,DateTime,Adopt,Euth,RTO,Unintended,Other,TotalOutcomes
0,2013-10-01,6,7,11,0,5,29
1,2013-10-02,12,2,9,0,10,33
2,2013-10-03,7,0,6,0,5,18
3,2013-10-04,6,3,9,0,5,23
4,2013-10-05,22,2,6,0,8,38
5,2013-10-06,18,1,9,0,4,32
6,2013-10-07,14,2,6,0,8,30
7,2013-10-08,6,0,9,0,1,16
8,2013-10-09,11,2,3,0,5,21
9,2013-10-10,9,4,5,1,21,40
10,2013-10-11,10,2,5,0,16,33
11,2013-10-12,21,3,18,0,6,48
12,2013-10-13,35,0,4,0,4,43
13,2013-10-14,7,3,9,0,19,38
14,2013-10-15,11,5,10,0,24,50
15,2013-10-16,8,0,7,0,20,35
16,2013-10-17,11,1,6,0,1,19
17,2013-10-18,7,4,14,0,6,31
18,2013-10-19,17,0,2,0,3,22
19,2013-10-20,17,1,9,0,12,39
20,2013-10-21,14,1,9,0,8,32
21,2013-10-22,7,3,7,1,3,21
22,2013-10-23,6,0,6,0,7,19
23,2013-10-24,15,6,10,0,15,46
24,2013-10-25,4,2,7,1,8,22
25,2013-10-26,13,0,5,0,3,21
26,2013-10-27,14,1,6,0,4,25
27,2013-10-28,2,6,9,1,20,38
28,2013-10-29,12,3,5,0,11,31
29,2013-10-30,6,3,5,0,9,23
30,2013-10-31,17,3,7,0,1,28
31,2013-11-01,18,1,9,0,8,36
32,2013-11-02,18,0,5,0,5,28
33,2013-11-03,30,3,4,0,5,42
34,2013-11-04,11,3,8,0,20,42
35,2013-11-05,7,1,11,0,2,21
36,2013-11-06,3,1,7,0,6,17
37,2013-11-07,8,2,12,0,11,33
38,2013-11-08,4,2,9,0,12,27
39,2013-11-09,17,0,13,0,8,38
40,2013-11-10,24,4,5,0,3,36
41,2013-11-11,16,2,11,0,7,36
42,2013-11-12,6,1,7,0,1,15
43,2013-11-13,4,1,7,0,5,17
44,2013-11-14,8,1,4,0,3,16
45,2013-11-15,8,5,4,0,14,31
46,2013-11-16,11,3,13,0,8,35
47,2013-11-17,8,0,8,0,13,29
48,2013-11-18,5,0,3,0,1,9
49,2013-11-19,10,2,11,0,8,31
50,2013-11-20,4,1,7,0,7,19
51,2013-11-21,7,5,5,0,6,23
52,2013-11-22,7,2,8,0,6,23
53,2013-11-23,13,2,12,0,6,33
54,2013-11-24,9,1,7,0,4,21
55,2013-11-25,9,0,6,0,10,25
56,2013-11-26,5,5,5,0,9,24
57,2013-11-27,9,1,8,0,9,27
58,2013-11-28,5,1,2,0,2,10
59,2013-11-29,6,3,7,0,16,32
60,2013-11-30,34,0,4,0,11,49
61,2013-12-01,23,0,6,1,6,36
62,2013-12-02,7,4,13,1,3,28
63,2013-12-03,11,0,5,0,6,22
64,2013-12-04,12,2,3,0,8,25
65,2013-12-05,9,5,4,0,5,23
66,2013-12-06,9,5,4,0,17,35
67,2013-12-07,14,1,3,0,1,19
68,2013-12-08,16,1,4,1,6,28
69,2013-12-09,10,0,8,0,13,31
70,2013-12-10,8,1,5,0,5,19
71,2013-12-11,6,5,9,0,2,22
72,2013-12-12,10,3,4,0,10,27
73,2013-12-13,12,1,6,0,12,31
74,2013-12-14,16,2,9,0,4,31
75,2013-12-15,12,2,7,0,6,27
76,2013-12-16,13,1,6,0,3,23
77,2013-12-17,10,0,12,0,1,23
78,2013-12-18,15,1,7,0,8,31
79,2013-12-19,11,3,8,0,8,30
80,2013-12-20,15,0,9,0,8,32
81,2013-12-21,24,3,12,0,7,46
82,2013-12-22,15,0,14,0,1,30
83,2013-12-23,20,4,15,0,2,41
84,2013-12-24,25,2,3,0,7,37
85,2013-12-25,0,1,0,0,1,2
86,2013-12-26,13,2,12,0,3,30
87,2013-12-27,11,7,5,0,6,29
88,2013-12-28,25,0,6,0,13,44
89,2013-12-29,12,1,7,0,7,27
90,2013-12-30,11,3,8,1,4,27
91,2013-12-31,10,1,15,0,9,35
92,2014-01-01,20,2,8,0,10,40
93,2014-01-02,11,1,8,0,5,25
94,2014-01-03,13,1,16,1,11,42
95,2014-01-04,17,1,4,0,2,24
96,2014-01-05,28,0,13,0,14,55
97,2014-01-06,10,3,9,0,4,26
98,2014-01-07,12,2,4,0,9,27
99,2014-01-08,6,4,9,0,5,24
100,2014-01-09,7,2,6,0,6,21
101,2014-01-10,13,3,7,0,11,34
102,2014-01-11,13,1,6,0,5,25
103,2014-01-12,12,0,8,0,11,31
104,2014-01-13,11,1,12,0,1,25
105,2014-01-14,7,1,12,0,3,23
106,2014-01-15,12,0,12,0,4,28
107,2014-01-16,6,1,19,0,7,33
108,2014-01-17,7,3,7,0,11,28
109,2014-01-18,19,2,4,0,5,30
110,2014-01-19,13,0,6,0,10,29
111,2014-01-20,15,2,3,0,13,33
112,2014-01-21,9,1,5,0,3,18
113,2014-01-22,13,2,7,1,4,27
114,2014-01-23,10,1,8,1,7,27
115,2014-01-24,4,2,5,0,5,16
116,2014-01-25,13,1,11,0,7,32
117,2014-01-26,14,2,3,0,11,30
118,2014-01-27,9,1,5,0,2,17
119,2014-01-28,5,1,11,1,2,20
120,2014-01-29,15,0,7,0,10,32
121,2014-01-30,9,1,7,0,3,20
122,2014-01-31,6,3,6,0,3,18
123,2014-02-01,25,1,8,0,0,34
124,2014-02-02,16,3,10,0,6,35
125,2014-02-03,14,4,11,1,5,35
126,2014-02-04,10,1,8,0,12,31
127,2014-02-05,3,1,8,0,3,15
128,2014-02-06,10,3,5,0,4,22
129,2014-02-07,5,0,7,0,14,26
130,2014-02-08,13,0,7,0,3,23
131,2014-02-09,15,0,5,0,5,25
132,2014-02-10,7,2,9,0,11,29
133,2014-02-11,12,1,11,0,5,29
134,2014-02-12,4,3,6,0,3,16
135,2014-02-13,6,2,16,0,15,39
136,2014-02-14,11,2,5,0,7,25
137,2014-02-15,16,4,4,0,3,27
138,2014-02-16,26,1,2,0,11,40
139,2014-02-17,14,0,9,0,8,31
140,2014-02-18,11,0,8,0,2,21
141,2014-02-19,12,0,12,0,9,33
142,2014-02-20,3,2,9,0,8,22
143,2014-02-21,12,1,7,0,4,24
144,2014-02-22,16,2,5,0,7,30
145,2014-02-23,20,1,8,0,2,31
146,2014-02-24,15,2,10,0,10,37
147,2014-02-25,17,6,13,0,2,38
148,2014-02-26,11,3,6,1,1,22
149,2014-02-27,6,0,6,0,3,15
150,2014-02-28,10,2,4,0,3,19
151,2014-03-01,18,0,6,0,5,29
152,2014-03-02,14,3,8,1,7,33
153,2014-03-03,6,2,4,0,11,23
154,2014-03-04,13,0,6,0,5,24
155,2014-03-05,11,1,6,0,1,19
156,2014-03-06,9,0,7,0,2,18
157,2014-03-07,9,5,10,0,5,29
158,2014-03-08,19,2,10,0,4,35
159,2014-03-09,18,1,7,0,9,35
160,2014-03-10,13,2,9,1,7,32
161,2014-03-11,11,4,7,0,6,28
162,2014-03-12,6,2,6,0,3,17
163,2014-03-13,17,1,13,0,16,47
164,2014-03-14,14,1,9,0,13,37
165,2014-03-15,14,2,6,0,10,32
166,2014-03-16,15,2,13,0,11,41
167,2014-03-17,9,2,14,0,11,36
168,2014-03-18,11,1,11,0,8,31
169,2014-03-19,8,4,8,0,2,22
170,2014-03-20,11,3,10,0,4,28
171,2014-03-21,9,4,9,0,8,30
172,2014-03-22,17,1,11,0,4,33
173,2014-03-23,19,0,11,0,17,47
174,2014-03-24,6,3,5,0,3,17
175,2014-03-25,11,2,9,0,2,24
176,2014-03-26,8,2,7,0,4,21
177,2014-03-27,7,4,12,0,5,28
178,2014-03-28,9,1,7,0,4,21
179,2014-03-29,18,0,8,0,6,32
180,2014-03-30,31,1,12,0,7,51
181,2014-03-31,8,3,4,0,2,17
182,2014-04-01,3,4,14,0,3,24
183,2014-04-02,7,1,13,0,4,25
184,2014-04-03,16,2,8,0,15,41
185,2014-04-04,6,0,13,0,2,21
186,2014-04-05,18,3,10,1,12,44
187,2014-04-06,19,0,14,0,3,36
188,2014-04-07,10,1,10,1,6,28
189,2014-04-08,12,1,9,0,4,26
190,2014-04-09,9,0,12,0,8,29
191,2014-04-10,13,4,5,0,6,28
192,2014-04-11,8,0,6,0,4,18
193,2014-04-12,12,0,8,0,3,23
194,2014-04-13,12,0,8,0,4,24
195,2014-04-14,4,3,6,0,6,19
196,2014-04-15,6,0,11,0,12,29
197,2014-04-16,8,0,15,0,16,39
198,2014-04-17,7,5,9,0,14,35
199,2014-04-18,7,0,5,0,19,31
200,2014-04-19,29,0,8,0,3,40
201,2014-04-20,17,0,9,0,5,31
202,2014-04-21,13,1,4,0,3,21
203,2014-04-22,9,0,8,0,2,19
204,2014-04-23,8,3,12,0,7,30
205,2014-04-24,12,0,12,0,6,30
206,2014-04-25,9,1,11,0,9,30
207,2014-04-26,13,1,6,1,8,29
208,2014-04-27,12,1,6,0,1,20
209,2014-04-28,9,1,10,1,4,25
210,2014-04-29,10,1,7,0,0,18
211,2014-04-30,13,1,9,0,11,34
212,2014-05-01,8,4,13,0,2,27
213,2014-05-02,4,0,6,0,4,14
214,2014-05-03,17,0,5,0,4,26
215,2014-05-04,28,5,14,0,4,51
216,2014-05-05,16,3,8,0,3,30
217,2014-05-06,6,1,9,1,7,24
218,2014-05-07,8,0,2,0,8,18
219,2014-05-08,5,3,6,0,4,18
220,2014-05-09,7,3,11,0,11,32
221,2014-05-10,16,1,9,0,4,30
222,2014-05-11,11,1,11,0,12,35
223,2014-05-12,5,0,10,0,3,18
224,2014-05-13,11,0,14,0,8,33
225,2014-05-14,13,8,9,0,9,39
226,2014-05-15,3,3,10,0,8,24
227,2014-05-16,6,1,10,0,11,28
228,2014-05-17,15,2,7,0,6,30
229,2014-05-18,13,2,10,0,5,30
230,2014-05-19,14,1,9,0,3,27
231,2014-05-20,10,0,9,1,5,25
232,2014-05-21,13,0,5,0,7,25
233,2014-05-22,8,5,8,2,5,28
234,2014-05-23,18,1,7,0,7,33
235,2014-05-24,10,3,6,2,18,39
236,2014-05-25,10,0,5,0,11,26
237,2014-05-26,21,1,14,0,10,46
238,2014-05-27,12,1,13,0,4,30
239,2014-05-28,6,2,11,0,4,23
240,2014-05-29,11,2,9,0,2,24
241,2014-05-30,8,1,13,0,12,34
242,2014-05-31,21,0,6,0,25,52
243,2014-06-01,20,0,10,0,8,38
244,2014-06-02,14,2,7,0,2,25
245,2014-06-03,19,3,11,0,12,45
246,2014-06-04,4,0,8,0,7,19
247,2014-06-05,7,0,4,0,5,16
248,2014-06-06,10,1,11,0,10,32
249,2014-06-07,18,3,6,0,12,39
250,2014-06-08,14,0,7,0,1,22
251,2014-06-09,13,4,10,0,3,30
252,2014-06-10,7,1,9,0,8,25
253,2014-06-11,7,2,2,0,6,17
254,2014-06-12,5,1,4,0,3,13
255,2014-06-13,8,1,8,0,3,20
256,2014-06-14,15,2,14,0,0,31
257,2014-06-15,19,1,7,0,9,36
258,2014-06-16,14,2,4,0,9,29
259,2014-06-17,12,5,12,0,16,45
260,2014-06-18,13,1,4,0,3,21
261,2014-06-19,10,4,9,0,19,42
262,2014-06-20,9,0,4,0,7,20
263,2014-06-21,16,0,11,0,3,30
264,2014-06-22,17,4,2,0,12,35
265,2014-06-23,7,1,4,1,4,17
266,2014-06-24,6,2,9,0,6,23
267,2014-06-25,8,1,5,0,3,17
268,2014-06-26,7,4,10,0,30,51
269,2014-06-27,6,2,9,1,1,19
270,2014-06-28,13,1,7,0,8,29
271,2014-06-29,23,1,3,0,8,35
272,2014-06-30,13,1,14,0,5,33
273,2014-07-01,24,2,7,0,7,40
274,2014-07-02,14,3,15,0,6,38
275,2014-07-03,9,1,5,0,5,20
276,2014-07-04,9,0,5,0,19,33
277,2014-07-05,15,1,10,0,13,39
278,2014-07-06,19,2,15,0,1,37
279,2014-07-07,24,2,16,0,2,44
280,2014-07-08,9,4,6,0,2,21
281,2014-07-09,15,0,8,0,4,27
282,2014-07-10,19,4,10,0,6,39
283,2014-07-11,18,2,6,0,7,33
284,2014-07-12,13,2,7,0,4,26
285,2014-07-13,23,1,5,0,2,31
286,2014-07-14,14,0,3,0,5,22
287,2014-07-15,13,0,5,0,6,24
288,2014-07-16,13,3,5,0,13,34
289,2014-07-17,19,3,3,0,6,31
290,2014-07-18,11,2,9,0,10,32
291,2014-07-19,22,1,5,1,2,31
292,2014-07-20,7,1,1,0,5,14
293,2014-07-21,10,4,15,0,21,50
294,2014-07-22,16,0,6,1,2,25
295,2014-07-23,17,16,9,0,12,54
296,2014-07-24,11,1,7,0,7,26
297,2014-07-25,10,2,11,0,3,26
298,2014-07-26,14,0,7,0,2,23
299,2014-07-27,18,2,9,0,11,40
300,2014-07-28,5,1,8,0,3,17
301,2014-07-29,19,2,6,0,2,29
302,2014-07-30,11,4,11,0,9,35
303,2014-07-31,5,1,8,0,4,18
304,2014-08-01,21,1,8,0,4,34
305,2014-08-02,17,1,5,1,8,32
306,2014-08-03,22,0,5,0,8,35
307,2014-08-04,18,2,11,0,7,38
308,2014-08-05,10,1,10,1,3,25
309,2014-08-06,14,4,13,0,5,36
310,2014-08-07,11,0,16,1,3,31
311,2014-08-08,10,2,6,0,0,18
312,2014-08-09,13,1,8,0,5,27
313,2014-08-10,25,0,11,0,5,41
314,2014-08-11,16,1,6,0,6,29
315,2014-08-12,11,3,4,0,4,22
316,2014-08-13,25,4,6,0,2,37
317,2014-08-14,6,1,4,0,13,24
318,2014-08-15,4,0,7,0,4,15
319,2014-08-16,15,1,8,0,4,28
320,2014-08-17,27,1,4,0,3,35
321,2014-08-18,17,2,7,0,9,35
322,2014-08-19,22,1,3,0,6,32
323,2014-08-20,13,3,8,0,11,35
324,2014-08-21,15,1,5,0,16,37
325,2014-08-22,16,0,9,0,1,26
326,2014-08-23,17,0,8,0,5,30
327,2014-08-24,17,0,9,0,2,28
328,2014-08-25,17,1,4,0,0,22
329,2014-08-26,10,0,4,0,0,14
330,2014-08-27,9,3,8,0,6,26
331,2014-08-28,11,1,5,0,5,22
332,2014-08-29,11,6,7,0,9,33
333,2014-08-30,28,1,11,0,4,44
334,2014-08-31,18,1,8,0,6,33
335,2014-09-01,14,4,6,0,4,28
336,2014-09-02,14,0,5,0,6,25
337,2014-09-03,9,2,10,0,15,36
338,2014-09-04,10,1,11,0,6,28
339,2014-09-05,11,2,7,0,6,26
340,2014-09-06,12,0,10,0,14,36
341,2014-09-07,21,1,4,0,9,35
342,2014-09-08,17,3,9,0,9,38
343,2014-09-09,14,3,5,0,10,32
344,2014-09-10,14,2,10,0,1,27
345,2014-09-11,11,0,7,0,1,19
346,2014-09-12,15,0,8,0,1,24
347,2014-09-13,18,0,13,0,8,39
348,2014-09-14,16,3,11,0,11,41
349,2014-09-15,3,1,10,0,9,23
350,2014-09-16,6,2,8,0,8,24
351,2014-09-17,13,1,3,0,4,21
352,2014-09-18,8,2,7,0,1,18
353,2014-09-19,6,4,13,0,5,28
354,2014-09-20,22,0,15,0,7,44
355,2014-09-21,18,3,4,0,8,33
356,2014-09-22,13,0,14,0,6,33
357,2014-09-23,9,0,7,0,8,24
358,2014-09-24,14,2,11,0,1,28
359,2014-09-25,4,0,5,0,3,12
360,2014-09-26,7,4,11,0,14,36
361,2014-09-27,30,0,8,0,6,44
362,2014-09-28,10,0,9,0,3,22
363,2014-09-29,15,5,7,1,16,44
364,2014-09-30,5,1,5,0,8,19
365,2014-10-01,5,2,3,0,10,20
366,2014-10-02,3,2,5,0,17,27
367,2014-10-03,9,0,6,0,4,19
368,2014-10-04,9,2,11,0,10,32
369,2014-10-05,14,0,6,0,1,21
370,2014-10-06,7,1,10,0,8,26
371,2014-10-07,9,1,4,0,4,18
372,2014-10-08,11,3,6,0,8,28
373,2014-10-09,8,6,16,0,7,37
374,2014-10-10,20,4,2,0,6,32
375,2014-10-11,18,1,4,0,5,28
376,2014-10-12,26,1,6,0,4,37
377,2014-10-13,14,2,8,0,7,31
378,2014-10-14,11,6,11,0,5,33
379,2014-10-15,3,0,8,0,1,12
380,2014-10-16,4,2,8,0,13,27
381,2014-10-17,6,1,9,0,5,21
382,2014-10-18,25,1,8,0,5,39
383,2014-10-19,28,2,1,0,6,37
384,2014-10-20,21,0,13,0,6,40
385,2014-10-21,7,4,4,0,5,20
386,2014-10-22,13,3,5,0,12,33
387,2014-10-23,13,2,11,0,5,31
388,2014-10-24,6,6,10,0,4,26
389,2014-10-25,15,1,9,0,9,34
390,2014-10-26,18,4,10,0,7,39
391,2014-10-27,6,1,4,0,14,25
392,2014-10-28,3,1,6,0,0,10
393,2014-10-29,7,1,14,0,4,26
394,2014-10-30,10,3,5,0,12,30
395,2014-10-31,5,2,8,0,1,16
396,2014-11-01,10,3,5,0,2,20
397,2014-11-02,15,1,5,0,14,35
398,2014-11-03,11,2,15,0,5,33
399,2014-11-04,11,5,11,0,12,39
400,2014-11-05,8,1,6,0,5,20
401,2014-11-06,8,2,1,0,2,13
402,2014-11-07,6,2,4,0,23,35
403,2014-11-08,13,1,10,0,4,28
404,2014-11-09,12,0,9,0,9,30
405,2014-11-10,7,5,10,0,0,22
406,2014-11-11,3,2,9,0,13,27
407,2014-11-12,12,3,12,0,9,36
408,2014-11-13,9,1,6,0,5,21
409,2014-11-14,7,2,10,0,3,22
410,2014-11-15,16,4,11,0,19,50
411,2014-11-16,10,0,8,0,4,22
412,2014-11-17,8,3,6,0,2,19
413,2014-11-18,10,1,4,0,12,27
414,2014-11-19,8,1,7,0,2,18
415,2014-11-20,5,8,12,0,4,29
416,2014-11-21,16,2,5,0,13,36
417,2014-11-22,9,2,11,0,5,27
418,2014-11-23,24,1,12,0,12,49
419,2014-11-24,9,2,9,0,10,30
420,2014-11-25,9,2,8,0,7,26
421,2014-11-26,16,0,8,0,4,28
422,2014-11-27,2,1,2,0,4,9
423,2014-11-28,13,2,11,0,4,30
424,2014-11-29,23,0,6,0,14,43
425,2014-11-30,18,1,9,0,8,36
426,2014-12-01,11,2,11,0,6,30
427,2014-12-02,14,2,10,0,0,26
428,2014-12-03,7,1,7,0,5,20
429,2014-12-04,7,2,8,1,42,60
430,2014-12-05,18,2,11,0,16,47
431,2014-12-06,36,1,4,0,2,43
432,2014-12-07,32,1,14,0,15,62
433,2014-12-08,21,2,7,0,11,41
434,2014-12-09,14,1,4,0,8,27
435,2014-12-10,5,4,6,0,12,27
436,2014-12-11,13,2,7,0,10,32
437,2014-12-12,7,1,9,0,8,25
438,2014-12-13,17,1,11,0,2,31
439,2014-12-14,10,0,7,0,3,20
440,2014-12-15,13,4,6,1,7,31
441,2014-12-16,9,1,10,1,3,24
442,2014-12-17,16,1,16,0,5,38
443,2014-12-18,13,3,7,0,9,32
444,2014-12-19,15,1,7,0,7,30
445,2014-12-20,18,1,10,0,10,39
446,2014-12-21,9,0,9,1,0,19
447,2014-12-22,11,4,8,0,2,25
448,2014-12-23,11,4,1,0,12,28
449,2014-12-24,14,1,6,0,3,24
450,2014-12-25,0,2,3,0,0,5
451,2014-12-26,11,0,11,0,7,29
452,2014-12-27,18,0,18,0,13,49
453,2014-12-28,13,0,5,0,5,23
454,2014-12-29,11,0,5,0,3,19
455,2014-12-30,16,2,10,0,5,33
456,2014-12-31,18,1,4,0,3,26
457,2015-01-01,18,0,10,0,3,31
458,2015-01-02,13,0,4,0,6,23
459,2015-01-03,20,1,7,0,2,30
460,2015-01-04,17,0,7,0,11,35
461,2015-01-05,13,0,12,1,6,32
462,2015-01-06,9,3,10,0,7,29
463,2015-01-07,12,0,5,0,3,20
464,2015-01-08,6,0,27,0,2,35
465,2015-01-09,6,2,7,0,12,27
466,2015-01-10,12,1,1,0,5,19
467,2015-01-11,14,0,3,0,3,20
468,2015-01-12,15,2,9,0,13,39
469,2015-01-13,2,1,7,0,1,11
470,2015-01-14,6,1,8,0,5,20
471,2015-01-15,7,0,4,0,3,14
472,2015-01-16,8,0,6,0,4,18
473,2015-01-17,25,2,11,0,0,38
474,2015-01-18,33,1,3,0,4,41
475,2015-01-19,22,1,4,0,3,30
476,2015-01-20,11,3,10,0,14,38
477,2015-01-21,11,2,11,0,3,27
478,2015-01-22,6,3,14,0,2,25
479,2015-01-23,7,0,5,0,5,17
480,2015-01-24,11,1,7,0,3,22
481,2015-01-25,13,1,7,0,3,24
482,2015-01-26,16,2,10,0,3,31
483,2015-01-27,14,2,4,0,7,27
484,2015-01-28,6,3,7,0,3,19
485,2015-01-29,7,2,9,0,4,22
486,2015-01-30,16,2,10,0,3,31
487,2015-01-31,23,0,4,0,6,33
488,2015-02-01,16,0,9,1,8,34
489,2015-02-02,15,2,12,0,10,39
490,2015-02-03,8,1,12,0,7,28
491,2015-02-04,16,0,6,0,10,32
492,2015-02-05,12,4,4,0,1,21
493,2015-02-06,7,4,5,0,7,23
494,2015-02-07,24,0,8,0,6,38
495,2015-02-08,23,3,3,0,5,34
496,2015-02-09,10,1,12,0,10,33
497,2015-02-10,12,1,10,0,5,28
498,2015-02-11,9,2,3,0,5,19
499,2015-02-12,21,2,9,0,7,39
500,2015-02-13,8,3,9,0,7,27
501,2015-02-14,23,1,4,0,2,30
502,2015-02-15,18,2,7,0,5,32
503,2015-02-16,14,1,12,0,2,29
504,2015-02-17,14,1,6,0,0,21
505,2015-02-18,9,2,9,0,7,27
506,2015-02-19,8,3,17,0,4,32
507,2015-02-20,11,2,10,0,11,34
508,2015-02-21,22,1,4,0,5,32
509,2015-02-22,15,2,11,0,6,34
510,2015-02-23,15,1,3,0,10,29
511,2015-02-24,7,3,6,0,6,22
512,2015-02-25,11,0,14,1,2,28
513,2015-02-26,5,3,9,0,7,24
514,2015-02-27,16,1,6,0,2,25
515,2015-02-28,12,1,9,1,3,26
516,2015-03-01,20,2,6,0,5,33
517,2015-03-02,13,0,7,0,6,26
518,2015-03-03,11,0,7,0,1,19
519,2015-03-04,9,1,4,0,1,15
520,2015-03-05,3,0,7,0,2,12
521,2015-03-06,4,3,8,0,10,25
522,2015-03-07,15,2,4,0,5,26
523,2015-03-08,16,0,2,0,7,25
524,2015-03-09,13,0,6,0,2,21
525,2015-03-10,13,1,7,0,4,25
526,2015-03-11,7,2,10,0,0,19
527,2015-03-12,6,1,7,0,3,17
528,2015-03-13,12,5,9,0,5,31
529,2015-03-14,30,3,7,0,9,49
530,2015-03-15,23,3,5,0,3,34
531,2015-03-16,12,1,7,0,5,25
532,2015-03-17,9,2,10,0,1,22
533,2015-03-18,8,0,6,0,1,15
534,2015-03-19,5,3,5,0,3,16
535,2015-03-20,12,0,9,0,4,25
536,2015-03-21,15,1,10,0,0,26
537,2015-03-22,15,0,5,0,9,29
538,2015-03-23,11,2,14,1,4,32
539,2015-03-24,11,0,25,0,4,40
540,2015-03-25,10,0,9,1,14,34
541,2015-03-26,7,2,11,0,6,26
542,2015-03-27,10,3,15,0,1,29
543,2015-03-28,14,1,7,0,2,24
544,2015-03-29,16,3,7,0,2,28
545,2015-03-30,15,2,6,0,10,33
546,2015-03-31,5,0,12,2,0,19
547,2015-04-01,8,2,13,0,4,27
548,2015-04-02,10,1,7,0,31,49
549,2015-04-03,11,1,0,1,11,24
550,2015-04-04,21,0,4,0,11,36
551,2015-04-05,20,1,5,0,7,33
552,2015-04-06,15,0,13,0,1,29
553,2015-04-07,13,0,11,0,1,25
554,2015-04-08,8,0,8,0,11,27
555,2015-04-09,9,0,11,0,4,24
556,2015-04-10,6,4,8,0,14,32
557,2015-04-11,13,0,7,0,4,24
558,2015-04-12,9,1,15,0,8,33
559,2015-04-13,10,3,12,0,9,34
560,2015-04-14,7,2,9,0,1,19
561,2015-04-15,5,1,6,0,5,17
562,2015-04-16,4,0,6,0,6,16
563,2015-04-17,9,1,9,0,2,21
564,2015-04-18,13,1,6,0,4,24
565,2015-04-19,19,4,5,0,9,37
566,2015-04-20,4,3,11,0,7,25
567,2015-04-21,12,4,19,0,5,40
568,2015-04-22,11,2,10,0,2,25
569,2015-04-23,6,5,8,0,3,22
570,2015-04-24,4,2,16,0,7,29
571,2015-04-25,24,0,6,0,6,36
572,2015-04-26,13,1,15,0,1,30
573,2015-04-27,9,1,10,0,5,25
574,2015-04-28,11,0,10,0,9,30
575,2015-04-29,12,3,8,0,7,30
576,2015-04-30,12,1,2,0,4,19
577,2015-05-01,6,5,10,0,8,29
578,2015-05-02,34,0,13,0,1,48
579,2015-05-03,35,0,9,1,8,53
580,2015-05-04,11,6,9,0,4,30
581,2015-05-05,22,1,10,0,5,38
582,2015-05-06,7,1,20,0,1,29
583,2015-05-07,7,5,8,0,5,25
584,2015-05-08,17,1,8,0,0,26
585,2015-05-09,18,0,10,0,4,32
586,2015-05-10,24,0,10,0,8,42
587,2015-05-11,8,1,9,0,3,21
588,2015-05-12,6,2,13,0,13,34
589,2015-05-13,5,0,6,0,4,15
590,2015-05-14,8,4,14,0,3,29
591,2015-05-15,6,4,10,2,9,31
592,2015-05-16,13,0,14,0,4,31
593,2015-05-17,12,3,17,0,5,37
594,2015-05-18,12,0,8,0,8,28
595,2015-05-19,10,2,7,0,7,26
596,2015-05-20,9,3,19,0,11,42
597,2015-05-21,15,2,12,0,5,34
598,2015-05-22,12,3,9,0,3,27
599,2015-05-23,23,0,10,0,8,41
600,2015-05-24,20,2,6,0,3,31
601,2015-05-25,28,5,14,0,5,52
602,2015-05-26,12,2,14,0,19,47
603,2015-05-27,13,1,11,0,27,52
604,2015-05-28,11,4,13,0,13,41
605,2015-05-29,11,0,20,0,14,45
606,2015-05-30,18,2,10,0,2,32
607,2015-05-31,16,1,8,0,11,36
608,2015-06-01,17,1,12,0,2,32
609,2015-06-02,5,3,5,0,3,16
610,2015-06-03,8,2,19,0,3,32
611,2015-06-04,10,1,10,1,8,30
612,2015-06-05,7,2,11,0,20,40
613,2015-06-06,13,0,6,0,3,22
614,2015-06-07,32,0,8,1,5,46
615,2015-06-08,10,0,4,0,5,19
616,2015-06-09,13,2,10,0,1,26
617,2015-06-10,8,2,5,0,4,19
618,2015-06-11,15,2,3,0,9,29
619,2015-06-12,11,3,7,0,6,27
620,2015-06-13,13,0,11,0,11,35
621,2015-06-14,13,0,7,0,0,20
622,2015-06-15,16,1,8,1,3,29
623,2015-06-16,8,1,10,0,2,21
624,2015-06-17,8,3,6,0,2,19
625,2015-06-18,8,0,14,0,9,31
626,2015-06-19,10,0,10,0,27,47
627,2015-06-20,17,1,11,0,13,42
628,2015-06-21,17,2,10,1,11,41
629,2015-06-22,9,1,7,0,1,18
630,2015-06-23,16,1,17,0,5,39
631,2015-06-24,12,2,8,0,16,38
632,2015-06-25,16,4,7,0,4,31
633,2015-06-26,14,2,3,1,7,27
634,2015-06-27,14,1,5,0,3,23
635,2015-06-28,24,2,9,1,2,38
636,2015-06-29,15,3,14,0,19,51
637,2015-06-30,11,2,5,1,14,33
638,2015-07-01,13,1,7,0,12,33
639,2015-07-02,13,0,9,0,17,39
640,2015-07-03,15,3,5,0,6,29
641,2015-07-04,7,2,5,1,0,15
642,2015-07-05,23,2,12,1,2,40
643,2015-07-06,14,3,12,0,9,38
644,2015-07-07,10,1,11,0,2,24
645,2015-07-08,16,0,6,0,9,31
646,2015-07-09,14,4,6,0,5,29
647,2015-07-10,10,2,8,0,8,28
648,2015-07-11,12,0,7,0,5,24
649,2015-07-12,12,1,9,0,1,23
650,2015-07-13,11,2,8,0,9,30
651,2015-07-14,8,2,6,0,7,23
652,2015-07-15,10,3,10,0,8,31
653,2015-07-16,8,2,8,1,4,23
654,2015-07-17,13,1,8,0,3,25
655,2015-07-18,10,0,8,1,5,24
656,2015-07-19,14,0,9,0,11,34
657,2015-07-20,11,0,8,0,6,25
658,2015-07-21,12,2,10,1,7,32
659,2015-07-22,11,0,6,0,5,22
660,2015-07-23,12,1,10,0,7,30
661,2015-07-24,12,3,13,0,2,30
662,2015-07-25,16,2,1,0,5,24
663,2015-07-26,19,0,10,0,2,31
664,2015-07-27,13,1,4,0,3,21
665,2015-07-28,11,1,5,0,7,24
666,2015-07-29,8,1,3,0,13,25
667,2015-07-30,5,0,12,0,3,20
668,2015-07-31,16,1,1,0,15,33
669,2015-08-01,24,0,3,0,4,31
670,2015-08-02,27,2,5,1,2,37
671,2015-08-03,7,2,1,1,11,22
672,2015-08-04,12,1,18,0,4,35
673,2015-08-05,7,0,6,0,2,15
674,2015-08-06,10,0,5,0,3,18
675,2015-08-07,10,1,6,1,8,26
676,2015-08-08,18,2,3,0,5,28
677,2015-08-09,22,0,8,0,7,37
678,2015-08-10,11,0,8,0,3,22
679,2015-08-11,8,2,6,0,9,25
680,2015-08-12,8,3,6,0,7,24
681,2015-08-13,12,3,10,0,13,38
682,2015-08-14,11,2,10,0,9,32
683,2015-08-15,13,2,3,0,2,20
684,2015-08-16,15,0,4,0,0,19
685,2015-08-17,9,1,8,0,1,19
686,2015-08-18,8,0,13,0,6,27
687,2015-08-19,7,0,5,1,11,24
688,2015-08-20,9,1,9,1,0,20
689,2015-08-21,8,0,5,0,4,17
690,2015-08-22,11,0,5,0,2,18
691,2015-08-23,17,0,6,0,1,24
692,2015-08-24,13,0,12,0,2,27
693,2015-08-25,8,0,10,2,22,42
694,2015-08-26,13,0,6,0,5,24
695,2015-08-27,10,1,9,0,8,28
696,2015-08-28,12,3,14,0,9,38
697,2015-08-29,22,1,8,0,5,36
698,2015-08-30,17,1,5,0,5,28
699,2015-08-31,13,0,5,0,12,30
700,2015-09-01,12,0,11,0,6,29
701,2015-09-02,7,0,4,0,6,17
702,2015-09-03,6,1,12,1,6,26
703,2015-09-04,11,2,12,1,3,29
704,2015-09-05,12,2,3,0,3,20
705,2015-09-06,17,0,7,0,6,30
706,2015-09-07,19,0,7,0,8,34
707,2015-09-08,12,1,3,0,6,22
708,2015-09-09,9,2,6,0,12,29
709,2015-09-10,10,2,7,0,13,32
710,2015-09-11,12,0,12,0,5,29
711,2015-09-12,14,0,10,0,9,33
712,2015-09-13,24,1,10,0,5,40
713,2015-09-14,4,2,5,0,14,25
714,2015-09-15,6,2,6,0,9,23
715,2015-09-16,8,3,6,1,4,22
716,2015-09-17,16,1,7,0,20,44
717,2015-09-18,10,1,11,0,10,32
718,2015-09-19,21,0,12,1,5,39
719,2015-09-20,16,1,3,0,7,27
720,2015-09-21,10,0,8,0,12,30
721,2015-09-22,11,2,3,0,3,19
722,2015-09-23,12,0,8,0,5,25
723,2015-09-24,9,0,4,0,0,13
724,2015-09-25,7,0,5,0,3,15
725,2015-09-26,8,0,11,0,13,32
726,2015-09-27,28,0,5,0,3,36
727,2015-09-28,8,1,6,0,1,16
728,2015-09-29,9,1,9,1,7,27
729,2015-09-30,8,0,10,0,3,21
730,2015-10-01,6,0,4,0,2,12
731,2015-10-02,7,0,9,0,3,19
732,2015-10-03,6,1,6,0,1,14
733,2015-10-04,16,1,4,0,0,21
734,2015-10-05,8,0,14,0,7,29
735,2015-10-06,10,0,6,0,11,27
736,2015-10-07,7,0,10,0,14,31
737,2015-10-08,6,2,10,0,8,26
738,2015-10-09,10,0,6,0,3,19
739,2015-10-10,14,0,8,0,14,36
740,2015-10-11,18,0,12,0,2,32
741,2015-10-12,14,0,10,0,22,46
742,2015-10-13,11,1,8,0,15,35
743,2015-10-14,6,0,1,1,3,11
744,2015-10-15,6,2,8,0,3,19
745,2015-10-16,10,0,10,0,6,26
746,2015-10-17,24,1,7,0,1,33
747,2015-10-18,29,0,7,0,5,41
748,2015-10-19,13,1,10,0,4,28
749,2015-10-20,7,0,13,0,1,21
750,2015-10-21,7,1,7,0,4,19
751,2015-10-22,8,1,5,0,2,16
752,2015-10-23,7,0,3,0,5,15
753,2015-10-24,19,1,7,0,0,27
754,2015-10-25,15,1,12,0,3,31
755,2015-10-26,3,3,13,0,3,22
756,2015-10-27,10,0,13,0,5,28
757,2015-10-28,8,0,6,0,10,24
758,2015-10-29,14,0,9,0,3,26
759,2015-10-30,2,0,3,0,0,5
760,2015-10-31,17,0,16,0,14,47
761,2015-11-01,9,0,25,0,11,45
762,2015-11-02,3,0,23,0,5,31
763,2015-11-03,12,0,12,0,5,29
764,2015-11-04,8,0,18,1,2,29
765,2015-11-05,10,0,14,0,13,37
766,2015-11-06,6,2,12,0,6,26
767,2015-11-07,15,0,5,0,4,24
768,2015-11-08,17,2,7,0,7,33
769,2015-11-09,9,2,11,0,10,32
770,2015-11-10,9,0,13,0,5,27
771,2015-11-11,9,0,7,0,2,18
772,2015-11-12,10,1,9,0,3,23
773,2015-11-13,7,1,23,0,12,43
774,2015-11-14,14,0,14,0,2,30
775,2015-11-15,16,0,10,0,12,38
776,2015-11-16,2,0,14,0,8,24
777,2015-11-17,13,0,8,0,5,26
778,2015-11-18,10,0,9,0,3,22
779,2015-11-19,9,0,11,0,2,22
780,2015-11-20,13,0,10,0,12,35
781,2015-11-21,18,0,2,0,2,22
782,2015-11-22,17,0,6,0,4,27
783,2015-11-23,13,0,8,0,15,36
784,2015-11-24,10,0,4,0,3,17
785,2015-11-25,11,0,21,0,5,37
786,2015-11-26,1,1,4,0,2,8
787,2015-11-27,20,1,14,0,5,40
788,2015-11-28,14,1,8,0,7,30
789,2015-11-29,15,1,8,1,1,26
790,2015-11-30,13,2,9,0,20,44
791,2015-12-01,6,4,9,0,4,23
792,2015-12-02,7,2,11,0,4,24
793,2015-12-03,1,0,5,1,13,20
794,2015-12-04,5,0,8,0,7,20
795,2015-12-05,10,0,9,0,0,19
796,2015-12-06,14,0,7,0,8,29
797,2015-12-07,13,1,5,0,9,28
798,2015-12-08,11,2,10,0,8,31
799,2015-12-09,2,0,6,0,1,9
800,2015-12-10,5,2,11,0,5,23
801,2015-12-11,8,0,7,1,3,19
802,2015-12-12,15,1,12,0,2,30
803,2015-12-13,25,1,11,0,4,41
804,2015-12-14,11,0,6,0,2,19
805,2015-12-15,9,1,10,0,7,27
806,2015-12-16,10,0,8,0,3,21
807,2015-12-17,20,0,6,0,3,29
808,2015-12-18,14,1,6,0,1,22
809,2015-12-19,15,0,6,0,13,34
810,2015-12-20,17,0,10,0,4,31
811,2015-12-21,13,0,10,0,5,28
812,2015-12-22,24,1,10,0,3,38
813,2015-12-23,18,1,8,0,0,27
814,2015-12-24,12,0,9,0,1,22
815,2015-12-26,20,0,15,1,7,43
816,2015-12-27,11,0,8,0,13,32
817,2015-12-28,10,0,12,0,8,30
818,2015-12-29,15,0,9,0,2,26
819,2015-12-30,5,5,12,0,3,25
820,2015-12-31,15,0,8,0,5,28
821,2016-01-01,1,0,4,0,7,12
822,2016-01-02,12,0,11,0,8,31
823,2016-01-03,12,0,10,1,1,24
824,2016-01-04,9,0,14,0,13,36
825,2016-01-05,13,0,8,0,8,29
826,2016-01-06,8,1,17,0,12,38
827,2016-01-07,9,1,8,0,11,29
828,2016-01-08,9,0,6,0,3,18
829,2016-01-09,19,0,2,0,3,24
830,2016-01-10,16,0,13,0,4,33
831,2016-01-11,13,1,6,0,0,20
832,2016-01-12,15,0,13,0,6,34
833,2016-01-13,10,0,10,1,6,27
834,2016-01-14,8,0,9,0,1,18
835,2016-01-15,15,0,5,0,3,23
836,2016-01-16,18,2,4,0,20,44
837,2016-01-17,16,2,11,1,9,39
838,2016-01-18,18,0,7,0,15,40
839,2016-01-19,5,0,12,0,8,25
840,2016-01-20,13,0,6,0,7,26
841,2016-01-21,12,0,4,0,8,24
842,2016-01-22,12,0,8,0,8,28
843,2016-01-23,17,1,6,0,7,31
844,2016-01-24,20,0,6,0,1,27
845,2016-01-25,10,0,5,0,20,35
846,2016-01-26,8,1,12,0,1,22
847,2016-01-27,7,1,8,0,5,21
848,2016-01-28,10,0,5,0,6,21
849,2016-01-29,4,0,9,0,8,21
850,2016-01-30,13,0,9,0,1,23
851,2016-01-31,12,1,6,0,8,27
852,2016-02-01,8,1,9,0,2,20
853,2016-02-02,7,0,6,0,16,29
854,2016-02-03,7,1,9,0,3,20
855,2016-02-04,12,1,6,0,1,20
856,2016-02-05,11,1,2,1,8,23
857,2016-02-06,22,0,6,0,3,31
858,2016-02-07,15,0,9,0,9,33
859,2016-02-08,14,0,7,0,4,25
860,2016-02-09,8,0,3,1,2,14
861,2016-02-10,12,0,4,0,4,20
862,2016-02-11,16,0,4,0,4,24
863,2016-02-12,12,2,13,0,2,29
864,2016-02-13,32,0,7,0,0,39
865,2016-02-14,22,0,16,0,1,39
866,2016-02-15,24,1,7,0,15,47
867,2016-02-16,6,2,14,0,10,32
868,2016-02-17,0,0,6,0,4,10
869,2016-02-18,16,3,4,0,0,23
870,2016-02-19,10,0,7,0,4,21
871,2016-02-20,16,1,11,0,3,31
872,2016-02-21,16,0,9,0,8,33
873,2016-02-22,9,0,11,1,7,28
874,2016-02-23,15,0,7,0,1,23
875,2016-02-24,14,1,13,0,5,33
876,2016-02-25,10,2,13,0,2,27
877,2016-02-26,11,0,11,1,2,25
878,2016-02-27,20,0,5,0,1,26
879,2016-02-28,16,0,10,2,16,44
880,2016-02-29,13,0,11,0,6,30
881,2016-03-01,9,1,10,0,15,35
882,2016-03-02,14,4,9,0,7,34
883,2016-03-03,11,0,8,0,13,32
884,2016-03-04,8,0,6,0,0,14
885,2016-03-05,24,0,11,0,0,35
886,2016-03-06,14,2,3,0,11,30
887,2016-03-07,7,0,14,0,9,30
888,2016-03-08,17,3,8,0,7,35
889,2016-03-09,11,0,12,0,1,24
890,2016-03-10,4,1,7,0,3,15
891,2016-03-11,9,0,7,0,6,22
892,2016-03-12,15,0,10,0,1,26
893,2016-03-13,13,0,9,0,2,24
894,2016-03-14,12,1,19,0,6,38
895,2016-03-15,14,1,5,0,4,24
896,2016-03-16,13,0,9,0,2,24
897,2016-03-17,16,1,4,0,5,26
898,2016-03-18,8,0,7,0,4,19
899,2016-03-19,8,1,7,0,7,23
900,2016-03-20,19,2,12,0,13,46
901,2016-03-21,12,0,7,0,4,23
902,2016-03-22,7,3,5,0,11,26
903,2016-03-23,6,4,10,1,3,24
904,2016-03-24,15,0,10,0,4,29
905,2016-03-25,12,0,9,0,1,22
906,2016-03-26,30,2,4,0,7,43
907,2016-03-27,10,1,16,0,8,35
908,2016-03-28,11,0,11,0,10,32
909,2016-03-29,18,0,13,0,2,33
910,2016-03-30,7,0,7,0,3,17
911,2016-03-31,3,0,11,1,2,17
912,2016-04-01,8,0,10,0,2,20
913,2016-04-02,17,0,3,0,6,26
914,2016-04-03,20,1,9,0,0,30
915,2016-04-04,13,0,10,0,5,28
916,2016-04-05,14,1,8,0,4,27
917,2016-04-06,8,1,8,0,6,23
918,2016-04-07,14,0,5,0,7,26
919,2016-04-08,8,0,7,0,1,16
920,2016-04-09,17,0,11,0,4,32
921,2016-04-10,12,0,6,0,5,23
922,2016-04-11,12,1,15,0,9,37
923,2016-04-12,6,0,12,0,1,19
924,2016-04-13,3,0,6,0,3,12
925,2016-04-14,13,1,5,0,1,20
926,2016-04-15,10,0,11,0,6,27
927,2016-04-16,20,0,4,0,5,29
928,2016-04-17,14,0,4,0,9,27
929,2016-04-18,10,0,9,0,33,52
930,2016-04-19,5,2,10,0,1,18
931,2016-04-20,10,1,12,1,2,26
932,2016-04-21,8,0,15,0,3,26
933,2016-04-22,10,0,13,1,0,24
934,2016-04-23,11,0,11,0,1,23
935,2016-04-24,14,0,10,0,2,26
936,2016-04-25,7,1,7,0,14,29
937,2016-04-26,11,0,11,0,5,27
938,2016-04-27,11,0,11,0,4,26
939,2016-04-28,11,1,8,0,2,22
940,2016-04-29,10,0,9,0,3,22
941,2016-04-30,17,4,9,0,2,32
942,2016-05-01,17,0,13,0,1,31
943,2016-05-02,8,0,12,0,3,23
944,2016-05-03,12,0,12,0,3,27
945,2016-05-04,13,1,12,0,4,30
946,2016-05-05,7,1,7,0,1,16
947,2016-05-06,8,2,13,0,2,25
948,2016-05-07,24,0,9,0,6,39
949,2016-05-08,15,0,12,1,5,33
950,2016-05-09,17,1,12,0,13,43
951,2016-05-10,12,1,7,1,7,28
952,2016-05-11,4,1,13,1,9,28
953,2016-05-12,11,0,11,0,3,25
954,2016-05-13,7,1,9,0,3,20
955,2016-05-14,18,0,13,0,4,35
956,2016-05-15,18,1,9,0,3,31
957,2016-05-16,10,1,8,0,11,30
958,2016-05-17,12,0,8,0,5,25
959,2016-05-18,11,0,20,1,3,35
960,2016-05-19,5,0,12,1,21,39
961,2016-05-20,9,2,13,0,2,26
962,2016-05-21,23,0,4,0,21,48
963,2016-05-22,27,2,3,0,8,40
964,2016-05-23,13,0,15,0,13,41
965,2016-05-24,19,0,13,0,3,35
966,2016-05-25,12,1,6,2,7,28
967,2016-05-26,14,3,9,1,8,35
968,2016-05-27,11,0,8,0,14,33
969,2016-05-28,16,0,15,0,3,34
970,2016-05-29,20,0,5,0,1,26
971,2016-05-30,18,0,2,0,13,33
972,2016-05-31,11,1,7,0,12,31
973,2016-06-01,3,0,9,0,9,21
974,2016-06-02,11,1,18,1,5,36
975,2016-06-03,14,0,5,1,9,29
976,2016-06-04,21,1,6,2,10,40
977,2016-06-05,22,1,8,0,2,33
978,2016-06-06,21,0,6,1,2,30
979,2016-06-07,8,2,8,0,6,24
980,2016-06-08,3,0,6,0,7,16
981,2016-06-09,16,0,8,0,8,32
982,2016-06-10,20,1,10,0,9,40
983,2016-06-11,27,4,4,0,2,37
984,2016-06-12,18,0,3,0,1,22
985,2016-06-13,10,2,2,0,3,17
986,2016-06-14,16,0,6,0,2,24
987,2016-06-15,8,0,4,0,0,12
988,2016-06-16,17,2,4,0,2,25
989,2016-06-17,10,0,4,0,8,22
990,2016-06-18,25,0,8,0,5,38
991,2016-06-19,26,1,4,0,2,33
992,2016-06-20,23,0,8,0,6,37
993,2016-06-21,11,0,10,0,14,35
994,2016-06-22,14,3,14,0,1,32
995,2016-06-23,6,0,8,0,4,18
996,2016-06-24,8,0,6,0,4,18
997,2016-06-25,17,0,7,0,5,29
998,2016-06-26,21,0,8,0,9,38
999,2016-06-27,9,1,7,0,2,19
1000,2016-06-28,15,1,8,0,8,32
1001,2016-06-29,10,0,12,0,6,28
1002,2016-06-30,13,0,3,0,6,22
1003,2016-07-01,5,0,8,0,4,17
1004,2016-07-02,7,0,5,0,1,13
1005,2016-07-03,15,1,5,0,2,23
1006,2016-07-04,10,0,7,0,9,26
1007,2016-07-05,17,0,8,0,16,41
1008,2016-07-06,12,1,7,0,7,27
1009,2016-07-07,17,0,6,0,3,26
1010,2016-07-08,3,1,5,0,3,12
1011,2016-07-09,21,0,8,0,3,32
1012,2016-07-10,12,1,9,0,2,24
1013,2016-07-11,9,1,8,0,5,23
1014,2016-07-12,15,2,5,0,6,28
1015,2016-07-13,13,0,7,0,6,26
1016,2016-07-14,12,0,7,0,4,23
1017,2016-07-15,3,0,11,0,6,20
1018,2016-07-16,16,0,8,0,4,28
1019,2016-07-17,13,0,2,0,9,24
1020,2016-07-18,11,1,2,0,12,26
1021,2016-07-19,9,0,4,0,10,23
1022,2016-07-20,12,1,9,0,2,24
1023,2016-07-21,29,1,8,0,1,39
1024,2016-07-22,31,1,7,0,0,39
1025,2016-07-23,31,0,5,0,0,36
1026,2016-07-24,42,0,6,0,2,50
1027,2016-07-25,19,0,8,0,6,33
1028,2016-07-26,17,0,10,0,2,29
1029,2016-07-27,14,0,8,0,2,24
1030,2016-07-28,12,0,5,1,5,23
1031,2016-07-29,7,0,11,0,6,24
1032,2016-07-30,18,1,5,0,3,27
1033,2016-07-31,29,0,4,0,2,35
1034,2016-08-01,19,0,6,0,4,29
1035,2016-08-02,12,0,2,1,1,16
1036,2016-08-03,17,1,6,0,2,26
1037,2016-08-04,9,0,8,0,3,20
1038,2016-08-05,6,0,8,1,1,16
1039,2016-08-06,8,1,4,0,2,15
1040,2016-08-07,16,1,10,0,1,28
1041,2016-08-08,14,1,12,0,1,28
1042,2016-08-09,11,0,9,0,7,27
1043,2016-08-10,12,0,7,0,2,21
1044,2016-08-11,9,0,1,0,5,15
1045,2016-08-12,10,0,3,0,6,19
1046,2016-08-13,9,0,4,1,4,18
1047,2016-08-14,7,1,6,0,2,16
1048,2016-08-15,12,0,6,0,2,20
1049,2016-08-16,17,1,10,0,6,34
1050,2016-08-17,14,0,10,0,15,39
1051,2016-08-18,20,1,6,0,2,29
1052,2016-08-19,20,0,10,0,4,34
1053,2016-08-20,18,0,5,1,2,26
1054,2016-08-21,16,0,11,0,0,27
1055,2016-08-22,10,0,10,0,10,30
1056,2016-08-23,10,0,5,0,5,20
1057,2016-08-24,22,0,4,0,3,29
1058,2016-08-25,8,0,7,0,16,31
1059,2016-08-26,7,0,9,0,13,29
1060,2016-08-27,21,0,5,0,3,29
1061,2016-08-28,18,1,8,0,4,31
1062,2016-08-29,12,1,9,0,2,24
1063,2016-08-30,11,0,6,0,3,20
1064,2016-08-31,6,0,2,0,2,10
1065,2016-09-01,15,1,6,0,4,26
1066,2016-09-02,13,0,12,0,1,26
1067,2016-09-03,19,0,5,0,1,25
1068,2016-09-04,39,0,5,1,3,48
1069,2016-09-05,12,0,7,0,3,22
1070,2016-09-06,11,0,15,0,5,31
1071,2016-09-07,13,0,7,0,1,21
1072,2016-09-08,16,1,15,0,4,36
1073,2016-09-09,11,0,10,0,11,32
1074,2016-09-10,16,0,7,0,1,24
1075,2016-09-11,20,1,6,0,3,30
1076,2016-09-12,15,0,9,0,13,37
1077,2016-09-13,11,1,12,0,8,32
1078,2016-09-14,9,3,4,0,2,18
1079,2016-09-15,7,0,4,0,6,17
1080,2016-09-16,7,0,9,1,1,18
1081,2016-09-17,15,0,5,0,5,25
1082,2016-09-18,13,0,4,0,4,21
1083,2016-09-19,10,0,13,0,2,25
1084,2016-09-20,12,1,5,1,7,26
1085,2016-09-21,18,1,8,0,7,34
1086,2016-09-22,14,0,6,0,7,27
1087,2016-09-23,12,3,7,0,7,29
1088,2016-09-24,22,0,8,0,8,38
1089,2016-09-25,17,0,7,0,3,27
1090,2016-09-26,10,0,11,0,10,31
1091,2016-09-27,2,0,6,0,6,14
1092,2016-09-28,10,0,13,0,3,26
1093,2016-09-29,7,0,3,0,13,23
1094,2016-09-30,14,0,8,0,4,26
1095,2016-10-01,26,0,10,0,5,41
1096,2016-10-02,11,0,8,0,3,22
1097,2016-10-03,12,0,15,0,6,33
1098,2016-10-04,11,2,9,1,1,24
1099,2016-10-05,15,0,8,0,2,25
1100,2016-10-06,18,0,1,0,4,23
1101,2016-10-07,25,0,4,0,1,30
1102,2016-10-08,20,0,5,0,4,29
1103,2016-10-09,22,1,9,0,2,34
1104,2016-10-10,10,0,11,0,5,26
1105,2016-10-11,7,0,8,1,2,18
1106,2016-10-12,11,0,6,0,1,18
1107,2016-10-13,4,0,8,0,5,17
1108,2016-10-14,11,0,10,0,2,23
1109,2016-10-15,14,1,9,0,2,26
1110,2016-10-16,20,0,4,0,2,26
1111,2016-10-17,8,0,12,1,7,28
1112,2016-10-18,10,2,11,0,12,35
1113,2016-10-19,10,0,3,0,10,23
1114,2016-10-20,11,1,10,0,9,31
1115,2016-10-21,7,2,6,0,3,18
1116,2016-10-22,9,0,6,2,3,20
1117,2016-10-23,20,0,4,0,7,31
1118,2016-10-24,7,0,9,0,11,27
1119,2016-10-25,8,1,8,1,3,21
1120,2016-10-26,11,1,5,0,6,23
1121,2016-10-27,8,0,3,0,6,17
1122,2016-10-28,7,0,5,1,6,19
1123,2016-10-29,13,0,4,0,3,20
1124,2016-10-30,11,0,2,0,3,16
1125,2016-10-31,12,0,6,0,4,22
1126,2016-11-01,9,2,8,0,2,21
1127,2016-11-02,9,0,7,1,6,23
1128,2016-11-03,8,0,9,0,4,21
1129,2016-11-04,20,1,8,0,14,43
1130,2016-11-05,16,0,8,0,2,26
1131,2016-11-06,16,0,12,0,6,34
1132,2016-11-07,13,0,5,0,5,23
1133,2016-11-08,12,0,5,0,8,25
1134,2016-11-09,3,0,11,0,0,14
1135,2016-11-10,10,1,6,0,6,23
1136,2016-11-11,7,2,11,0,10,30
1137,2016-11-12,18,0,12,0,2,32
1138,2016-11-13,18,0,15,0,3,36
1139,2016-11-14,10,1,12,0,13,36
1140,2016-11-15,6,0,9,0,11,26
1141,2016-11-16,6,0,6,0,1,13
1142,2016-11-17,5,0,16,0,2,23
1143,2016-11-18,15,0,18,0,1,34
1144,2016-11-19,15,0,12,0,6,33
1145,2016-11-20,13,0,11,1,2,27
1146,2016-11-21,11,0,11,0,2,24
1147,2016-11-22,10,1,9,0,5,25
1148,2016-11-23,7,0,4,1,6,18
1149,2016-11-24,0,0,2,0,0,2
1150,2016-11-25,32,0,7,0,5,44
1151,2016-11-26,36,0,16,0,12,64
1152,2016-11-27,27,2,6,0,0,35
1153,2016-11-28,19,1,10,0,6,36
1154,2016-11-29,14,2,11,0,8,35
1155,2016-11-30,9,1,6,0,7,23
1156,2016-12-01,7,0,7,0,0,14
1157,2016-12-02,7,0,3,0,2,12
1158,2016-12-03,6,0,8,0,6,20
1159,2016-12-04,15,0,8,0,4,27
1160,2016-12-05,7,1,7,0,5,20
1161,2016-12-06,6,2,10,0,3,21
1162,2016-12-07,18,1,16,0,3,38
1163,2016-12-08,14,1,13,0,2,30
1164,2016-12-09,8,0,12,0,6,26
1165,2016-12-10,22,0,8,1,8,39
1166,2016-12-11,18,0,9,0,6,33
1167,2016-12-12,10,1,8,0,18,37
1168,2016-12-13,20,0,7,0,1,28
1169,2016-12-14,11,1,7,0,4,23
1170,2016-12-15,14,1,6,0,1,22
1171,2016-12-16,10,1,6,0,1,18
1172,2016-12-17,18,0,6,1,3,28
1173,2016-12-18,21,0,5,0,7,33
1174,2016-12-19,8,2,9,0,0,19
1175,2016-12-20,21,0,7,1,6,35
1176,2016-12-21,16,0,3,0,1,20
1177,2016-12-22,13,1,0,0,13,27
1178,2016-12-23,12,0,8,0,6,26
1179,2016-12-24,21,0,4,0,0,25
1180,2016-12-25,1,0,0,0,0,1
1181,2016-12-26,14,0,6,0,3,23
1182,2016-12-27,15,0,16,0,2,33
1183,2016-12-28,10,2,7,0,5,24
1184,2016-12-29,9,0,26,0,8,43
1185,2016-12-30,25,0,4,1,9,39
1186,2016-12-31,25,0,9,0,3,37
1187,2017-01-01,2,0,7,1,0,10
1188,2017-01-02,24,0,16,0,1,41
1189,2017-01-03,15,0,11,0,3,29
1190,2017-01-04,0,0,2,0,0,2
1191,2017-01-05,9,1,9,0,10,29
1192,2017-01-06,17,0,14,0,3,34
1193,2017-01-07,17,0,13,0,3,33
1194,2017-01-08,17,0,6,0,4,27
1195,2017-01-09,10,1,9,0,2,22
1196,2017-01-10,15,0,9,0,6,30
1197,2017-01-11,7,0,5,1,2,15
1198,2017-01-12,15,0,9,0,9,33
1199,2017-01-13,13,0,10,0,3,26
1200,2017-01-14,16,0,5,3,7,31
1201,2017-01-15,13,0,12,0,11,36
1202,2017-01-16,12,2,16,0,6,36
1203,2017-01-17,9,0,5,0,4,18
1204,2017-01-18,13,1,5,0,17,36
1205,2017-01-19,8,0,8,0,6,22
1206,2017-01-20,9,0,6,0,3,18
1207,2017-01-21,5,0,6,0,1,12
1208,2017-01-22,19,0,8,0,4,31
1209,2017-01-23,15,1,12,0,5,33
1210,2017-01-24,18,0,6,0,5,29
1211,2017-01-25,9,0,11,0,2,22
1212,2017-01-26,12,0,13,0,5,30
1213,2017-01-27,8,0,5,0,4,17
1214,2017-01-28,44,0,7,0,1,52
1215,2017-01-29,50,0,4,1,2,57
1216,2017-01-30,11,1,1,0,10,23
1217,2017-01-31,19,0,3,0,2,24
1218,2017-02-01,10,0,4,0,2,16
1219,2017-02-02,12,0,11,0,2,25
1220,2017-02-03,17,1,13,0,7,38
1221,2017-02-04,16,0,10,0,4,30
1222,2017-02-05,18,0,6,0,4,28
1223,2017-02-06,12,1,13,0,9,35
1224,2017-02-07,7,0,5,0,8,20
1225,2017-02-08,13,0,12,0,6,31
1226,2017-02-09,10,0,5,0,16,31
1227,2017-02-10,29,0,15,0,4,48
1228,2017-02-11,55,1,9,0,3,68
1229,2017-02-12,51,0,3,0,0,54
1230,2017-02-13,13,0,7,1,11,32
1231,2017-02-14,21,0,12,0,14,47
1232,2017-02-15,8,0,7,1,2,18
1233,2017-02-16,8,0,8,1,4,21
1234,2017-02-17,8,0,16,0,8,32
1235,2017-02-18,10,0,8,0,0,18
1236,2017-02-19,15,1,8,0,2,26
1237,2017-02-20,15,1,9,0,7,32
1238,2017-02-21,17,0,12,0,9,38
1239,2017-02-22,13,2,8,0,1,24
1240,2017-02-23,10,0,7,1,11,29
1241,2017-02-24,15,0,9,0,4,28
1242,2017-02-25,13,1,11,0,8,33
1243,2017-02-26,24,0,12,0,1,37
1244,2017-02-27,10,0,2,0,13,25
1245,2017-02-28,13,0,3,0,7,23
1246,2017-03-01,14,0,8,0,5,27
1247,2017-03-02,16,0,13,0,6,35
1248,2017-03-03,13,0,9,0,4,26
1249,2017-03-04,15,1,13,0,1,30
1250,2017-03-05,9,0,7,0,3,19
1251,2017-03-06,8,0,14,0,7,29
1252,2017-03-07,4,0,17,0,1,22
1253,2017-03-08,10,0,13,0,6,29
1254,2017-03-09,7,0,11,0,3,21
1255,2017-03-10,5,0,6,0,10,21
1256,2017-03-11,8,0,11,0,1,20
1257,2017-03-12,9,0,7,0,3,19
1258,2017-03-13,13,0,8,1,18,40
1259,2017-03-14,8,0,9,0,10,27
1260,2017-03-15,14,0,12,0,4,30
1261,2017-03-16,7,0,14,0,7,28
1262,2017-03-17,8,0,11,0,11,30
1263,2017-03-18,12,0,9,2,4,27
1264,2017-03-19,22,0,6,0,4,32
1265,2017-03-20,13,1,6,0,5,25
1266,2017-03-21,12,0,7,0,6,25
1267,2017-03-22,5,0,6,0,3,14
1268,2017-03-23,8,0,14,0,1,23
1269,2017-03-24,6,0,4,0,16,26
1270,2017-03-25,11,0,9,0,1,21
1271,2017-03-26,16,1,8,1,1,27
1272,2017-03-27,9,0,9,0,10,28
1273,2017-03-28,12,0,11,0,19,42
1274,2017-03-29,7,0,12,0,4,23
1275,2017-03-30,11,0,7,0,7,25
1276,2017-03-31,9,0,10,0,1,20
1277,2017-04-01,13,0,7,0,3,23
1278,2017-04-02,10,1,9,0,0,20
1279,2017-04-03,16,0,5,0,10,31
1280,2017-04-04,18,0,8,0,10,36
1281,2017-04-05,8,0,13,0,3,24
1282,2017-04-06,1,0,2,0,2,5
1283,2017-04-07,11,0,6,0,4,21
1284,2017-04-08,20,0,5,0,4,29
1285,2017-04-09,22,0,4,0,2,28
1286,2017-04-10,7,0,14,0,10,31
1287,2017-04-11,15,0,9,0,14,38
1288,2017-04-12,17,3,10,0,4,34
1289,2017-04-13,21,0,9,0,2,32
1290,2017-04-14,20,1,6,0,9,36
1291,2017-04-15,31,0,10,0,1,42
1292,2017-04-16,18,1,6,0,3,28
1293,2017-04-17,14,0,6,0,8,28
1294,2017-04-18,8,0,6,0,10,24
1295,2017-04-19,10,0,7,0,9,26
1296,2017-04-20,3,0,6,0,4,13
1297,2017-04-21,6,0,7,0,2,15
1298,2017-04-22,13,0,12,0,3,28
1299,2017-04-23,11,0,7,0,6,24
1300,2017-04-24,5,0,10,0,6,21
1301,2017-04-25,7,0,9,0,4,20
1302,2017-04-26,13,0,9,0,11,33
1303,2017-04-27,9,1,6,0,7,23
1304,2017-04-28,11,0,16,0,15,42
1305,2017-04-29,2,0,3,1,1,7
1306,2017-04-30,10,0,11,0,3,24
1307,2017-05-01,7,2,7,1,4,21
1308,2017-05-02,10,0,8,0,7,25
1309,2017-05-03,21,0,8,0,16,45
1310,2017-05-04,6,1,8,0,6,21
1311,2017-05-05,8,0,9,0,8,25
1312,2017-05-06,22,0,7,0,3,32
1313,2017-05-07,16,0,3,1,2,22
1314,2017-05-08,21,0,8,0,1,30
1315,2017-05-09,23,0,17,0,5,45
1316,2017-05-10,12,0,5,0,6,23
1317,2017-05-11,12,0,13,0,2,27
1318,2017-05-12,7,1,9,0,2,19
1319,2017-05-13,11,0,9,0,0,20
1320,2017-05-14,11,0,9,0,10,30
1321,2017-05-15,5,0,6,0,12,23
1322,2017-05-16,9,0,10,0,2,21
1323,2017-05-17,10,1,8,0,8,27
1324,2017-05-18,4,0,6,1,5,16
1325,2017-05-19,15,0,8,0,21,44
1326,2017-05-20,16,0,4,1,2,23
1327,2017-05-21,12,1,5,0,2,20
1328,2017-05-22,9,1,9,0,7,26
1329,2017-05-23,12,1,4,0,4,21
1330,2017-05-24,10,1,9,0,13,33
1331,2017-05-25,9,0,13,0,7,29
1332,2017-05-26,18,0,10,0,16,44
1333,2017-05-27,35,0,7,0,0,42
1334,2017-05-28,33,0,11,1,4,49
1335,2017-05-29,39,0,7,0,2,48
1336,2017-05-30,14,0,11,0,10,35
1337,2017-05-31,10,0,9,0,13,32
1338,2017-06-01,7,0,8,1,2,18
1339,2017-06-02,5,1,7,0,9,22
1340,2017-06-03,10,0,6,0,6,22
1341,2017-06-04,14,1,12,0,1,28
1342,2017-06-05,8,0,9,0,4,21
1343,2017-06-06,21,0,9,0,6,36
1344,2017-06-07,9,0,8,0,2,19
1345,2017-06-08,7,0,10,0,4,21
1346,2017-06-09,19,0,8,0,5,32
1347,2017-06-10,21,0,5,0,0,26
1348,2017-06-11,13,1,6,1,1,22
1349,2017-06-12,20,0,9,0,2,31
1350,2017-06-13,12,0,7,0,8,27
1351,2017-06-14,6,0,6,0,1,13
1352,2017-06-15,7,2,4,0,1,14
1353,2017-06-16,12,0,7,0,4,23
1354,2017-06-17,9,0,17,0,2,28
1355,2017-06-18,17,1,3,0,1,22
1356,2017-06-19,5,1,13,0,15,34
1357,2017-06-20,12,0,10,0,12,34
1358,2017-06-21,9,0,13,0,1,23
1359,2017-06-22,12,0,4,0,7,23
1360,2017-06-23,14,0,10,0,11,35
1361,2017-06-24,21,0,5,1,4,31
1362,2017-06-25,14,0,8,1,2,25
1363,2017-06-26,13,0,3,0,12,28
1364,2017-06-27,15,4,14,0,10,43
1365,2017-06-28,3,0,12,0,4,19
1366,2017-06-29,14,1,5,0,1,21
1367,2017-06-30,8,0,9,0,3,20
1368,2017-07-01,10,0,4,0,5,19
1369,2017-07-02,19,0,14,0,4,37
1370,2017-07-03,12,0,10,1,20,43
1371,2017-07-04,13,1,5,0,13,32
1372,2017-07-05,11,2,10,0,1,24
1373,2017-07-06,12,0,15,1,9,37
1374,2017-07-07,13,0,7,0,9,29
1375,2017-07-08,14,0,9,0,1,24
1376,2017-07-09,4,0,3,0,1,8
1377,2017-07-10,16,1,11,0,5,33
1378,2017-07-11,10,0,4,0,22,36
1379,2017-07-12,17,0,6,0,9,32
1380,2017-07-13,16,0,9,0,9,34
1381,2017-07-14,14,0,8,0,7,29
1382,2017-07-15,15,1,6,0,1,23
1383,2017-07-16,11,0,4,0,1,16
1384,2017-07-17,6,1,10,0,16,33
1385,2017-07-18,19,0,8,0,9,36
1386,2017-07-19,3,1,6,0,4,14
1387,2017-07-20,8,0,5,0,4,17
1388,2017-07-21,14,0,8,0,8,30
1389,2017-07-22,11,1,5,0,6,23
1390,2017-07-23,15,1,6,0,0,22
1391,2017-07-24,14,1,10,1,4,30
1392,2017-07-25,16,1,8,0,11,36
1393,2017-07-26,11,0,5,0,3,19
1394,2017-07-27,7,0,6,0,0,13
1395,2017-07-28,13,0,7,0,6,26
1396,2017-07-29,33,0,7,0,2,42
1397,2017-07-30,18,0,4,0,5,27
1398,2017-07-31,17,0,6,0,0,23
1399,2017-08-01,12,0,10,0,13,35
1400,2017-08-02,11,1,11,0,4,27
1401,2017-08-03,10,0,10,0,3,23
1402,2017-08-04,8,0,13,0,10,31
1403,2017-08-05,13,0,5,0,5,23
1404,2017-08-06,10,0,8,0,3,21
1405,2017-08-07,12,0,5,0,12,29
1406,2017-08-08,9,0,6,0,16,31
1407,2017-08-09,5,0,4,0,1,10
1408,2017-08-10,11,0,6,0,7,24
1409,2017-08-11,8,0,5,0,6,19
1410,2017-08-12,13,0,9,0,4,26
1411,2017-08-13,10,0,9,0,2,21
1412,2017-08-14,11,0,6,0,9,26
1413,2017-08-15,12,0,5,0,12,29
1414,2017-08-16,13,1,1,0,6,21
1415,2017-08-17,15,0,15,1,16,47
1416,2017-08-18,10,1,8,0,3,22
1417,2017-08-19,79,0,1,0,1,81
1418,2017-08-20,9,1,3,0,2,15
1419,2017-08-21,9,0,8,0,2,19
1420,2017-08-22,7,0,5,0,15,27
1421,2017-08-23,18,1,5,0,5,29
1422,2017-08-24,14,0,6,0,7,27
1423,2017-08-25,9,0,6,0,4,19
1424,2017-08-26,12,0,10,0,2,24
1425,2017-08-27,8,0,7,0,4,19
1426,2017-08-28,16,0,8,0,4,28
1427,2017-08-29,11,0,10,0,1,22
1428,2017-08-30,9,0,15,0,0,24
1429,2017-08-31,13,0,11,0,3,27
1430,2017-09-01,14,0,2,0,4,20
1431,2017-09-02,21,1,8,0,1,31
1432,2017-09-03,21,0,9,0,1,31
1433,2017-09-04,18,0,17,0,14,49
1434,2017-09-05,20,0,10,0,5,35
1435,2017-09-06,12,0,12,0,4,28
1436,2017-09-07,8,0,5,0,8,21
1437,2017-09-08,6,0,12,0,1,19
1438,2017-09-09,22,0,5,0,1,28
1439,2017-09-10,15,0,8,0,1,24
1440,2017-09-11,7,0,9,0,2,18
1441,2017-09-12,18,0,5,1,5,29
1442,2017-09-13,8,0,15,0,1,24
1443,2017-09-14,3,0,8,1,7,19
1444,2017-09-15,5,3,8,0,27,43
1445,2017-09-16,27,0,11,0,3,41
1446,2017-09-17,15,0,7,0,9,31
1447,2017-09-18,5,0,5,0,8,18
1448,2017-09-19,12,0,12,0,8,32
1449,2017-09-20,11,0,5,0,6,22
1450,2017-09-21,6,0,5,0,18,29
1451,2017-09-22,6,0,9,0,8,23
1452,2017-09-23,8,2,6,1,0,17
1453,2017-09-24,15,1,12,0,5,33
1454,2017-09-25,8,0,10,0,1,19
1455,2017-09-26,9,0,5,0,13,27
1456,2017-09-27,7,1,11,1,8,28
1457,2017-09-28,6,1,6,0,12,25
1458,2017-09-29,19,1,10,0,17,47
1459,2017-09-30,15,1,6,0,0,22
1460,2017-10-01,15,1,6,0,0,22
1461,2017-10-02,15,1,15,0,10,41
1462,2017-10-03,8,0,10,0,70,88
1463,2017-10-04,11,1,16,0,29,57
1464,2017-10-05,11,0,5,0,12,28
1465,2017-10-06,12,0,10,0,12,34
1466,2017-10-07,21,1,4,0,0,26
1467,2017-10-08,27,0,7,0,2,36
1468,2017-10-09,14,0,3,0,18,35
1469,2017-10-10,12,1,9,0,4,26
1470,2017-10-11,11,1,6,1,5,24
1471,2017-10-12,12,0,8,1,3,24
1472,2017-10-13,12,3,7,0,3,25
1473,2017-10-14,9,0,12,0,4,25
1474,2017-10-15,14,0,19,0,1,34
1475,2017-10-16,11,0,8,0,12,31
1476,2017-10-17,16,0,12,0,18,46
1477,2017-10-18,10,0,8,0,1,19
1478,2017-10-19,13,0,5,0,3,21
1479,2017-10-20,9,0,7,0,7,23
1480,2017-10-21,13,0,4,0,1,18
1481,2017-10-22,12,0,10,0,1,23
1482,2017-10-23,9,0,15,0,8,32
1483,2017-10-24,9,0,11,0,4,24
1484,2017-10-25,1,0,7,0,12,20
1485,2017-10-26,14,0,2,0,8,24
1486,2017-10-27,12,0,4,0,5,21
1487,2017-10-28,29,0,11,0,2,42
1488,2017-10-29,23,1,1,0,2,27
1489,2017-10-30,24,1,6,0,6,37
1490,2017-10-31,12,0,4,0,5,21
1491,2017-11-01,20,0,9,0,3,32
1492,2017-11-02,6,0,15,0,2,23
1493,2017-11-03,6,1,4,0,12,23
1494,2017-11-04,9,0,8,0,0,17
1495,2017-11-05,6,0,10,0,1,17
1496,2017-11-06,10,0,13,0,4,27
1497,2017-11-07,9,0,12,0,1,22
1498,2017-11-08,11,0,5,0,13,29
1499,2017-11-09,8,0,9,0,8,25
1500,2017-11-10,9,0,3,0,5,17
1501,2017-11-11,6,0,5,0,5,16
1502,2017-11-12,12,0,9,0,1,22
1503,2017-11-13,13,1,14,0,1,29
1504,2017-11-14,8,0,8,0,9,25
1505,2017-11-15,8,0,9,0,4,21
1506,2017-11-16,10,0,10,0,9,29
1507,2017-11-17,9,0,4,0,20,33
1508,2017-11-18,19,0,6,0,3,28
1509,2017-11-19,10,0,8,0,3,21
1510,2017-11-20,7,0,6,0,8,21
1511,2017-11-21,11,1,10,0,5,27
1512,2017-11-22,8,1,0,0,7,16
1513,2017-11-23,1,1,5,0,0,7
1514,2017-11-24,16,0,6,0,0,22
1515,2017-11-25,15,0,5,0,1,21
1516,2017-11-26,26,0,10,0,9,45
1517,2017-11-27,14,0,7,0,1,22
1518,2017-11-28,11,0,5,0,10,26
1519,2017-11-29,4,1,7,0,6,18
1520,2017-11-30,7,0,7,0,6,20
1521,2017-12-01,11,0,7,0,15,33
1522,2017-12-02,9,0,12,0,1,22
1523,2017-12-03,11,0,5,0,2,18
1524,2017-12-04,5,0,4,0,3,12
1525,2017-12-05,2,1,11,0,2,16
1526,2017-12-06,4,0,8,0,4,16
1527,2017-12-07,6,0,7,0,4,17
1528,2017-12-08,8,0,7,0,8,23
1529,2017-12-09,24,0,11,0,12,47
1530,2017-12-10,16,0,8,0,1,25
1531,2017-12-11,21,0,5,0,3,29
1532,2017-12-12,14,0,9,0,6,29
1533,2017-12-13,9,0,10,0,8,27
1534,2017-12-14,9,0,5,0,5,19
1535,2017-12-15,12,1,12,0,4,29
1536,2017-12-16,7,0,5,0,1,13
1537,2017-12-17,16,0,7,0,0,23
1538,2017-12-18,10,1,11,0,8,30
1539,2017-12-19,8,0,7,0,0,15
1540,2017-12-20,13,0,9,0,4,26
1541,2017-12-21,15,0,7,0,16,38
1542,2017-12-22,19,0,4,0,4,27
1543,2017-12-23,18,0,10,0,8,36
1544,2017-12-24,7,1,9,0,1,18
1545,2017-12-25,0,0,2,0,0,2
1546,2017-12-26,15,0,16,0,10,41
1547,2017-12-27,16,0,10,0,2,28
1548,2017-12-28,10,1,8,0,4,23
1549,2017-12-29,16,2,6,1,2,27
1550,2017-12-30,13,0,7,0,0,20
1551,2017-12-31,22,0,6,0,4,32
1552,2018-01-01,0,0,2,0,0,2
1553,2018-01-02,6,0,10,0,3,19
1554,2018-01-03,16,0,2,0,4,22
1555,2018-01-04,19,1,15,0,4,39
1556,2018-01-05,11,0,7,0,4,22
1557,2018-01-06,12,0,7,0,0,19
1558,2018-01-07,15,0,6,0,3,24
1559,2018-01-08,14,2,11,1,1,29
1560,2018-01-09,8,1,3,0,1,13
1561,2018-01-10,12,0,9,0,6,27
1562,2018-01-11,8,0,5,0,6,19
1563,2018-01-12,14,0,9,0,4,27
1564,2018-01-13,18,0,4,0,4,26
1565,2018-01-14,34,0,8,0,8,50
1566,2018-01-15,15,1,3,0,5,24
1567,2018-01-16,0,0,5,0,0,5
1568,2018-01-17,14,0,6,0,7,27
1569,2018-01-18,13,0,7,1,9,30
1570,2018-01-19,7,0,11,0,4,22
1571,2018-01-20,14,0,15,0,0,29
1572,2018-01-21,15,0,10,0,0,25
1573,2018-01-22,13,0,14,0,5,32
1574,2018-01-23,9,0,6,0,3,18
1575,2018-01-24,8,0,15,0,13,36
1576,2018-01-25,14,0,8,0,11,33
1577,2018-01-26,9,0,8,0,2,19
1578,2018-01-27,18,0,4,0,1,23
1579,2018-01-28,17,0,8,0,1,26
1580,2018-01-29,17,1,5,0,9,32
1581,2018-01-30,5,0,6,0,12,23
1582,2018-01-31,8,0,14,0,5,27
1583,2018-02-01,17,1,8,0,2,28
1584,2018-02-02,15,1,7,0,4,27
1585,2018-02-03,23,1,7,1,3,35
1586,2018-02-04,18,0,4,0,2,24
1587,2018-02-05,10,0,6,1,3,20
1588,2018-02-06,9,0,7,0,9,25
1589,2018-02-07,7,0,15,0,0,22
1590,2018-02-08,6,1,9,0,13,29
1591,2018-02-09,16,0,8,0,5,29
1592,2018-02-10,16,0,6,0,2,24
1593,2018-02-11,13,1,15,0,0,29
1594,2018-02-12,10,1,9,0,12,32
1595,2018-02-13,15,0,14,0,3,32
1596,2018-02-14,8,0,5,0,6,19
1597,2018-02-15,11,0,4,0,9,24
1598,2018-02-16,12,1,7,0,8,28
1599,2018-02-17,10,0,7,0,3,20
1600,2018-02-18,15,0,6,0,1,22
1601,2018-02-19,16,0,8,0,6,30
1602,2018-02-20,14,0,5,0,14,33
1603,2018-02-21,8,1,6,0,5,20
1604,2018-02-22,6,5,3,0,1,15
1605,2018-02-23,13,0,5,0,4,22
1606,2018-02-24,14,0,7,0,2,23
1607,2018-02-25,13,2,9,0,1,25
1608,2018-02-26,9,0,4,0,1,14
1609,2018-02-27,9,0,4,0,11,24
1610,2018-02-28,18,0,9,0,13,40
1611,2018-03-01,14,1,8,0,5,28
1612,2018-03-02,14,0,5,0,5,24
1613,2018-03-03,15,0,8,0,12,35
1614,2018-03-04,26,0,7,0,1,34
1615,2018-03-05,13,0,11,0,1,25
1616,2018-03-06,9,0,11,0,10,30
1617,2018-03-07,0,0,7,0,0,7
1618,2018-03-08,12,2,7,1,2,24
1619,2018-03-09,7,0,9,0,7,23
1620,2018-03-10,50,0,6,0,0,56
1621,2018-03-11,31,0,7,0,1,39
1622,2018-03-12,18,0,9,0,1,28
1623,2018-03-13,8,0,7,0,5,20
1624,2018-03-14,9,0,10,0,0,19
1625,2018-03-15,7,0,11,1,5,24
1626,2018-03-16,17,0,6,0,2,25
1627,2018-03-17,42,0,8,0,0,50
1628,2018-03-18,22,0,3,0,0,25
1629,2018-03-19,9,2,5,0,3,19
1630,2018-03-20,8,0,9,0,3,20
1631,2018-03-21,8,0,10,0,13,31
1632,2018-03-22,6,1,9,0,7,23
1633,2018-03-23,7,1,9,0,2,19
1634,2018-03-24,10,0,9,1,3,23
1635,2018-03-25,22,0,4,0,0,26
1636,2018-03-26,8,0,9,0,2,19
1637,2018-03-27,11,0,10,0,4,25
1638,2018-03-28,13,0,8,0,4,25
1639,2018-03-29,16,1,14,0,2,33
1640,2018-03-30,22,1,9,0,13,45
1641,2018-03-31,13,1,10,0,2,26
1642,2018-04-01,18,1,3,0,8,30
1643,2018-04-02,6,0,6,0,10,22
1644,2018-04-03,11,0,11,0,11,33
1645,2018-04-04,15,0,5,0,13,33
1646,2018-04-05,16,1,15,0,6,38
1647,2018-04-06,20,0,6,0,12,38
1648,2018-04-07,10,0,6,0,4,20
1649,2018-04-08,17,0,7,0,4,28
1650,2018-04-09,6,0,3,0,1,10
1651,2018-04-10,17,0,9,0,7,33
1652,2018-04-11,12,0,9,0,3,24
1653,2018-04-12,2,0,12,0,6,20
1654,2018-04-13,12,1,10,0,3,26
1655,2018-04-14,16,0,10,0,6,32
1656,2018-04-15,14,0,11,0,1,26
1657,2018-04-16,14,0,8,0,13,35
1658,2018-04-17,10,0,13,0,7,30
1659,2018-04-18,3,0,10,0,7,20
1660,2018-04-19,8,2,6,0,0,16
1661,2018-04-20,12,1,7,0,7,27
1662,2018-04-21,19,0,7,0,3,29
1663,2018-04-22,17,0,1,0,1,19
1664,2018-04-23,6,0,8,0,2,16
1665,2018-04-24,8,0,9,0,5,22
1666,2018-04-25,14,0,14,0,8,36
1667,2018-04-26,13,0,11,1,3,28
1668,2018-04-27,10,0,14,0,8,32
1669,2018-04-28,10,0,4,0,3,17
1670,2018-04-29,15,0,13,0,1,29
1671,2018-04-30,15,1,13,0,7,36
1672,2018-05-01,14,0,3,0,2,19
1673,2018-05-02,12,3,4,1,8,28
1674,2018-05-03,5,0,7,0,17,29
1675,2018-05-04,16,0,8,0,3,27
1676,2018-05-05,11,0,9,0,0,20
1677,2018-05-06,34,0,8,0,0,42
1678,2018-05-07,9,0,11,0,8,28
1679,2018-05-08,7,0,7,0,14,28
1680,2018-05-09,14,0,3,0,5,22
1681,2018-05-10,16,0,10,0,6,32
1682,2018-05-11,10,0,10,0,5,25
1683,2018-05-12,10,0,10,0,15,35
1684,2018-05-13,16,0,7,0,2,25
1685,2018-05-14,11,1,2,0,7,21
1686,2018-05-15,9,0,4,0,2,15
1687,2018-05-16,15,1,10,0,10,36
1688,2018-05-17,9,0,4,0,1,14
1689,2018-05-18,8,0,6,0,1,15
1690,2018-05-19,15,0,6,0,3,24
1691,2018-05-20,11,0,3,0,5,19
1692,2018-05-21,10,0,9,0,14,33
1693,2018-05-22,14,0,8,0,16,38
1694,2018-05-23,4,0,9,0,2,15
1695,2018-05-24,5,0,9,1,8,23
1696,2018-05-25,11,1,4,1,10,27
1697,2018-05-26,17,0,10,0,2,29
1698,2018-05-27,27,1,11,0,1,40
1699,2018-05-28,36,0,6,0,6,48
1700,2018-05-29,18,0,12,1,15,46
1701,2018-05-30,18,0,7,0,0,25
1702,2018-05-31,11,0,8,0,6,25
1703,2018-06-01,12,0,4,0,5,21
1704,2018-06-02,18,1,7,0,3,29
1705,2018-06-03,20,0,9,0,1,30
1706,2018-06-04,6,0,9,0,5,20
1707,2018-06-05,16,1,6,0,4,27
1708,2018-06-06,17,0,9,0,1,27
1709,2018-06-07,8,0,5,0,15,28
1710,2018-06-08,5,1,7,1,4,18
1711,2018-06-09,17,0,3,0,3,23
1712,2018-06-10,17,0,9,0,1,27
1713,2018-06-11,21,0,10,0,3,34
1714,2018-06-12,11,0,11,0,9,31
1715,2018-06-13,7,0,6,0,7,20
1716,2018-06-14,8,0,5,0,7,20
1717,2018-06-15,11,0,2,0,16,29
1718,2018-06-16,9,0,5,0,3,17
1719,2018-06-17,7,0,9,0,1,17
1720,2018-06-18,11,0,5,0,11,27
1721,2018-06-19,10,0,9,0,7,26
1722,2018-06-20,5,0,3,0,7,15
1723,2018-06-21,6,1,3,0,5,15
1724,2018-06-22,13,0,7,0,15,35
1725,2018-06-23,25,0,6,1,2,34
1726,2018-06-24,11,2,4,0,1,18
1727,2018-06-25,19,0,5,0,5,29
1728,2018-06-26,20,0,11,0,13,44
1729,2018-06-27,22,0,9,0,5,36
1730,2018-06-28,13,0,6,0,5,24
1731,2018-06-29,15,0,7,0,5,27
1732,2018-06-30,14,0,5,0,2,21
1733,2018-07-01,23,0,5,0,0,28
1734,2018-07-02,18,0,7,1,9,35
1735,2018-07-03,13,1,6,0,1,21
1736,2018-07-04,8,0,5,0,1,14
1737,2018-07-05,10,0,7,0,20,37
1738,2018-07-06,11,0,11,2,13,37
1739,2018-07-07,17,0,11,0,1,29
1740,2018-07-08,18,1,11,1,1,32
1741,2018-07-09,15,0,10,0,7,32
1742,2018-07-10,19,0,15,0,13,47
1743,2018-07-11,8,0,13,1,4,26
1744,2018-07-12,10,0,4,1,9,24
1745,2018-07-13,14,0,7,0,9,30
1746,2018-07-14,26,1,2,0,2,31
1747,2018-07-15,9,0,14,1,4,28
1748,2018-07-16,21,0,5,1,0,27
1749,2018-07-17,13,1,4,0,7,25
1750,2018-07-18,10,0,7,0,11,28
1751,2018-07-19,6,0,8,1,9,24
1752,2018-07-20,6,0,2,0,1,9
1753,2018-07-21,16,0,5,0,5,26
1754,2018-07-22,14,0,3,0,7,24
1755,2018-07-23,11,0,9,0,6,26
1756,2018-07-24,7,0,6,0,16,29
1757,2018-07-25,7,0,9,0,3,19
1758,2018-07-26,14,0,6,0,9,29
1759,2018-07-27,9,0,5,0,10,24
1760,2018-07-28,23,0,11,0,1,35
1761,2018-07-29,27,0,4,0,0,31
1762,2018-07-30,17,0,1,0,14,32
1763,2018-07-31,10,0,2,0,6,18
1764,2018-08-01,8,0,5,0,2,15
1765,2018-08-02,6,0,9,0,12,27
1766,2018-08-03,8,0,6,0,8,22
1767,2018-08-04,13,0,6,1,0,20
1768,2018-08-05,15,0,5,0,1,21
1769,2018-08-06,12,0,11,0,13,36
1770,2018-08-07,4,0,7,0,12,23
1771,2018-08-08,15,0,2,0,10,27
1772,2018-08-09,9,0,10,0,5,24
1773,2018-08-10,12,1,6,0,5,24
1774,2018-08-11,13,0,7,0,1,21
1775,2018-08-12,36,0,5,0,16,57
1776,2018-08-13,15,0,4,0,7,26
1777,2018-08-14,16,0,12,0,28,56
1778,2018-08-15,18,0,7,0,7,32
1779,2018-08-16,11,0,6,0,6,23
1780,2018-08-17,16,0,7,2,10,35
1781,2018-08-18,66,0,4,0,1,71
1782,2018-08-19,31,0,4,0,1,36
1783,2018-08-20,16,0,2,0,3,21
1784,2018-08-21,18,0,5,0,5,28
1785,2018-08-22,17,1,13,0,2,33
1786,2018-08-23,14,0,10,0,5,29
1787,2018-08-24,21,0,6,0,4,31
1788,2018-08-25,14,0,9,0,0,23
1789,2018-08-26,11,0,9,0,7,27
1790,2018-08-27,11,0,7,0,2,20
1791,2018-08-28,14,1,1,1,1,18
1792,2018-08-29,6,0,4,0,2,12
1793,2018-08-30,5,1,8,0,1,15
1794,2018-08-31,10,0,11,0,0,21
1795,2018-09-01,12,0,9,0,4,25
1796,2018-09-02,14,0,7,1,2,24
1797,2018-09-03,24,1,11,0,5,41
1798,2018-09-04,11,1,4,0,7,23
1799,2018-09-05,8,0,12,0,7,27
1800,2018-09-06,10,1,6,0,13,30
1801,2018-09-07,7,0,13,0,5,25
1802,2018-09-08,18,0,13,0,5,36
1803,2018-09-09,13,0,14,2,1,30
1804,2018-09-10,7,0,5,0,1,13
1805,2018-09-11,12,0,8,0,20,40
1806,2018-09-12,9,1,7,0,15,32
1807,2018-09-13,11,0,11,0,14,36
1808,2018-09-14,15,1,11,0,7,34
1809,2018-09-15,16,0,6,0,1,23
1810,2018-09-16,7,0,8,0,0,15
1811,2018-09-17,22,1,9,0,2,34
1812,2018-09-18,18,0,7,0,21,46
1813,2018-09-19,17,1,3,0,2,23
1814,2018-09-20,11,0,8,0,5,24
1815,2018-09-21,14,0,10,0,10,34
1816,2018-09-22,17,0,14,0,6,37
1817,2018-09-23,10,1,8,0,2,21
1818,2018-09-24,13,0,11,0,10,34
1819,2018-09-25,11,0,11,0,13,35
1820,2018-09-26,8,0,12,1,10,31
1821,2018-09-27,8,0,4,0,3,15
1822,2018-09-28,6,0,13,0,13,32
1823,2018-09-29,14,0,7,0,5,26
1824,2018-09-30,16,0,3,0,2,21
1825,2018-10-01,10,0,9,0,10,29
1826,2018-10-02,7,0,5,0,5,17
1827,2018-10-03,5,0,10,1,4,20
1828,2018-10-04,4,0,6,1,4,15
1829,2018-10-05,25,0,6,0,2,33
1830,2018-10-06,18,0,11,0,1,30
1831,2018-10-07,24,0,6,0,1,31
1832,2018-10-08,21,0,4,0,14,39
1833,2018-10-09,17,1,4,0,11,33
1834,2018-10-10,15,0,10,0,2,27
1835,2018-10-11,7,0,9,0,5,21
1836,2018-10-12,9,0,15,0,4,28
1837,2018-10-13,15,0,12,1,5,33
1838,2018-10-14,18,0,4,0,3,25
1839,2018-10-15,16,0,11,0,7,34
1840,2018-10-16,17,0,6,0,10,33
1841,2018-10-17,17,0,6,0,7,30
1842,2018-10-18,13,1,5,0,2,21
1843,2018-10-19,13,0,5,0,8,26
1844,2018-10-20,20,0,4,0,4,28
1845,2018-10-21,7,0,9,0,6,22
1846,2018-10-22,18,0,14,0,4,36
1847,2018-10-23,22,0,14,0,2,38
1848,2018-10-24,12,0,12,0,22,46
1849,2018-10-25,8,0,10,0,4,22
1850,2018-10-26,7,0,9,0,15,31
1851,2018-10-27,16,0,3,0,13,32
1852,2018-10-28,9,0,3,0,3,15
1853,2018-10-29,10,0,4,0,5,19
1854,2018-10-30,6,0,10,0,10,26
1855,2018-10-31,7,0,9,0,4,20
1856,2018-11-01,2,0,6,0,12,20
1857,2018-11-02,6,0,12,0,8,26
1858,2018-11-03,8,0,7,0,4,19
1859,2018-11-04,6,0,11,0,8,25
1860,2018-11-05,6,0,9,0,3,18
1861,2018-11-06,5,0,5,0,7,17
1862,2018-11-07,3,0,7,1,11,22
1863,2018-11-08,6,0,6,0,5,17
1864,2018-11-09,5,0,7,0,6,18
1865,2018-11-10,7,1,10,0,2,20
1866,2018-11-11,6,0,8,0,2,16
1867,2018-11-12,1,0,15,0,9,25
1868,2018-11-13,7,0,13,0,12,32
1869,2018-11-14,1,0,8,0,14,23
1870,2018-11-15,3,0,11,0,3,17
1871,2018-11-16,6,0,9,0,7,22
1872,2018-11-17,10,0,12,0,4,26
1873,2018-11-18,2,0,6,0,1,9
1874,2018-11-19,6,0,6,0,1,13
1875,2018-11-20,2,0,5,0,11,18
1876,2018-11-21,0,0,4,0,5,9
1877,2018-11-22,0,0,3,0,0,3
1878,2018-11-23,19,0,7,0,4,30
1879,2018-11-24,9,0,14,0,2,25
1880,2018-11-25,8,1,5,0,4,18
1881,2018-11-26,8,1,7,0,15,31
1882,2018-11-27,6,0,7,0,8,21
1883,2018-11-28,6,0,10,1,4,21
1884,2018-11-29,7,0,2,0,14,23
1885,2018-11-30,13,0,3,0,3,19
1886,2018-12-01,2,0,2,0,2,6
1887,2018-12-02,7,0,10,0,2,19
1888,2018-12-03,6,0,8,0,5,19
1889,2018-12-04,17,0,9,0,14,40
1890,2018-12-05,8,0,9,0,5,22
1891,2018-12-06,17,0,5,0,15,37
1892,2018-12-07,12,1,4,0,4,21
1893,2018-12-08,14,0,7,2,0,23
1894,2018-12-09,9,0,4,0,2,15
1895,2018-12-10,15,0,12,0,2,29
1896,2018-12-11,19,0,17,0,9,45
1897,2018-12-12,19,0,8,0,6,33
1898,2018-12-13,16,0,8,0,7,31
1899,2018-12-14,31,0,14,0,17,62
1900,2018-12-15,24,0,15,0,2,41
1901,2018-12-16,26,0,12,0,14,52
1902,2018-12-17,24,0,7,0,5,36
1903,2018-12-18,21,0,5,0,2,28
1904,2018-12-19,11,0,7,1,3,22
1905,2018-12-20,25,0,11,0,0,36
1906,2018-12-21,17,0,16,0,2,35
1907,2018-12-22,18,0,8,0,1,27
1908,2018-12-23,22,0,7,0,2,31
1909,2018-12-24,12,0,8,0,3,23
1910,2018-12-25,1,0,1,0,1,3
1911,2018-12-26,19,0,3,0,5,27
1912,2018-12-27,30,0,12,0,2,44
1913,2018-12-28,19,0,4,0,10,33
1914,2018-12-29,13,1,14,1,5,34
1915,2018-12-30,21,0,5,0,1,27
1916,2018-12-31,13,0,5,0,8,26
1917,2019-01-01,1,0,4,0,0,5
1918,2019-01-02,19,0,13,0,2,34
1919,2019-01-03,20,0,9,0,7,36
1920,2019-01-04,22,0,10,0,1,33
1921,2019-01-05,18,0,10,0,3,31
1922,2019-01-06,15,0,5,1,3,24
1923,2019-01-07,21,0,9,0,6,36
1924,2019-01-08,12,1,9,0,21,43
1925,2019-01-09,14,1,11,1,3,30
1926,2019-01-10,15,0,7,0,1,23
1927,2019-01-11,26,0,11,0,2,39
1928,2019-01-12,20,0,8,0,2,30
1929,2019-01-13,17,0,7,0,9,33
1930,2019-01-14,15,0,13,0,3,31
1931,2019-01-15,13,1,7,0,8,29
1932,2019-01-16,21,0,5,0,10,36
1933,2019-01-17,16,0,1,0,7,24
1934,2019-01-18,17,0,2,0,8,27
1935,2019-01-19,32,0,10,0,3,45
1936,2019-01-20,20,0,10,0,0,30
1937,2019-01-21,24,0,13,0,9,46
1938,2019-01-22,22,1,6,0,1,30
1939,2019-01-23,22,0,10,0,14,46
1940,2019-01-24,16,1,5,0,3,25
1941,2019-01-25,17,0,2,0,3,22
1942,2019-01-26,23,0,13,0,0,36
1943,2019-01-27,19,0,5,0,1,25
1944,2019-01-28,18,0,3,0,5,26
1945,2019-01-29,12,2,8,0,10,32
1946,2019-01-30,14,0,9,0,7,30
1947,2019-01-31,8,2,10,0,9,29
1948,2019-02-01,11,0,11,0,4,26
1949,2019-02-02,13,0,7,1,3,24
1950,2019-02-03,20,0,4,0,3,27
1951,2019-02-04,9,1,6,1,1,18
1952,2019-02-05,8,0,9,0,5,22
1953,2019-02-06,15,0,8,0,9,32
1954,2019-02-07,14,0,5,0,8,27
1955,2019-02-08,9,0,7,0,2,18
1956,2019-02-09,20,0,8,0,5,33
1957,2019-02-10,18,0,5,0,3,26
1958,2019-02-11,22,0,8,0,1,31
1959,2019-02-12,18,0,9,0,13,40
1960,2019-02-13,18,0,10,0,8,36
1961,2019-02-14,21,0,8,0,5,34
1962,2019-02-15,17,0,11,1,7,36
1963,2019-02-16,21,0,7,0,1,29
1964,2019-02-17,12,0,5,0,1,18
1965,2019-02-18,14,0,12,0,7,33
1966,2019-02-19,13,0,6,0,11,30
1967,2019-02-20,16,2,5,0,2,25
1968,2019-02-21,11,1,5,0,3,20
1969,2019-02-22,14,2,9,0,5,30
1970,2019-02-23,13,0,7,0,1,21
1971,2019-02-24,17,0,8,1,4,30
1972,2019-02-25,18,1,8,0,6,33
1973,2019-02-26,9,0,8,0,10,27
1974,2019-02-27,11,0,8,0,14,33
1975,2019-02-28,10,0,10,0,2,22
1976,2019-03-01,11,0,8,0,6,25
1977,2019-03-02,11,1,8,0,2,22
1978,2019-03-03,24,0,7,0,2,33
1979,2019-03-04,15,0,12,0,5,32
1980,2019-03-05,3,0,8,0,12,23
1981,2019-03-06,9,0,7,4,3,23
1982,2019-03-07,12,1,9,1,7,30
1983,2019-03-08,23,1,10,0,9,43
1984,2019-03-09,32,0,7,0,11,50
1985,2019-03-10,21,0,14,0,2,37
1986,2019-03-11,15,0,10,0,7,32
1987,2019-03-12,21,0,9,0,8,38
1988,2019-03-13,10,2,5,0,6,23
1989,2019-03-14,9,0,2,0,5,16
1990,2019-03-15,10,0,10,2,9,31
1991,2019-03-16,27,0,16,1,0,44
1992,2019-03-17,9,0,6,0,0,15
1993,2019-03-18,19,0,6,0,6,31
1994,2019-03-19,18,0,6,0,5,29
1995,2019-03-20,11,0,9,0,21,41
1996,2019-03-21,13,0,6,0,7,26
1997,2019-03-22,19,0,5,0,26,50
1998,2019-03-23,24,0,5,0,1,30
1999,2019-03-24,10,1,6,0,3,20
2000,2019-03-25,16,1,10,0,14,41
2001,2019-03-26,23,0,13,2,7,45
2002,2019-03-27,16,0,8,0,17,41
2003,2019-03-28,13,0,6,1,1,21
2004,2019-03-29,12,0,7,0,8,27
2005,2019-03-30,17,0,7,1,2,27
2006,2019-03-31,19,0,11,0,2,32
2007,2019-04-01,12,1,5,0,4,22
2008,2019-04-02,17,2,9,0,11,39
2009,2019-04-03,15,0,9,1,11,36
2010,2019-04-04,13,1,9,0,4,27
2011,2019-04-05,14,1,5,0,0,20
2012,2019-04-06,10,0,8,0,7,25
2013,2019-04-07,17,0,5,0,7,29
2014,2019-04-08,7,0,18,0,6,31
2015,2019-04-09,8,0,5,0,8,21
2016,2019-04-10,15,1,11,0,20,47
2017,2019-04-11,8,0,16,1,3,28
2018,2019-04-12,20,0,12,0,13,45
2019,2019-04-13,36,0,9,0,0,45
2020,2019-04-14,19,1,11,0,3,34
2021,2019-04-15,12,0,11,0,25,48
2022,2019-04-16,16,0,4,0,6,26
2023,2019-04-17,6,0,8,0,8,22
2024,2019-04-18,6,0,14,0,15,35
2025,2019-04-19,13,1,8,0,4,26
2026,2019-04-20,12,1,8,0,1,22
2027,2019-04-21,15,1,3,0,1,20
2028,2019-04-22,9,0,7,0,4,20
2029,2019-04-23,20,0,10,0,9,39
2030,2019-04-24,15,0,7,0,10,32
2031,2019-04-25,6,0,11,0,7,24
2032,2019-04-26,17,0,12,1,11,41
2033,2019-04-27,17,0,7,0,0,24
2034,2019-04-28,16,0,7,0,1,24
2035,2019-04-29,4,0,8,0,8,20
2036,2019-04-30,20,2,4,0,18,44
2037,2019-05-01,9,0,9,1,6,25
2038,2019-05-02,9,1,4,1,3,18
2039,2019-05-03,8,0,12,0,1,21
2040,2019-05-04,10,1,7,0,9,27
2041,2019-05-05,24,0,8,0,2,34
2042,2019-05-06,8,0,20,0,5,33
2043,2019-05-07,4,0,17,0,8,29
2044,2019-05-08,12,0,15,0,6,33
2045,2019-05-09,10,0,9,0,9,28
2046,2019-05-10,14,0,9,0,2,25
2047,2019-05-11,18,0,9,0,6,33
2048,2019-05-12,42,0,13,0,2,57
2049,2019-05-13,18,2,4,1,15,40
2050,2019-05-14,23,1,7,1,12,44
2051,2019-05-15,23,0,11,0,5,39
2052,2019-05-16,16,3,7,0,13,39
2053,2019-05-17,5,1,4,1,1,12
2054,2019-05-18,10,1,14,0,3,28
2055,2019-05-19,11,0,5,0,3,19
2056,2019-05-20,11,0,6,0,7,24
2057,2019-05-21,11,0,10,0,3,24
2058,2019-05-22,11,0,7,1,10,29
2059,2019-05-23,14,1,5,0,4,24
2060,2019-05-24,8,0,5,0,6,19
2061,2019-05-25,23,0,10,1,3,37
2062,2019-05-26,16,0,11,0,6,33
2063,2019-05-27,12,2,3,0,7,24
2064,2019-05-28,15,0,11,0,14,40
2065,2019-05-29,14,0,8,0,17,39
2066,2019-05-30,12,0,5,0,4,21
2067,2019-05-31,14,0,9,1,8,32
2068,2019-06-01,13,0,10,0,7,30
2069,2019-06-02,19,0,5,2,2,28
2070,2019-06-03,20,0,14,0,13,47
2071,2019-06-04,21,1,10,0,2,34
2072,2019-06-05,8,1,8,0,13,30
2073,2019-06-06,12,0,9,0,6,27
2074,2019-06-07,13,1,5,0,20,39
2075,2019-06-08,22,1,6,0,9,38
2076,2019-06-09,20,1,4,3,3,31
2077,2019-06-10,16,1,14,2,5,38
2078,2019-06-11,21,0,7,0,9,37
2079,2019-06-12,16,1,9,1,9,36
2080,2019-06-13,16,0,5,1,17,39
2081,2019-06-14,16,3,6,0,9,34
2082,2019-06-15,16,0,8,0,6,30
2083,2019-06-16,30,1,8,2,4,45
2084,2019-06-17,14,0,6,3,2,25
2085,2019-06-18,13,0,6,0,14,33
2086,2019-06-19,13,2,7,0,16,38
2087,2019-06-20,16,0,11,1,6,34
2088,2019-06-21,13,0,10,0,3,26
2089,2019-06-22,14,0,9,1,1,25
2090,2019-06-23,13,0,6,0,4,23
2091,2019-06-24,7,0,11,1,4,23
2092,2019-06-25,6,0,8,0,19,33
2093,2019-06-26,11,0,6,0,12,29
2094,2019-06-27,17,0,8,0,38,63
2095,2019-06-28,17,0,7,0,38,62
2096,2019-06-29,32,1,3,0,7,43
2097,2019-06-30,32,0,6,0,4,42
2098,2019-07-01,18,2,8,0,1,29
2099,2019-07-02,15,0,3,1,12,31
2100,2019-07-03,18,0,9,1,7,35
2101,2019-07-04,8,0,1,0,0,9
2102,2019-07-05,19,0,15,0,16,50
2103,2019-07-06,23,1,5,0,3,32
2104,2019-07-07,23,1,10,1,1,36
2105,2019-07-08,11,0,11,0,8,30
2106,2019-07-09,13,0,11,0,15,39
2107,2019-07-10,15,0,10,1,20,46
2108,2019-07-11,9,0,7,0,5,21
2109,2019-07-12,16,0,4,0,4,24
2110,2019-07-13,5,1,5,0,14,25
2111,2019-07-14,13,1,4,0,1,19
2112,2019-07-15,13,0,9,0,6,28
2113,2019-07-16,18,1,19,0,6,44
2114,2019-07-17,19,1,9,0,19,48
2115,2019-07-18,9,0,6,0,9,24
2116,2019-07-19,4,2,25,0,9,40
2117,2019-07-20,22,0,10,0,7,39
2118,2019-07-21,15,0,7,1,0,23
2119,2019-07-22,8,0,13,0,4,25
2120,2019-07-23,17,0,6,0,22,45
2121,2019-07-24,18,1,6,0,14,39
2122,2019-07-25,14,2,8,0,2,26
2123,2019-07-26,10,1,9,0,3,23
2124,2019-07-27,14,0,6,0,2,22
2125,2019-07-28,18,1,12,0,3,34
2126,2019-07-29,14,0,4,0,1,19
2127,2019-07-30,11,1,3,1,12,28
2128,2019-07-31,13,1,3,0,5,22
2129,2019-08-01,9,0,6,0,6,21
2130,2019-08-02,10,0,12,0,1,23
2131,2019-08-03,10,1,7,0,14,32
2132,2019-08-04,17,0,11,0,5,33
2133,2019-08-05,11,0,6,0,13,30
2134,2019-08-06,14,1,6,0,7,28
2135,2019-08-07,15,0,9,0,8,32
2136,2019-08-08,16,0,9,0,12,37
2137,2019-08-09,17,1,5,0,6,29
2138,2019-08-10,22,0,2,1,1,26
2139,2019-08-11,23,0,11,2,2,38
2140,2019-08-12,13,0,5,1,7,26
2141,2019-08-13,16,0,4,0,13,33
2142,2019-08-14,13,0,5,3,9,30
2143,2019-08-15,18,0,4,0,4,26
2144,2019-08-16,16,0,8,3,9,36
2145,2019-08-17,60,0,9,0,0,69
2146,2019-08-18,25,0,5,0,0,30
2147,2019-08-19,28,0,11,0,5,44
2148,2019-08-20,14,0,2,0,1,17
2149,2019-08-21,14,0,10,0,12,36
2150,2019-08-22,16,0,5,1,11,33
2151,2019-08-23,18,3,7,0,9,37
2152,2019-08-24,14,0,3,0,3,20
2153,2019-08-25,24,0,8,0,1,33
2154,2019-08-26,9,0,6,0,2,17
2155,2019-08-27,17,0,6,0,12,35
2156,2019-08-28,19,1,8,0,5,33
2157,2019-08-29,8,1,9,0,16,34
2158,2019-08-30,24,0,4,0,2,30
2159,2019-08-31,13,1,3,0,11,28
2160,2019-09-01,20,0,4,0,2,26
2161,2019-09-02,9,2,6,0,7,24
2162,2019-09-03,10,1,5,0,14,30
2163,2019-09-04,7,0,14,1,7,29
2164,2019-09-05,12,0,6,0,2,20
2165,2019-09-06,15,2,4,0,13,34
2166,2019-09-07,18,0,6,0,6,30
2167,2019-09-08,15,0,12,0,2,29
2168,2019-09-09,17,1,6,1,9,34
2169,2019-09-10,11,0,18,0,16,45
2170,2019-09-11,8,0,8,1,6,23
2171,2019-09-12,14,0,9,1,3,27
2172,2019-09-13,16,0,8,1,5,30
2173,2019-09-14,23,0,6,0,0,29
2174,2019-09-15,22,0,7,0,2,31
2175,2019-09-16,18,2,5,0,10,35
2176,2019-09-17,17,0,8,0,18,43
2177,2019-09-18,10,0,2,0,8,20
2178,2019-09-19,12,1,4,0,6,23
2179,2019-09-20,15,0,6,0,5,26
2180,2019-09-21,17,0,5,0,23,45
2181,2019-09-22,14,1,6,0,1,22
2182,2019-09-23,15,0,12,0,3,30
2183,2019-09-24,9,0,7,0,8,24
2184,2019-09-25,16,1,8,0,15,40
2185,2019-09-26,13,0,7,0,12,32
2186,2019-09-27,13,0,8,0,13,34
2187,2019-09-28,22,0,3,0,2,27
2188,2019-09-29,24,0,8,0,6,38
2189,2019-09-30,16,1,4,0,8,29
2190,2019-10-01,16,1,6,2,4,29
2191,2019-10-02,9,0,3,0,20,32
2192,2019-10-03,13,0,7,0,1,21
2193,2019-10-04,12,0,6,0,6,24
2194,2019-10-05,14,0,8,0,7,29
2195,2019-10-06,15,0,15,1,3,34
2196,2019-10-07,21,0,8,0,0,29
2197,2019-10-08,14,0,5,0,13,32
2198,2019-10-09,15,1,4,0,16,36
2199,2019-10-10,7,1,4,0,9,21
2200,2019-10-11,5,0,6,0,4,15
2201,2019-10-12,10,0,11,0,1,22
2202,2019-10-13,23,0,10,0,2,35
2203,2019-10-14,14,1,14,0,9,38
2204,2019-10-15,16,0,16,0,16,48
2205,2019-10-16,11,0,7,0,4,22
2206,2019-10-17,11,0,8,0,6,25
2207,2019-10-18,9,0,7,0,7,23
2208,2019-10-19,16,0,2,1,1,20
2209,2019-10-20,16,0,9,0,0,25
2210,2019-10-21,8,0,6,0,2,16
2211,2019-10-22,9,1,2,1,19,32
2212,2019-10-23,8,0,5,0,22,35
2213,2019-10-24,7,0,4,1,7,19
2214,2019-10-25,20,1,8,0,5,34
2215,2019-10-26,21,0,9,0,13,43
2216,2019-10-27,24,0,8,0,1,33
2217,2019-10-28,20,0,8,0,6,34
2218,2019-10-29,19,0,8,0,6,33
2219,2019-10-30,18,0,6,0,12,36
2220,2019-10-31,19,0,9,0,5,33
2221,2019-11-01,13,0,1,0,2,16
2222,2019-11-02,13,0,9,0,2,24
2223,2019-11-03,17,0,17,0,2,36
2224,2019-11-04,20,0,3,0,5,28
2225,2019-11-05,12,0,4,0,13,29
2226,2019-11-06,9,1,4,0,12,26
2227,2019-11-07,10,0,6,0,5,21
2228,2019-11-08,15,0,8,0,3,26
2229,2019-11-09,20,0,5,0,5,30
2230,2019-11-10,15,1,2,0,3,21
2231,2019-11-11,17,2,5,0,3,27
2232,2019-11-12,12,2,4,0,14,32
2233,2019-11-13,14,0,7,0,0,21
2234,2019-11-14,10,0,7,0,13,30
2235,2019-11-15,5,0,10,0,12,27
2236,2019-11-16,10,0,14,0,3,27
2237,2019-11-17,12,0,10,0,1,23
2238,2019-11-18,15,0,9,0,17,41
2239,2019-11-19,20,0,10,0,7,37
2240,2019-11-20,7,0,10,0,6,23
2241,2019-11-21,11,1,10,0,12,34
2242,2019-11-22,12,0,8,0,2,22
2243,2019-11-23,9,0,6,0,0,15
2244,2019-11-24,15,1,7,0,6,29
2245,2019-11-25,11,0,6,0,27,44
2246,2019-11-26,21,0,4,0,4,29
2247,2019-11-27,20,2,5,0,1,28
2248,2019-11-29,43,1,9,0,4,57
2249,2019-11-30,26,0,2,0,5,33
2250,2019-12-01,25,1,5,0,1,32
2251,2019-12-02,22,0,1,0,3,26
2252,2019-12-03,27,0,7,0,16,50
2253,2019-12-04,19,0,2,0,18,39
2254,2019-12-05,13,0,11,0,2,26
2255,2019-12-06,23,0,5,0,2,30
2256,2019-12-07,17,0,4,0,1,22
2257,2019-12-08,22,0,8,0,7,37
2258,2019-12-09,24,0,1,0,4,29
2259,2019-12-10,21,0,9,0,0,30
2260,2019-12-11,13,0,5,0,4,22
2261,2019-12-12,22,0,10,0,6,38
2262,2019-12-13,14,0,8,0,5,27
2263,2019-12-14,10,0,7,0,0,17
2264,2019-12-15,12,0,4,0,1,17
2265,2019-12-16,7,0,7,0,13,27
2266,2019-12-17,17,0,14,0,10,41
2267,2019-12-18,11,0,9,0,3,23
2268,2019-12-19,24,0,13,0,4,41
2269,2019-12-20,15,0,6,1,1,23
2270,2019-12-21,21,0,5,0,0,26
2271,2019-12-22,19,0,6,0,6,31
2272,2019-12-23,19,0,10,0,2,31
2273,2019-12-24,0,0,1,0,0,1
2274,2019-12-26,22,0,5,1,9,37
2275,2019-12-27,12,0,7,0,7,26
2276,2019-12-28,18,0,2,0,0,20
2277,2019-12-29,8,1,7,0,5,21
2278,2019-12-30,18,1,8,2,15,44
2279,2019-12-31,26,0,9,1,8,44
2280,2020-01-01,0,0,1,0,0,1
2281,2020-01-02,18,0,12,1,16,47
2282,2020-01-03,14,0,20,0,10,44
2283,2020-01-04,14,1,11,0,5,31
2284,2020-01-05,19,0,6,0,2,27
2285,2020-01-06,21,0,10,0,3,34
2286,2020-01-07,15,0,5,0,4,24
2287,2020-01-08,23,0,13,1,10,47
2288,2020-01-09,11,0,2,0,9,22
2289,2020-01-10,12,0,3,0,17,32
2290,2020-01-11,17,1,9,0,2,29
2291,2020-01-12,16,0,9,0,1,26
2292,2020-01-13,12,1,5,0,3,21
2293,2020-01-14,13,1,4,0,16,34
2294,2020-01-15,7,0,4,0,9,20
2295,2020-01-16,7,3,3,0,2,15
2296,2020-01-17,15,0,8,0,2,25
2297,2020-01-18,26,1,7,0,1,35
2298,2020-01-19,17,0,12,0,3,32
2299,2020-01-20,0,1,0,0,0,1
2300,2020-01-21,16,0,12,0,5,33
2301,2020-01-22,13,1,6,0,15,35
2302,2020-01-23,7,0,6,0,12,25
2303,2020-01-24,13,0,7,0,0,20
2304,2020-01-25,19,0,6,0,5,30
2305,2020-01-26,14,1,6,0,3,24
2306,2020-01-27,20,0,4,0,0,24
2307,2020-01-28,11,2,10,0,10,33
2308,2020-01-29,16,1,13,0,2,32
2309,2020-01-30,7,1,7,0,12,27
2310,2020-01-31,21,0,4,0,1,26
2311,2020-02-01,15,0,10,0,0,25
2312,2020-02-02,18,0,6,0,5,29
2313,2020-02-03,13,1,3,0,1,18
2314,2020-02-04,17,1,6,0,10,34
2315,2020-02-05,10,0,4,0,7,21
2316,2020-02-06,7,0,5,0,5,17
2317,2020-02-07,17,1,6,0,4,28
2318,2020-02-08,11,0,4,0,4,19
2319,2020-02-09,9,0,4,0,5,18
2320,2020-02-10,16,0,11,0,4,31
2321,2020-02-11,17,0,8,0,4,29
2322,2020-02-12,0,0,0,0,16,16
2323,2020-02-13,18,0,4,0,4,26
2324,2020-02-14,25,2,7,1,8,43
2325,2020-02-15,28,0,6,0,1,35
2326,2020-02-16,25,0,3,0,6,34
2327,2020-02-18,22,1,15,0,17,55
2328,2020-02-19,19,1,5,0,17,42
2329,2020-02-20,9,0,9,1,11,30
2330,2020-02-21,8,0,2,0,10,20
2331,2020-02-22,11,1,2,0,0,14
2332,2020-02-23,3,1,7,0,1,12
2333,2020-02-24,12,0,6,0,1,19
2334,2020-02-25,16,0,5,1,29,51
2335,2020-02-26,7,1,19,0,0,27
2336,2020-02-27,22,1,4,1,7,35
2337,2020-02-28,14,0,6,0,3,23
2338,2020-02-29,23,1,8,0,4,36
2339,2020-03-01,18,0,2,0,1,21
2340,2020-03-02,13,0,7,1,8,29
2341,2020-03-03,12,1,5,0,7,25
2342,2020-03-04,10,0,5,1,20,36
2343,2020-03-05,22,0,1,2,2,27
2344,2020-03-06,10,1,10,0,8,29
2345,2020-03-07,18,0,3,0,2,23
2346,2020-03-08,14,0,2,0,4,20
2347,2020-03-09,15,0,10,0,0,25
2348,2020-03-10,17,2,8,1,6,34
2349,2020-03-11,12,0,6,0,2,20
2350,2020-03-12,12,0,3,1,21,37
2351,2020-03-13,13,1,13,0,2,29
2352,2020-03-14,24,0,6,0,1,31
2353,2020-03-15,27,1,6,0,2,36
2354,2020-03-16,9,0,5,0,6,20
2355,2020-03-17,6,0,6,1,17,30
2356,2020-03-18,2,0,3,0,7,12
2357,2020-03-19,0,0,2,0,3,5
2358,2020-03-20,0,0,1,0,10,11
2359,2020-03-21,3,0,0,0,0,3
2360,2020-03-22,0,0,4,1,0,5
2361,2020-03-23,0,0,2,0,2,4
2362,2020-03-24,0,1,23,0,15,39
2363,2020-03-25,6,0,1,0,6,13
2364,2020-03-26,4,0,3,0,2,9
2365,2020-03-27,1,0,2,0,1,4
2366,2020-03-28,5,1,5,0,0,11
2367,2020-03-29,1,1,6,0,0,8
2368,2020-03-30,0,1,0,0,1,2
2369,2020-03-31,15,0,1,0,0,16
2370,2020-04-01,5,0,3,0,0,8
2371,2020-04-02,8,0,2,1,0,11
2372,2020-04-03,2,0,1,0,3,6
2373,2020-04-04,10,0,5,0,1,16
2374,2020-04-05,3,0,5,0,2,10
2375,2020-04-06,2,0,2,0,0,4
2376,2020-04-07,17,0,3,0,0,20
2377,2020-04-08,5,0,0,0,3,8
2378,2020-04-09,4,0,4,0,1,9
2379,2020-04-10,3,0,3,0,1,7
2380,2020-04-11,2,1,1,0,1,5
2381,2020-04-13,1,0,6,0,3,10
2382,2020-04-14,3,1,2,0,5,11
2383,2020-04-15,11,1,2,0,0,14
2384,2020-04-16,13,0,4,0,2,19
2385,2020-04-17,0,0,1,0,1,2
2386,2020-04-18,5,0,1,0,2,8
2387,2020-04-19,0,3,0,0,2,5
2388,2020-04-20,2,0,1,0,0,3
2389,2020-04-21,10,0,3,0,5,18
2390,2020-04-22,2,0,1,0,1,4
2391,2020-04-23,2,0,0,0,1,3
2392,2020-04-24,4,0,1,0,1,6
2393,2020-04-25,0,0,2,0,0,2
2394,2020-04-26,4,0,1,0,0,5
2395,2020-04-27,1,1,1,0,2,5
2396,2020-04-28,3,0,3,0,1,7
2397,2020-04-29,7,0,2,0,2,11
2398,2020-04-30,3,0,1,0,1,5
2399,2020-05-01,2,0,4,0,1,7
2400,2020-05-02,6,0,0,0,3,9
2401,2020-05-03,0,0,0,0,2,2
2402,2020-05-04,3,0,1,0,0,4
2403,2020-05-05,4,0,2,0,4,10
2404,2020-05-06,6,0,3,0,1,10
2405,2020-05-07,11,0,5,1,1,18
2406,2020-05-08,6,0,1,0,2,9
2407,2020-05-09,5,0,0,0,4,9
2408,2020-05-10,0,0,1,0,1,2
2409,2020-05-11,2,0,0,0,2,4
2410,2020-05-12,11,0,3,0,2,16
2411,2020-05-13,7,0,4,0,1,12
2412,2020-05-14,7,0,0,0,0,7
2413,2020-05-15,6,0,3,0,0,9
2414,2020-05-16,7,0,2,0,5,14
2415,2020-05-17,3,0,2,0,2,7
2416,2020-05-18,5,0,0,0,1,6
2417,2020-05-19,5,0,2,0,0,7
2418,2020-05-20,7,0,3,0,0,10
2419,2020-05-21,1,0,0,0,2,3
2420,2020-05-22,5,0,1,0,1,7
2421,2020-05-23,0,0,0,0,3,3
2422,2020-05-24,4,0,7,0,1,12
2423,2020-05-26,7,1,5,0,3,16
2424,2020-05-27,9,1,8,0,6,24
2425,2020-05-28,4,0,1,0,2,7
2426,2020-05-29,4,0,3,0,0,7
2427,2020-05-30,3,0,3,2,3,11
2428,2020-05-31,3,0,1,0,0,4
2429,2020-06-01,1,0,8,0,2,11
2430,2020-06-02,14,0,2,0,3,19
2431,2020-06-03,8,0,8,0,10,26
2432,2020-06-04,4,0,0,0,2,6
2433,2020-06-05,4,0,5,0,1,10
2434,2020-06-06,6,0,2,0,2,10
2435,2020-06-07,3,0,1,0,1,5
2436,2020-06-08,8,0,4,0,7,19
2437,2020-06-09,11,0,2,0,2,15
2438,2020-06-10,6,1,2,1,5,15
2439,2020-06-11,5,1,1,0,4,11
2440,2020-06-12,3,1,0,0,6,10
2441,2020-06-13,2,0,1,0,2,5
2442,2020-06-14,3,0,4,0,0,7
2443,2020-06-15,10,0,3,0,4,17
2444,2020-06-16,6,0,9,0,3,18
2445,2020-06-17,6,1,5,0,1,13
2446,2020-06-18,5,1,2,0,0,8
2447,2020-06-19,5,0,1,0,3,9
2448,2020-06-20,4,0,2,0,2,8
2449,2020-06-21,4,0,0,0,1,5
2450,2020-06-22,9,0,2,0,8,19
2451,2020-06-23,11,0,0,0,12,23
2452,2020-06-24,6,0,1,0,0,7
2453,2020-06-25,4,0,1,0,4,9
2454,2020-06-26,8,0,4,0,0,12
2455,2020-06-27,2,0,0,0,0,2
2456,2020-06-28,3,0,4,0,0,7
2457,2020-06-29,5,0,4,1,1,11
2458,2020-06-30,6,1,4,0,1,12
2459,2020-07-01,6,0,8,0,4,18
2460,2020-07-02,6,0,1,0,1,8
2461,2020-07-03,0,1,2,0,1,4
2462,2020-07-04,5,0,0,1,2,8
2463,2020-07-05,2,0,6,0,0,8
2464,2020-07-06,6,0,0,1,2,9
2465,2020-07-07,10,4,3,0,6,23
2466,2020-07-08,6,0,1,0,1,8
2467,2020-07-09,4,0,1,0,5,10
2468,2020-07-10,4,0,1,0,3,8
2469,2020-07-11,6,0,1,0,0,7
2470,2020-07-12,4,1,2,0,2,9
2471,2020-07-13,5,0,6,0,4,15
2472,2020-07-14,5,0,2,0,15,22
2473,2020-07-15,5,1,4,1,4,15
2474,2020-07-16,6,0,2,0,4,12
2475,2020-07-17,11,0,3,0,0,14
2476,2020-07-18,3,0,7,0,4,14
2477,2020-07-19,2,0,0,0,0,2
2478,2020-07-20,5,0,5,1,4,15
2479,2020-07-21,6,1,0,0,0,7
2480,2020-07-22,1,1,1,0,12,15
2481,2020-07-23,5,0,0,0,2,7
2482,2020-07-24,0,0,4,0,2,6
2483,2020-07-25,3,0,0,0,0,3
2484,2020-07-26,6,0,0,0,0,6
2485,2020-07-27,3,0,10,0,4,17
2486,2020-07-28,19,0,2,0,3,24
2487,2020-07-29,5,0,0,0,7,12
2488,2020-07-30,4,0,2,0,3,9
2489,2020-07-31,6,0,3,0,1,10
2490,2020-08-01,6,0,3,0,5,14
2491,2020-08-02,4,0,4,0,4,12
2492,2020-08-03,4,0,1,0,5,10
2493,2020-08-04,7,0,3,1,3,14
2494,2020-08-05,6,0,1,0,6,13
2495,2020-08-06,15,0,5,0,5,25
2496,2020-08-07,6,0,3,0,4,13
2497,2020-08-08,7,0,2,0,4,13
2498,2020-08-09,0,0,0,0,2,2
2499,2020-08-10,5,0,0,0,4,9
2500,2020-08-11,22,0,4,0,8,34
2501,2020-08-12,9,0,2,1,2,14
2502,2020-08-13,8,0,3,0,1,12
2503,2020-08-14,6,0,3,1,2,12
2504,2020-08-15,3,0,0,0,1,4
2505,2020-08-16,5,0,2,0,1,8
2506,2020-08-17,8,0,4,0,2,14
2507,2020-08-18,11,0,1,0,0,12
2508,2020-08-19,5,0,4,0,8,17
2509,2020-08-20,8,0,0,0,1,9
2510,2020-08-21,3,0,3,0,1,7
2511,2020-08-22,8,1,1,0,2,12
2512,2020-08-23,1,0,1,0,2,4
2513,2020-08-24,8,0,1,0,0,9
2514,2020-08-25,7,0,6,0,8,21
2515,2020-08-26,9,0,4,0,7,20
2516,2020-08-27,3,0,3,0,3,9
2517,2020-08-28,11,0,3,0,16,30
2518,2020-08-29,5,0,2,0,4,11
2519,2020-08-30,1,1,4,0,1,7
2520,2020-08-31,7,2,3,0,0,12
2521,2020-09-01,7,0,4,0,7,18
2522,2020-09-02,8,0,0,0,0,8
2523,2020-09-03,4,0,2,0,0,6
2524,2020-09-04,3,0,5,0,0,8
2525,2020-09-05,5,0,8,0,5,18
2526,2020-09-06,2,0,2,0,0,4
2527,2020-09-07,0,0,1,0,0,1
2528,2020-09-08,14,0,3,0,6,23
2529,2020-09-09,9,0,3,0,1,13
2530,2020-09-10,7,1,3,0,3,14
2531,2020-09-11,5,0,1,0,3,9
2532,2020-09-12,16,0,2,0,2,20
2533,2020-09-13,1,0,1,0,0,2
2534,2020-09-14,16,0,13,0,10,39
2535,2020-09-15,8,0,1,0,8,17
2536,2020-09-16,7,0,2,0,0,9
2537,2020-09-17,7,1,1,0,5,14
2538,2020-09-18,8,0,5,0,1,14
2539,2020-09-19,4,0,4,0,1,9
2540,2020-09-20,2,0,4,0,2,8
2541,2020-09-21,9,0,1,0,1,11
2542,2020-09-22,16,0,6,1,6,29
2543,2020-09-23,12,0,6,0,0,18
2544,2020-09-24,9,1,2,0,1,13
2545,2020-09-25,9,2,1,0,1,13
2546,2020-09-26,17,1,5,0,1,24
2547,2020-09-27,0,0,3,0,1,4
2548,2020-09-28,12,0,3,0,2,17
2549,2020-09-29,12,0,1,0,7,20
2550,2020-09-30,3,1,2,0,5,11
2551,2020-10-01,13,0,3,0,0,16
2552,2020-10-02,2,0,6,0,0,8
2553,2020-10-03,3,1,1,0,0,5
2554,2020-10-04,0,0,3,0,5,8
2555,2020-10-05,5,0,13,0,8,26
2556,2020-10-06,13,0,3,0,8,24
2557,2020-10-07,3,0,5,0,0,8
2558,2020-10-08,11,0,1,0,2,14
2559,2020-10-09,8,0,11,0,3,22
2560,2020-10-10,9,0,1,0,1,11
2561,2020-10-11,1,0,1,0,2,4
2562,2020-10-12,2,0,0,0,2,4
2563,2020-10-13,16,0,7,0,2,25
2564,2020-10-14,5,2,3,0,1,11
2565,2020-10-15,5,0,4,0,3,12
2566,2020-10-16,12,0,0,0,2,14
2567,2020-10-17,2,0,6,0,3,11
2568,2020-10-18,1,0,2,0,0,3
2569,2020-10-19,8,0,0,0,1,9
2570,2020-10-20,15,0,1,0,10,26
2571,2020-10-21,4,0,2,0,0,6
2572,2020-10-22,8,1,2,0,1,12
2573,2020-10-23,14,0,2,1,0,17
2574,2020-10-24,5,0,1,0,0,6
2575,2020-10-25,3,0,3,0,3,9
2576,2020-10-26,6,0,3,0,1,10
2577,2020-10-27,11,1,3,0,9,24
2578,2020-10-28,6,0,4,0,7,17
2579,2020-10-29,3,0,5,0,2,10
2580,2020-10-30,7,0,5,0,3,15
2581,2020-10-31,9,1,2,0,1,13
2582,2020-11-01,1,0,1,0,1,3
2583,2020-11-02,9,0,3,0,1,13
2584,2020-11-03,5,0,3,0,8,16
2585,2020-11-04,4,1,2,0,3,10
2586,2020-11-05,4,0,3,1,2,10
2587,2020-11-06,7,1,3,2,4,17
2588,2020-11-07,6,0,2,0,1,9
2589,2020-11-08,4,0,2,0,9,15
2590,2020-11-09,6,0,6,1,0,13
2591,2020-11-10,8,1,1,0,8,18
2592,2020-11-12,10,0,10,0,4,24
2593,2020-11-13,7,0,3,0,18,28
2594,2020-11-14,8,1,1,1,1,12
2595,2020-11-15,4,1,3,0,2,10
2596,2020-11-16,4,0,4,1,3,12
2597,2020-11-17,6,1,1,0,6,14
2598,2020-11-18,4,0,2,0,2,8
2599,2020-11-19,3,1,5,0,2,11
2600,2020-11-20,4,0,3,0,1,8
2601,2020-11-21,10,0,2,1,4,17
2602,2020-11-22,3,0,3,0,0,6
2603,2020-11-23,10,0,5,1,1,17
2604,2020-11-24,9,2,5,0,11,27
2605,2020-11-25,5,0,7,0,1,13
2606,2020-11-26,0,0,0,0,2,2
2607,2020-11-27,0,0,1,0,0,1
2608,2020-11-28,11,0,1,0,0,12
2609,2020-11-29,4,1,1,0,3,9
2610,2020-11-30,13,0,1,0,4,18
2611,2020-12-01,9,0,4,0,7,20
2612,2020-12-02,8,0,3,0,8,19
2613,2020-12-03,12,1,3,0,14,30
2614,2020-12-04,11,0,5,0,25,41
2615,2020-12-05,10,0,2,0,1,13
2616,2020-12-06,3,0,0,0,1,4
2617,2020-12-07,10,1,6,0,4,21
2618,2020-12-08,13,0,4,0,13,30
2619,2020-12-09,10,1,5,0,2,18
2620,2020-12-10,7,0,6,0,3,16
2621,2020-12-11,7,0,3,1,4,15
2622,2020-12-12,5,1,1,1,0,8
2623,2020-12-13,2,1,2,0,3,8
2624,2020-12-14,12,1,4,0,3,20
2625,2020-12-15,14,0,5,1,0,20
2626,2020-12-16,5,0,4,0,5,14
2627,2020-12-17,5,0,3,0,9,17
2628,2020-12-18,11,0,3,0,7,21
2629,2020-12-19,12,0,6,0,0,18
2630,2020-12-20,4,0,0,0,0,4
2631,2020-12-21,11,0,3,0,7,21
2632,2020-12-22,14,0,2,0,2,18
2633,2020-12-23,5,0,1,0,3,9
2634,2020-12-26,6,0,5,0,1,12
2635,2020-12-27,2,0,1,0,0,3
2636,2020-12-28,13,2,3,0,3,21
2637,2020-12-29,4,0,3,0,5,12
2638,2020-12-30,7,0,2,0,0,9
2639,2020-12-31,8,0,2,0,3,13
2640,2021-01-02,5,0,9,0,8,22
2641,2021-01-03,4,0,2,0,3,9
2642,2021-01-04,2,0,1,0,1,4
2643,2021-01-05,5,2,2,2,3,14
2644,2021-01-06,14,0,5,0,1,20
2645,2021-01-07,8,0,5,0,6,19
2646,2021-01-08,7,1,4,0,3,15
2647,2021-01-09,6,2,0,0,0,8
2648,2021-01-10,2,0,0,0,1,3
2649,2021-01-11,7,0,2,0,6,15
2650,2021-01-12,4,0,1,1,5,11
2651,2021-01-13,5,0,5,0,0,10
2652,2021-01-14,7,0,3,0,1,11
2653,2021-01-15,10,0,3,0,6,19
2654,2021-01-16,4,1,2,0,2,9
2655,2021-01-17,4,0,3,0,1,8
2656,2021-01-19,11,0,2,0,3,16
2657,2021-01-20,7,0,0,0,3,10
2658,2021-01-21,8,0,4,0,4,16
2659,2021-01-22,7,0,2,0,4,13
2660,2021-01-23,9,0,4,0,5,18
2661,2021-01-24,0,0,1,1,0,2
2662,2021-01-25,3,0,3,0,3,9
2663,2021-01-26,7,0,6,0,3,16
2664,2021-01-27,6,0,7,2,7,22
2665,2021-01-28,5,0,4,0,9,18
2666,2021-01-29,8,0,3,0,4,15
2667,2021-01-30,14,1,3,0,3,21
2668,2021-01-31,2,0,2,1,0,5
2669,2021-02-01,7,0,6,0,0,13
2670,2021-02-02,5,0,4,1,7,17
2671,2021-02-03,8,0,3,0,2,13
2672,2021-02-04,14,0,6,0,1,21
2673,2021-02-05,9,0,2,0,2,13
2674,2021-02-06,4,0,4,0,2,10
2675,2021-02-07,5,1,1,0,2,9
2676,2021-02-08,7,0,2,0,0,9
2677,2021-02-09,10,0,5,0,8,23
2678,2021-02-10,5,0,4,0,0,9
2679,2021-02-11,5,0,3,0,3,11
2680,2021-02-12,7,0,0,1,6,14
2681,2021-02-13,12,0,0,1,0,13
2682,2021-02-14,0,1,0,0,0,1
2683,2021-02-18,4,0,1,0,0,5
2684,2021-02-19,1,0,2,0,0,3
2685,2021-02-20,5,0,2,1,0,8
2686,2021-02-21,8,0,0,0,0,8
2687,2021-02-22,10,0,1,0,0,11
2688,2021-02-23,7,0,4,0,7,18
2689,2021-02-24,4,0,4,0,0,8
2690,2021-02-25,4,0,0,0,6,10
2691,2021-02-26,10,0,3,0,2,15
2692,2021-02-27,8,0,1,0,4,13
2693,2021-02-28,5,0,1,0,2,8
2694,2021-03-01,7,0,3,0,0,10
2695,2021-03-02,14,1,7,1,8,31
2696,2021-03-03,10,0,1,1,0,12
2697,2021-03-04,10,0,4,0,7,21
2698,2021-03-05,2,0,1,0,4,7
2699,2021-03-06,7,2,5,0,2,16
2700,2021-03-07,2,0,1,0,0,3
2701,2021-03-08,1,0,5,0,4,10
2702,2021-03-09,7,0,2,0,6,15
2703,2021-03-10,3,0,3,1,2,9
2704,2021-03-11,3,1,1,1,1,7
2705,2021-03-12,11,0,3,0,9,23
2706,2021-03-13,30,0,0,0,1,31
2707,2021-03-14,1,0,3,0,0,4
2708,2021-03-15,9,0,2,0,4,15
2709,2021-03-16,8,0,5,0,8,21
2710,2021-03-17,4,0,4,0,0,8
2711,2021-03-18,6,0,3,0,4,13
2712,2021-03-19,7,0,3,0,2,12
2713,2021-03-20,6,1,1,0,2,10
2714,2021-03-21,3,0,0,0,3,6
2715,2021-03-22,6,0,1,0,2,9
2716,2021-03-23,13,0,5,0,3,21
2717,2021-03-24,6,0,1,0,1,8
2718,2021-03-25,2,1,2,0,4,9
2719,2021-03-26,8,0,5,0,2,15
2720,2021-03-27,3,0,2,0,10,15
2721,2021-03-28,5,0,3,0,4,12
2722,2021-03-29,14,0,5,0,2,21
2723,2021-03-30,2,0,5,1,3,11
2724,2021-03-31,9,1,2,0,2,14
2725,2021-04-01,11,1,1,1,2,16
2726,2021-04-02,9,0,7,0,3,19
2727,2021-04-03,15,0,1,0,2,18
2728,2021-04-04,5,0,0,0,5,10
2729,2021-04-05,9,0,4,0,0,13
2730,2021-04-06,6,0,1,0,6,13
2731,2021-04-07,6,0,3,0,1,10
2732,2021-04-08,9,0,1,0,4,14
2733,2021-04-09,7,1,2,0,1,11
2734,2021-04-10,5,0,1,0,1,7
2735,2021-04-11,4,0,5,0,4,13
2736,2021-04-12,4,0,4,0,3,11
2737,2021-04-13,9,0,0,0,3,12
2738,2021-04-14,8,0,2,0,1,11
2739,2021-04-15,6,0,0,1,0,7
2740,2021-04-16,8,0,4,0,11,23
2741,2021-04-17,4,0,1,0,10,15
2742,2021-04-18,5,1,1,0,2,9
2743,2021-04-19,11,1,8,0,3,23
2744,2021-04-20,8,1,7,0,4,20
2745,2021-04-21,7,0,0,0,1,8
2746,2021-04-22,5,0,7,2,0,14
2747,2021-04-23,10,0,4,0,2,16
2748,2021-04-24,2,0,2,0,4,8
2749,2021-04-25,5,0,0,0,0,5
2750,2021-04-26,11,1,4,0,3,19
2751,2021-04-27,5,0,3,0,5,13
2752,2021-04-28,8,0,3,0,0,11
2753,2021-04-29,13,0,3,0,0,16
2754,2021-04-30,11,0,4,0,13,28
2755,2021-05-01,21,0,5,0,2,28
2756,2021-05-02,3,0,1,0,3,7
2757,2021-05-03,10,0,4,0,2,16
2758,2021-05-04,9,0,5,0,4,18
2759,2021-05-05,21,0,2,0,9,32
2760,2021-05-06,15,0,1,0,3,19
2761,2021-05-07,16,0,4,0,2,22
2762,2021-05-08,19,0,3,0,0,22
2763,2021-05-09,16,0,3,0,5,24
2764,2021-05-10,4,0,7,0,3,14
2765,2021-05-11,14,0,1,0,8,23
2766,2021-05-12,7,0,1,0,0,8
2767,2021-05-13,9,1,3,0,2,15
2768,2021-05-14,9,1,2,0,4,16
2769,2021-05-15,10,0,2,0,0,12
2770,2021-05-16,5,0,6,0,2,13
2771,2021-05-17,8,0,2,1,2,13
2772,2021-05-18,15,0,3,0,7,25
2773,2021-05-19,3,0,2,1,1,7
2774,2021-05-20,8,1,6,0,7,22
2775,2021-05-21,9,0,2,0,3,14
2776,2021-05-22,7,0,2,0,2,11
2777,2021-05-23,4,0,2,0,0,6
2778,2021-05-24,5,0,3,0,3,11
2779,2021-05-25,12,0,4,1,3,20
2780,2021-05-26,11,0,2,0,0,13
2781,2021-05-27,8,0,6,1,0,15
2782,2021-05-28,9,0,2,0,4,15
2783,2021-05-29,3,0,5,0,2,10
2784,2021-05-30,5,0,1,0,0,6
2785,2021-05-31,0,1,0,0,3,4
2786,2021-06-01,10,1,5,0,7,23
2787,2021-06-02,8,0,3,0,5,16
2788,2021-06-03,14,0,4,0,2,20
2789,2021-06-04,3,2,3,0,6,14
2790,2021-06-05,18,0,2,0,2,22
2791,2021-06-06,10,0,2,0,0,12
2792,2021-06-07,17,0,4,0,4,25
2793,2021-06-08,20,0,2,0,4,26
2794,2021-06-09,9,1,4,0,4,18
2795,2021-06-10,11,0,2,0,1,14
2796,2021-06-11,7,0,3,0,2,12
2797,2021-06-12,8,1,2,2,6,19
2798,2021-06-13,8,0,1,0,0,9
2799,2021-06-14,11,0,5,0,0,16
2800,2021-06-15,11,0,6,1,4,22
2801,2021-06-16,14,0,3,2,3,22
2802,2021-06-17,18,1,3,1,5,28
2803,2021-06-18,0,1,0,0,1,2
2804,2021-06-19,9,0,6,1,0,16
2805,2021-06-20,4,4,1,0,3,12
2806,2021-06-21,17,0,3,0,19,39
2807,2021-06-22,14,0,5,1,1,21
2808,2021-06-23,13,0,4,1,2,20
2809,2021-06-24,8,0,3,0,2,13
2810,2021-06-25,18,0,1,0,11,30
2811,2021-06-26,18,1,3,1,4,27
2812,2021-06-27,2,0,1,0,2,5
2813,2021-06-28,22,2,2,0,10,36
2814,2021-06-29,15,0,4,1,4,24
2815,2021-06-30,21,1,0,1,7,30
2816,2021-07-01,20,0,2,0,1,23
2817,2021-07-02,10,1,2,0,14,27
2818,2021-07-03,11,0,3,0,1,15
2819,2021-07-04,7,0,4,0,0,11
2820,2021-07-05,0,0,0,0,2,2
2821,2021-07-06,26,0,13,0,4,43
2822,2021-07-07,13,0,5,0,6,24
2823,2021-07-08,7,1,7,0,3,18
2824,2021-07-09,4,0,3,0,1,8
2825,2021-07-10,15,0,4,0,11,30
2826,2021-07-11,9,0,1,0,1,11
2827,2021-07-12,14,1,2,0,5,22
2828,2021-07-13,7,0,6,0,2,15
2829,2021-07-14,14,1,7,0,7,29
2830,2021-07-15,25,1,2,0,0,28
2831,2021-07-16,16,0,0,0,4,20
2832,2021-07-17,11,1,2,0,2,16
2833,2021-07-18,7,0,4,1,0,12
2834,2021-07-19,21,0,5,0,1,27
2835,2021-07-20,21,0,4,0,7,32
2836,2021-07-21,11,1,3,0,2,17
2837,2021-07-22,9,0,5,0,1,15
2838,2021-07-23,12,2,1,0,0,15
2839,2021-07-24,8,0,7,0,4,19
2840,2021-07-25,26,1,3,0,7,37
2841,2021-07-26,15,0,5,1,8,29
2842,2021-07-27,18,1,2,1,3,25
2843,2021-07-28,6,0,0,0,0,6
2844,2021-07-29,11,0,4,0,4,19
2845,2021-07-30,11,0,4,0,10,25
2846,2021-07-31,12,0,0,0,0,12
2847,2021-08-01,5,0,1,0,0,6
2848,2021-08-02,18,1,11,0,3,33
2849,2021-08-03,17,0,3,0,6,26
2850,2021-08-04,14,0,3,0,0,17
2851,2021-08-05,8,0,7,0,2,17
2852,2021-08-06,22,0,5,0,15,42
2853,2021-08-07,4,0,1,1,1,7
2854,2021-08-08,3,1,3,0,1,8
2855,2021-08-09,7,0,5,0,1,13
2856,2021-08-10,14,0,2,0,4,20
2857,2021-08-11,12,1,2,0,4,19
2858,2021-08-12,8,0,4,0,1,13
2859,2021-08-13,12,0,1,0,0,13
2860,2021-08-14,16,0,2,0,11,29
2861,2021-08-15,8,0,1,0,1,10
2862,2021-08-16,14,0,4,0,0,18
2863,2021-08-17,14,0,6,0,3,23
2864,2021-08-18,18,0,0,0,2,20
2865,2021-08-19,15,0,4,0,3,22
2866,2021-08-20,12,0,6,0,3,21
2867,2021-08-21,10,0,4,0,1,15
2868,2021-08-22,20,0,0,1,3,24
2869,2021-08-23,21,0,4,0,1,26
2870,2021-08-24,8,2,6,0,7,23
2871,2021-08-25,10,0,3,0,0,13
2872,2021-08-26,12,0,6,2,5,25
2873,2021-08-27,14,0,2,0,7,23
2874,2021-08-28,11,0,4,0,9,24
2875,2021-08-29,6,0,2,0,1,9
2876,2021-08-30,15,0,4,2,1,22
2877,2021-08-31,8,0,1,0,8,17
2878,2021-09-01,12,0,1,0,2,15
2879,2021-09-02,11,0,3,0,0,14
2880,2021-09-03,6,0,6,0,8,20
2881,2021-09-04,13,0,0,0,3,16
2882,2021-09-05,11,1,1,1,9,23
2883,2021-09-07,15,0,3,0,5,23
2884,2021-09-08,15,0,3,0,1,19
2885,2021-09-09,9,1,3,0,15,28
2886,2021-09-10,9,0,1,0,1,11
2887,2021-09-11,21,0,2,0,0,23
2888,2021-09-12,8,0,3,0,0,11
2889,2021-09-13,22,0,6,0,6,34
2890,2021-09-14,13,0,2,0,4,19
2891,2021-09-15,11,0,3,0,0,14
2892,2021-09-16,14,1,5,0,10,30
2893,2021-09-17,10,0,3,0,6,19
2894,2021-09-18,33,0,1,0,1,35
2895,2021-09-19,9,0,4,0,2,15
2896,2021-09-20,22,0,2,0,3,27
2897,2021-09-21,17,0,5,0,1,23
2898,2021-09-22,8,0,7,0,6,21
2899,2021-09-23,21,0,0,1,1,23
2900,2021-09-24,13,2,8,0,2,25
2901,2021-09-25,9,0,3,0,4,16
2902,2021-09-26,7,0,4,0,1,12
2903,2021-09-27,18,0,8,0,4,30
2904,2021-09-28,8,2,1,0,30,41
2905,2021-09-29,16,1,3,0,6,26
2906,2021-09-30,9,0,3,0,1,13
2907,2021-10-01,13,0,1,0,3,17
2908,2021-10-02,9,1,2,0,0,12
2909,2021-10-03,8,0,3,0,1,12
2910,2021-10-04,18,1,11,0,2,32
2911,2021-10-05,20,0,3,0,0,23
2912,2021-10-06,8,0,4,1,1,14
2913,2021-10-07,7,0,2,1,5,15
2914,2021-10-08,11,0,2,0,26,39
2915,2021-10-09,15,0,2,0,1,18
2916,2021-10-10,5,0,4,0,1,10
2917,2021-10-11,11,0,4,0,9,24
2918,2021-10-12,15,0,3,1,1,20
2919,2021-10-13,11,0,4,0,3,18
2920,2021-10-14,7,0,2,0,5,14
2921,2021-10-15,7,0,5,0,6,18
2922,2021-10-16,3,0,6,0,0,9
2923,2021-10-17,4,1,2,0,1,8
2924,2021-10-18,19,0,8,0,5,32
2925,2021-10-19,17,0,4,0,1,22
2926,2021-10-20,15,0,5,0,0,20
2927,2021-10-21,5,0,5,2,2,14
2928,2021-10-22,3,0,6,0,26,35
2929,2021-10-23,12,0,3,0,1,16
2930,2021-10-24,7,0,0,0,3,10
2931,2021-10-25,14,0,6,0,5,25
2932,2021-10-26,21,0,4,2,0,27
2933,2021-10-27,9,0,2,1,0,12
2934,2021-10-28,3,1,6,0,5,15
2935,2021-10-29,9,0,2,0,1,12
2936,2021-10-30,6,0,5,0,2,13
2937,2021-10-31,2,0,4,1,1,8
2938,2021-11-01,18,0,8,0,19,45
2939,2021-11-02,5,0,3,0,3,11
2940,2021-11-03,6,0,1,0,1,8
2941,2021-11-04,8,0,6,0,3,17
2942,2021-11-05,9,0,4,0,29,42
2943,2021-11-06,7,0,4,0,1,12
2944,2021-11-07,14,0,2,0,1,17
2945,2021-11-08,16,1,3,0,0,20
2946,2021-11-09,7,0,6,0,2,15
2947,2021-11-10,8,0,5,1,5,19
2948,2021-11-11,1,0,0,0,0,1
2949,2021-11-12,9,0,5,0,8,22
2950,2021-11-13,15,0,3,2,24,44
2951,2021-11-14,9,0,5,0,0,14
2952,2021-11-15,14,1,3,0,12,30
2953,2021-11-16,8,0,1,0,4,13
2954,2021-11-17,9,1,3,0,1,14
2955,2021-11-18,9,0,3,0,0,12
2956,2021-11-19,11,0,3,0,23,37
2957,2021-11-20,13,1,3,0,1,18
2958,2021-11-21,8,1,0,1,2,12
2959,2021-11-22,10,0,3,0,1,14
2960,2021-11-23,13,0,3,0,0,16
2961,2021-11-24,12,1,7,0,4,24
2962,2021-11-26,0,0,2,0,1,3
2963,2021-11-27,17,0,11,0,2,30
2964,2021-11-28,6,0,1,0,3,10
2965,2021-11-29,19,0,5,0,8,32
2966,2021-11-30,7,0,5,0,3,15
2967,2021-12-01,16,0,6,0,6,28
2968,2021-12-02,8,0,5,0,2,15
2969,2021-12-03,7,0,6,1,1,15
2970,2021-12-04,12,0,4,0,2,18
2971,2021-12-05,11,0,3,0,1,15
2972,2021-12-06,10,0,12,0,6,28
2973,2021-12-07,11,0,1,0,2,14
2974,2021-12-08,12,0,2,0,3,17
2975,2021-12-09,10,0,0,0,4,14
2976,2021-12-10,6,0,9,0,25,40
2977,2021-12-11,13,0,9,0,5,27
2978,2021-12-12,3,0,3,0,1,7
2979,2021-12-13,12,0,2,0,3,17
2980,2021-12-14,12,1,3,0,0,16
2981,2021-12-15,10,0,4,0,2,16
2982,2021-12-16,5,1,2,0,17,25
2983,2021-12-17,9,0,2,1,4,16
2984,2021-12-18,8,1,3,0,1,13
2985,2021-12-19,19,0,3,0,3,25
2986,2021-12-20,24,1,5,0,8,38
2987,2021-12-21,18,1,11,0,2,32
2988,2021-12-22,18,0,1,0,9,28
2989,2021-12-23,18,0,3,0,4,25
2990,2021-12-24,0,0,0,0,1,1
2991,2021-12-26,6,1,3,0,3,13
2992,2021-12-27,10,1,6,0,4,21
2993,2021-12-28,10,0,3,0,0,13
2994,2021-12-29,18,3,10,0,5,36
2995,2021-12-30,7,0,4,1,6,18
2996,2021-12-31,13,0,6,0,6,25
2997,2022-01-01,0,0,0,0,4,4
2998,2022-01-02,7,0,4,1,2,14
2999,2022-01-03,21,0,6,0,3,30
3000,2022-01-04,15,0,1,1,3,20
3001,2022-01-05,8,1,4,2,4,19
3002,2022-01-06,15,2,1,0,5,23
3003,2022-01-07,14,0,12,0,35,61
3004,2022-01-08,15,0,1,0,2,18
3005,2022-01-09,7,1,2,0,0,10
3006,2022-01-10,5,0,5,0,1,11
3007,2022-01-11,12,1,2,0,2,17
3008,2022-01-12,18,0,4,0,8,30
3009,2022-01-13,10,1,1,0,7,19
3010,2022-01-14,22,0,4,0,5,31
3011,2022-01-15,6,0,2,0,8,16
3012,2022-01-16,10,0,3,0,2,15
3013,2022-01-17,0,1,0,0,2,3
3014,2022-01-18,30,0,7,0,3,40
3015,2022-01-19,10,0,3,0,9,22
3016,2022-01-20,11,0,2,0,3,16
3017,2022-01-21,16,0,4,0,2,22
3018,2022-01-22,8,0,6,0,0,14
3019,2022-01-23,0,0,0,0,2,2
3020,2022-01-24,17,0,6,0,8,31
3021,2022-01-25,16,0,3,0,2,21
3022,2022-01-26,13,1,5,0,11,30
3023,2022-01-27,10,0,4,0,1,15
3024,2022-01-28,2,0,1,0,2,5
3025,2022-01-29,15,0,3,0,4,22
3026,2022-01-30,0,0,1,0,0,1
3027,2022-01-31,9,0,3,0,6,18
3028,2022-02-01,6,0,5,0,2,13
3029,2022-02-02,18,0,4,0,27,49
3030,2022-02-03,1,0,0,1,2,4
3031,2022-02-05,13,1,8,0,0,22
3032,2022-02-06,0,0,1,0,0,1
3033,2022-02-07,8,0,6,0,4,18
3034,2022-02-08,17,1,4,0,2,24
3035,2022-02-09,7,4,1,0,12,24
3036,2022-02-10,16,0,6,0,37,59
3037,2022-02-11,17,0,5,0,2,24
3038,2022-02-12,29,0,4,0,2,35
3039,2022-02-13,0,0,0,0,3,3
3040,2022-02-14,16,1,2,0,0,19
3041,2022-02-15,18,0,9,0,3,30
3042,2022-02-16,9,0,0,0,4,13
3043,2022-02-17,5,0,8,1,2,16
3044,2022-02-18,9,0,8,0,4,21
3045,2022-02-19,13,0,0,0,0,13
3046,2022-02-22,14,0,11,0,9,34
3047,2022-02-23,4,1,12,0,4,21
3048,2022-02-24,6,1,9,0,1,17
3049,2022-02-25,8,0,3,0,26,37
3050,2022-02-26,12,0,2,0,2,16
3051,2022-02-27,0,0,0,0,1,1
3052,2022-02-28,18,0,3,0,1,22
3053,2022-03-01,12,0,1,0,6,19
3054,2022-03-02,8,0,2,0,10,20
3055,2022-03-03,12,1,6,0,3,22
3056,2022-03-04,7,0,5,0,1,13
3057,2022-03-05,13,0,4,1,2,20
3058,2022-03-06,0,0,1,0,1,2
3059,2022-03-07,14,0,7,1,2,24
3060,2022-03-08,10,0,4,0,4,18
3061,2022-03-09,10,0,4,0,5,19
3062,2022-03-10,7,0,3,0,0,10
3063,2022-03-11,6,0,7,0,11,24
3064,2022-03-12,21,0,3,0,3,27
3065,2022-03-13,1,0,0,0,1,2
3066,2022-03-14,18,1,7,0,24,50
3067,2022-03-15,11,0,9,0,1,21
3068,2022-03-16,10,0,4,1,1,16
3069,2022-03-17,7,0,5,0,0,12
3070,2022-03-18,11,0,1,0,5,17
3071,2022-03-19,6,0,2,0,16,24
3072,2022-03-21,4,0,5,0,0,9
3073,2022-03-22,10,1,2,0,1,14
3074,2022-03-23,9,0,1,0,15,25
3075,2022-03-24,10,1,4,0,0,15
3076,2022-03-25,13,1,2,0,5,21
3077,2022-03-26,15,1,1,0,1,18
3078,2022-03-27,0,0,1,0,0,1
3079,2022-03-28,10,0,6,0,8,24
3080,2022-03-29,8,0,5,1,1,15
3081,2022-03-30,8,0,6,0,7,21
3082,2022-03-31,12,1,3,0,0,16
3083,2022-04-01,11,0,2,0,2,15
3084,2022-04-02,19,0,7,0,0,26
3085,2022-04-03,0,1,0,0,0,1
3086,2022-04-04,9,0,7,0,1,17
3087,2022-04-05,9,0,0,0,7,16
3088,2022-04-06,10,0,9,0,35,54
3089,2022-04-07,6,0,3,0,6,15
3090,2022-04-08,9,0,3,0,5,17
3091,2022-04-09,21,0,4,0,3,28
3092,2022-04-10,0,0,0,0,7,7
3093,2022-04-11,8,1,8,0,1,18
3094,2022-04-12,15,0,3,0,8,26
3095,2022-04-13,15,0,8,0,5,28
3096,2022-04-14,8,0,0,0,4,12
3097,2022-04-15,10,0,7,0,3,20
3098,2022-04-16,12,0,2,0,3,17
3099,2022-04-17,0,0,2,0,12,14
3100,2022-04-18,12,0,7,0,1,20
3101,2022-04-19,10,1,4,0,15,30
3102,2022-04-20,8,0,2,0,1,11
3103,2022-04-21,10,0,5,0,12,27
3104,2022-04-22,8,0,9,0,6,23
3105,2022-04-23,13,0,3,1,0,17
3106,2022-04-25,6,0,2,0,1,9
3107,2022-04-26,12,0,2,0,9,23
3108,2022-04-27,9,2,4,0,21,36
3109,2022-04-28,8,1,0,0,2,11
3110,2022-04-29,6,0,5,0,30,41
3111,2022-04-30,17,0,1,0,6,24
3112,2022-05-01,0,1,0,0,4,5
3113,2022-05-02,7,2,2,0,6,17
3114,2022-05-03,16,0,4,0,5,25
3115,2022-05-04,2,0,2,0,0,4
3116,2022-05-05,4,1,4,0,0,9
3117,2022-05-06,9,0,3,0,13,25
3118,2022-05-07,11,0,4,0,1,16
3119,2022-05-09,9,0,3,0,23,35
3120,2022-05-10,10,0,6,0,4,20
3121,2022-05-11,7,1,3,0,2,13
3122,2022-05-12,5,0,13,1,10,29
3123,2022-05-13,8,1,4,0,1,14
3124,2022-05-14,10,0,1,0,1,12
3125,2022-05-16,8,1,4,0,11,24
3126,2022-05-17,5,1,4,0,0,10
3127,2022-05-18,8,0,4,0,1,13
3128,2022-05-19,5,0,3,0,2,10
3129,2022-05-20,12,1,4,0,30,47
3130,2022-05-21,7,0,2,0,0,9
3131,2022-05-22,0,0,1,0,0,1
3132,2022-05-23,16,3,3,0,4,26
3133,2022-05-24,12,0,1,0,27,40
3134,2022-05-25,6,0,7,0,10,23
3135,2022-05-26,12,0,6,0,6,24
3136,2022-05-27,9,1,4,0,8,22
3137,2022-05-28,11,0,1,0,1,13
3138,2022-05-29,0,0,1,0,0,1
3139,2022-05-30,0,0,1,0,0,1
3140,2022-05-31,20,1,5,0,5,31
3141,2022-06-01,7,0,6,0,10,23
3142,2022-06-02,4,0,2,0,5,11
3143,2022-06-03,15,0,6,0,7,28
3144,2022-06-04,9,1,3,0,24,37
3145,2022-06-05,0,1,2,0,0,3
3146,2022-06-06,11,0,2,0,0,13
3147,2022-06-07,9,0,2,0,8,19
3148,2022-06-08,6,0,1,0,43,50
3149,2022-06-09,2,0,2,1,0,5
3150,2022-06-10,6,6,1,0,0,13
3151,2022-06-11,11,1,0,0,1,13
3152,2022-06-12,0,0,0,0,2,2
3153,2022-06-13,7,0,1,0,5,13
3154,2022-06-14,10,0,3,0,1,14
3155,2022-06-15,2,0,4,0,3,9
3156,2022-06-16,6,0,3,0,11,20
3157,2022-06-17,9,0,4,0,4,17
3158,2022-06-18,9,0,0,0,1,10
3159,2022-06-19,5,1,0,0,0,6
3160,2022-06-20,16,1,3,2,3,25
3161,2022-06-21,10,1,5,0,5,21
3162,2022-06-22,6,0,4,0,0,10
3163,2022-06-23,18,1,4,0,22,45
3164,2022-06-24,14,0,2,0,30,46
3165,2022-06-25,8,0,0,0,7,15
3166,2022-06-26,0,0,0,0,1,1
3167,2022-06-27,15,0,2,0,3,20
3168,2022-06-28,9,0,5,0,20,34
3169,2022-06-29,6,0,1,0,5,12
3170,2022-06-30,13,0,3,0,0,16
3171,2022-07-01,15,0,1,0,2,18
3172,2022-07-02,6,0,1,1,1,9
3173,2022-07-03,0,0,4,0,0,4
3174,2022-07-04,0,0,0,0,2,2
3175,2022-07-05,13,0,2,0,5,20
3176,2022-07-06,13,0,1,0,1,15
3177,2022-07-07,12,0,4,0,9,25
3178,2022-07-08,8,0,1,1,3,13
3179,2022-07-09,12,0,4,0,0,16
3180,2022-07-10,1,0,1,1,0,3
3181,2022-07-11,13,0,2,0,1,16
3182,2022-07-12,14,1,6,6,2,29
3183,2022-07-13,9,0,2,0,5,16
3184,2022-07-14,15,1,5,0,10,31
3185,2022-07-15,14,0,10,0,2,26
3186,2022-07-16,6,0,4,0,3,13
3187,2022-07-17,21,0,2,2,0,25
3188,2022-07-18,14,1,4,1,2,22
3189,2022-07-19,7,0,1,0,11,19
3190,2022-07-20,7,0,3,1,33,44
3191,2022-07-21,7,0,1,0,6,14
3192,2022-07-22,12,0,2,0,3,17
3193,2022-07-23,13,0,2,2,11,28
3194,2022-07-24,5,0,0,0,0,5
3195,2022-07-25,21,1,4,3,2,31
3196,2022-07-26,7,0,2,0,41,50
3197,2022-07-27,13,0,1,0,3,17
3198,2022-07-28,8,1,8,0,0,17
3199,2022-07-29,20,2,1,0,3,26
3200,2022-07-30,8,0,4,0,0,12
3201,2022-08-01,18,0,2,0,2,22
3202,2022-08-02,13,1,1,0,0,15
3203,2022-08-03,6,0,3,0,10,19
3204,2022-08-04,11,0,6,0,2,19
3205,2022-08-05,13,0,2,1,16,32
3206,2022-08-06,6,0,4,0,2,12
3207,2022-08-07,1,0,0,0,0,1
3208,2022-08-08,18,2,8,0,2,30
3209,2022-08-09,18,0,0,0,1,19
3210,2022-08-10,17,0,3,0,8,28
3211,2022-08-11,9,0,3,0,6,18
3212,2022-08-12,11,0,5,0,30,46
3213,2022-08-13,11,1,5,0,2,19
3214,2022-08-14,0,1,0,0,0,1
3215,2022-08-15,14,0,2,0,2,18
3216,2022-08-16,11,0,4,0,2,17
3217,2022-08-17,11,0,4,0,4,19
3218,2022-08-18,11,0,7,0,8,26
3219,2022-08-19,13,0,2,0,0,15
3220,2022-08-20,15,1,3,0,1,20
3221,2022-08-21,0,0,1,0,0,1
3222,2022-08-22,17,2,2,0,5,26
3223,2022-08-23,7,0,3,0,1,11
3224,2022-08-24,14,1,5,0,17,37
3225,2022-08-25,10,0,2,0,14,26
3226,2022-08-26,12,1,5,0,3,21
3227,2022-08-27,32,0,0,1,0,33
3228,2022-08-28,0,0,1,0,0,1
3229,2022-08-29,19,0,3,0,0,22
3230,2022-08-30,23,1,2,0,1,27
3231,2022-08-31,18,0,0,1,21,40
3232,2022-09-01,11,1,6,0,5,23
3233,2022-09-02,12,0,2,0,1,15
3234,2022-09-03,12,0,4,0,1,17
3235,2022-09-05,0,0,1,0,3,4
3236,2022-09-06,13,0,4,0,1,18
3237,2022-09-07,8,2,4,0,5,19
3238,2022-09-08,9,0,6,0,1,16
3239,2022-09-09,14,2,4,0,17,37
3240,2022-09-10,10,0,5,0,1,16
3241,2022-09-11,0,0,1,0,0,1
3242,2022-09-12,22,0,2,0,0,24
3243,2022-09-13,22,0,3,0,2,27
3244,2022-09-14,14,0,4,0,7,25
3245,2022-09-15,21,1,0,1,2,25
3246,2022-09-16,10,0,4,0,19,33
3247,2022-09-17,17,0,2,0,1,20
3248,2022-09-19,33,0,4,0,1,38
3249,2022-09-20,13,0,4,0,0,17
3250,2022-09-21,10,0,5,0,6,21
3251,2022-09-22,12,0,2,0,8,22
3252,2022-09-23,13,0,3,0,11,27
3253,2022-09-24,5,0,0,0,0,5
3254,2022-09-25,7,0,2,0,1,10
3255,2022-09-26,20,0,2,0,2,24
3256,2022-09-27,14,0,2,0,0,16
3257,2022-09-28,11,0,1,0,3,15
3258,2022-09-29,14,0,1,1,2,18
3259,2022-09-30,8,0,5,0,16,29
3260,2022-10-01,7,0,0,0,2,9
3261,2022-10-02,2,0,1,0,0,3
3262,2022-10-03,11,0,3,0,1,15
3263,2022-10-04,7,0,1,0,0,8
3264,2022-10-05,11,0,1,0,3,15
3265,2022-10-06,8,0,8,1,1,18
3266,2022-10-07,8,0,4,1,2,15
3267,2022-10-08,6,0,1,0,3,10
3268,2022-10-09,12,0,3,0,3,18
3269,2022-10-10,11,0,0,1,30,42
3270,2022-10-11,10,1,4,0,1,16
3271,2022-10-12,1,0,5,0,1,7
3272,2022-10-13,4,0,3,0,7,14
3273,2022-10-14,8,0,4,0,3,15
3274,2022-10-15,3,0,1,0,2,6
3275,2022-10-16,2,1,1,0,4,8
3276,2022-10-17,9,0,2,0,0,11
3277,2022-10-18,10,0,0,0,1,11
3278,2022-10-19,7,0,5,0,5,17
3279,2022-10-20,4,0,0,0,6,10
3280,2022-10-21,9,1,0,0,15,25
3281,2022-10-22,7,0,1,0,0,8
3282,2022-10-23,1,0,5,0,0,6
3283,2022-10-24,10,0,2,0,6,18
3284,2022-10-25,11,0,5,0,6,22
3285,2022-10-26,4,0,10,0,18,32
3286,2022-10-27,3,0,1,0,2,6
3287,2022-10-28,10,0,5,1,6,22
3288,2022-10-29,3,0,4,2,2,11
3289,2022-10-30,2,0,3,0,2,7
3290,2022-10-31,8,0,1,0,7,16
3291,2022-11-01,10,1,3,0,1,15
3292,2022-11-02,7,0,4,0,0,11
3293,2022-11-03,2,0,2,0,2,6
3294,2022-11-04,6,1,2,0,35,44
3295,2022-11-05,9,0,3,0,3,15
3296,2022-11-06,6,0,2,0,8,16
3297,2022-11-07,13,0,1,0,0,14
3298,2022-11-08,4,0,4,0,3,11
3299,2022-11-09,8,0,2,0,1,11
3300,2022-11-10,4,1,3,0,1,9
3301,2022-11-11,0,0,0,0,1,1
3302,2022-11-12,11,0,2,0,2,15
3303,2022-11-13,3,0,0,0,2,5
3304,2022-11-14,10,0,2,0,2,14
3305,2022-11-15,11,0,2,0,4,17
3306,2022-11-16,8,0,1,0,8,17
3307,2022-11-17,10,0,6,0,3,19
3308,2022-11-18,8,0,4,0,3,15
3309,2022-11-19,7,0,2,0,4,13
3310,2022-11-20,5,0,1,0,1,7
3311,2022-11-21,8,0,0,0,6,14
3312,2022-11-22,8,0,6,0,1,15
3313,2022-11-23,11,0,1,0,1,13
3314,2022-11-25,14,0,2,0,3,19
3315,2022-11-26,9,0,0,0,5,14
3316,2022-11-27,5,0,0,0,0,5
3317,2022-11-28,8,0,4,0,5,17
3318,2022-11-29,13,1,0,1,2,17
3319,2022-11-30,7,0,3,0,3,13
3320,2022-12-01,8,0,2,0,1,11
3321,2022-12-02,7,1,2,0,3,13
3322,2022-12-03,7,0,4,0,1,12
3323,2022-12-04,6,0,2,0,2,10
3324,2022-12-05,12,0,1,0,3,16
3325,2022-12-06,12,2,1,0,1,16
3326,2022-12-07,7,0,2,1,2,12
3327,2022-12-08,1,0,0,1,0,2
3328,2022-12-09,6,0,1,0,1,8
3329,2022-12-10,6,0,12,2,4,24
3330,2022-12-11,5,0,2,0,0,7
3331,2022-12-12,9,0,5,0,2,16
3332,2022-12-13,16,1,3,0,4,24
3333,2022-12-14,5,0,2,0,2,9
3334,2022-12-15,9,0,6,0,3,18
3335,2022-12-16,11,1,2,0,3,17
3336,2022-12-17,15,0,2,0,2,19
3337,2022-12-18,11,0,3,0,0,14
3338,2022-12-19,12,0,2,0,2,16
3339,2022-12-20,17,1,0,0,4,22
3340,2022-12-21,13,1,1,0,2,17
3341,2022-12-22,12,0,4,0,9,25
3342,2022-12-23,4,0,5,0,1,10
3343,2022-12-25,0,0,0,0,1,1
3344,2022-12-26,0,0,0,0,1,1
3345,2022-12-27,15,0,1,0,2,18
3346,2022-12-28,19,1,3,0,0,23
3347,2022-12-29,15,0,2,0,2,19
3348,2022-12-30,14,0,1,0,3,18
3349,2022-12-31,12,1,1,0,3,17
3350,2023-01-01,0,0,2,0,0,2
3351,2023-01-02,1,0,0,0,0,1
3352,2023-01-03,17,0,3,0,3,23
3353,2023-01-04,12,0,2,0,3,17
3354,2023-01-05,15,0,3,0,4,22
3355,2023-01-06,11,0,5,0,1,17
3356,2023-01-07,14,0,0,1,3,18
3357,2023-01-08,5,0,3,0,2,10
3358,2023-01-09,8,0,5,0,6,19
3359,2023-01-10,14,0,1,0,2,17
3360,2023-01-11,11,0,2,0,6,19
3361,2023-01-12,5,0,1,0,2,8
3362,2023-01-13,10,0,7,0,5,22
3363,2023-01-14,9,0,1,1,2,13
3364,2023-01-15,20,0,0,0,4,24
3365,2023-01-16,0,0,0,0,1,1
3366,2023-01-17,17,0,2,0,4,23
3367,2023-01-18,14,1,2,0,2,19
3368,2023-01-19,18,0,11,0,17,46
3369,2023-01-20,8,0,1,0,11,20
3370,2023-01-21,16,0,1,0,0,17
3371,2023-01-22,5,0,2,0,0,7
3372,2023-01-23,7,0,0,0,3,10
3373,2023-01-24,9,1,2,0,3,15
3374,2023-01-25,4,0,0,0,8,12
3375,2023-01-26,6,0,1,0,1,8
3376,2023-01-27,7,1,3,0,5,16
3377,2023-01-28,9,0,3,0,4,16
3378,2023-01-29,8,0,1,0,0,9
3379,2023-01-30,10,0,0,1,5,16
3380,2023-01-31,3,0,2,0,0,5
3381,2023-02-03,13,0,4,0,4,21
3382,2023-02-04,12,0,4,0,0,16
3383,2023-02-05,7,0,4,0,2,13
3384,2023-02-06,15,0,1,0,9,25
3385,2023-02-07,16,0,8,0,2,26
3386,2023-02-08,10,1,0,0,2,13
3387,2023-02-09,8,0,2,0,2,12
3388,2023-02-10,9,0,0,1,10,20
3389,2023-02-11,30,0,1,0,0,31
3390,2023-02-12,6,0,0,0,6,12
3391,2023-02-13,12,0,0,0,9,21
3392,2023-02-14,15,1,1,0,1,18
3393,2023-02-15,9,1,2,0,1,13
3394,2023-02-16,14,0,6,0,8,28
3395,2023-02-17,13,0,3,0,0,16
3396,2023-02-18,8,0,1,0,1,10
3397,2023-02-19,13,0,0,0,2,15
3398,2023-02-20,0,0,1,0,0,1
3399,2023-02-21,12,1,2,0,15,30
3400,2023-02-22,10,0,0,0,1,11
3401,2023-02-23,3,1,1,1,1,7
3402,2023-02-24,7,1,2,0,5,15
3403,2023-02-25,10,0,2,0,1,13
3404,2023-02-26,9,1,4,0,0,14
3405,2023-02-27,18,0,1,0,11,30
3406,2023-02-28,11,0,1,0,0,12
3407,2023-03-01,10,0,2,1,3,16
3408,2023-03-02,12,0,2,0,0,14
3409,2023-03-03,8,0,4,0,7,19
3410,2023-03-04,23,1,1,0,2,27
3411,2023-03-05,8,0,1,0,5,14
3412,2023-03-06,9,1,0,0,2,12
3413,2023-03-07,11,0,5,0,1,17
3414,2023-03-08,13,0,4,0,2,19
3415,2023-03-09,10,0,4,0,2,16
3416,2023-03-10,12,0,6,0,7,25
3417,2023-03-11,13,0,0,0,0,13
3418,2023-03-12,15,0,2,0,1,18
3419,2023-03-13,14,0,2,0,2,18
3420,2023-03-14,14,0,5,0,1,20
3421,2023-03-15,19,1,2,0,8,30
3422,2023-03-16,12,0,3,0,3,18
3423,2023-03-17,13,0,3,2,6,24
3424,2023-03-18,11,0,2,2,3,18
3425,2023-03-19,5,0,2,0,2,9
3426,2023-03-20,11,0,3,0,2,16
3427,2023-03-21,7,0,4,0,1,12
3428,2023-03-22,7,0,2,1,5,15
3429,2023-03-23,9,0,6,0,3,18
3430,2023-03-24,1,0,3,0,3,7
3431,2023-03-25,13,0,4,0,4,21
3432,2023-03-26,6,0,1,0,7,14
3433,2023-03-27,17,0,1,0,2,20
3434,2023-03-28,11,0,0,0,3,14
3435,2023-03-29,5,1,10,0,4,20
3436,2023-03-30,8,0,1,0,9,18
3437,2023-03-31,7,0,3,0,2,12
3438,2023-04-01,16,0,1,1,4,22
3439,2023-04-02,14,0,1,0,1,16
3440,2023-04-03,11,0,1,0,1,13
3441,2023-04-04,10,0,0,0,1,11
3442,2023-04-05,10,0,1,0,2,13
3443,2023-04-06,5,1,3,0,7,16
3444,2023-04-07,10,0,1,0,5,16
3445,2023-04-08,11,0,5,3,4,23
3446,2023-04-09,3,1,1,0,6,11
3447,2023-04-10,14,1,2,0,4,21
3448,2023-04-11,4,0,0,1,3,8
3449,2023-04-12,5,3,4,0,8,20
3450,2023-04-13,4,0,7,0,4,15
3451,2023-04-14,12,0,8,0,5,25
3452,2023-04-15,14,0,2,0,6,22
3453,2023-04-16,9,1,4,0,0,14
3454,2023-04-17,13,0,2,0,1,16
3455,2023-04-18,9,0,3,1,2,15
3456,2023-04-19,3,0,0,0,0,3
3457,2023-04-20,3,0,3,1,2,9
3458,2023-04-21,7,0,8,0,3,18
3459,2023-04-22,18,0,1,0,1,20
3460,2023-04-23,8,0,1,1,1,11
3461,2023-04-24,11,0,1,0,2,14
3462,2023-04-25,8,0,2,2,3,15
3463,2023-04-26,9,0,1,0,5,15
3464,2023-04-27,7,0,2,0,4,13
3465,2023-04-28,4,0,3,1,5,13
3466,2023-04-29,9,1,4,0,4,18
3467,2023-04-30,4,1,5,0,2,12
3468,2023-05-01,14,0,6,2,2,24
3469,2023-05-02,8,0,2,1,0,11
3470,2023-05-03,5,0,2,0,1,8
3471,2023-05-04,5,1,3,1,2,12
3472,2023-05-05,8,0,1,0,6,15
3473,2023-05-06,9,0,1,0,3,13
3474,2023-05-07,11,0,1,0,8,20
3475,2023-05-08,18,0,2,0,8,28
3476,2023-05-09,7,0,5,0,2,14
3477,2023-05-10,5,1,4,0,1,11
3478,2023-05-11,9,0,7,0,7,23
3479,2023-05-12,11,0,6,0,14,31
3480,2023-05-13,10,0,2,0,1,13
3481,2023-05-14,14,1,1,0,1,17
3482,2023-05-15,10,0,2,0,5,17
3483,2023-05-16,7,0,3,0,9,19
3484,2023-05-17,10,2,1,0,4,17
3485,2023-05-18,3,0,2,0,18,23
3486,2023-05-19,1,0,2,0,1,4
3487,2023-05-20,4,0,1,0,3,8
3488,2023-05-21,6,0,3,0,6,15
3489,2023-05-22,16,0,3,1,0,20
3490,2023-05-23,15,1,3,0,2,21
3491,2023-05-24,5,0,5,0,2,12
3492,2023-05-25,6,0,0,0,2,8
3493,2023-05-26,10,0,2,0,5,17
3494,2023-05-27,6,2,0,0,3,11
3495,2023-05-28,8,0,4,0,3,15
3496,2023-05-29,0,0,0,0,2,2
3497,2023-05-30,15,0,3,0,11,29
3498,2023-05-31,6,0,2,0,3,11
3499,2023-06-01,12,0,3,0,5,20
3500,2023-06-02,13,0,2,1,6,22
3501,2023-06-03,6,0,3,0,1,10
3502,2023-06-04,4,0,3,0,3,10
3503,2023-06-05,14,0,7,0,12,33
3504,2023-06-06,11,0,1,0,2,14
3505,2023-06-07,9,0,5,1,7,22
3506,2023-06-08,10,0,3,0,2,15
3507,2023-06-09,6,0,0,0,4,10
3508,2023-06-10,5,0,1,1,15,22
3509,2023-06-11,7,1,1,0,1,10
3510,2023-06-12,10,0,3,0,11,24
3511,2023-06-13,9,0,3,0,3,15
3512,2023-06-14,9,1,4,0,7,21
3513,2023-06-15,2,0,3,0,0,5
3514,2023-06-16,7,0,2,1,5,15
3515,2023-06-17,2,0,4,0,0,6
3516,2023-06-18,5,0,3,0,0,8
3517,2023-06-19,0,0,0,0,1,1
3518,2023-06-20,10,0,1,0,0,11
3519,2023-06-21,10,2,1,0,8,21
3520,2023-06-22,3,0,3,0,20,26
3521,2023-06-23,8,0,1,0,0,9
3522,2023-06-24,8,0,1,0,5,14
3523,2023-06-25,7,0,0,0,3,10
3524,2023-06-26,10,1,2,0,5,18
3525,2023-06-27,8,0,4,0,2,14
3526,2023-06-28,5,0,3,0,5,13
3527,2023-06-29,11,0,5,0,1,17
3528,2023-06-30,11,0,1,0,3,15
3529,2023-07-01,3,0,0,0,1,4
3530,2023-07-02,3,0,1,0,0,4
3531,2023-07-03,8,0,1,0,4,13
3532,2023-07-04,0,1,1,0,0,2
3533,2023-07-05,13,0,0,0,4,17
3534,2023-07-06,5,0,7,0,1,13
3535,2023-07-07,7,0,6,1,0,14
3536,2023-07-08,9,0,1,1,0,11
3537,2023-07-09,5,1,5,0,0,11
3538,2023-07-10,11,0,1,0,8,20
3539,2023-07-11,14,0,1,0,0,15
3540,2023-07-12,4,0,4,0,4,12
3541,2023-07-13,2,0,0,0,2,4
3542,2023-07-14,10,0,0,0,1,11
3543,2023-07-15,8,0,1,0,1,10
3544,2023-07-16,8,0,2,0,6,16
3545,2023-07-17,6,0,0,0,3,9
3546,2023-07-18,6,2,1,0,0,9
3547,2023-07-19,12,1,1,0,4,18
3548,2023-07-20,11,0,2,0,1,14
3549,2023-07-21,10,0,1,0,1,12
3550,2023-07-22,8,0,1,1,3,13
3551,2023-07-23,3,0,0,0,3,6
3552,2023-07-24,9,1,2,0,6,18
3553,2023-07-25,7,0,1,1,0,9
3554,2023-07-26,4,1,4,0,2,11
3555,2023-07-27,9,0,0,0,5,14
3556,2023-07-28,7,1,3,0,2,13
3557,2023-07-29,4,0,1,0,1,6
3558,2023-07-30,3,0,0,0,1,4
3559,2023-07-31,10,0,3,0,5,18
3560,2023-08-01,13,1,6,0,3,23
3561,2023-08-02,6,2,3,0,1,12
3562,2023-08-03,6,0,2,0,0,8
3563,2023-08-04,7,0,3,0,1,11
3564,2023-08-05,10,0,0,0,2,12
3565,2023-08-06,7,0,5,1,4,17
3566,2023-08-07,15,0,3,0,3,21
3567,2023-08-08,6,0,0,1,7,14
3568,2023-08-09,4,0,4,0,2,10
3569,2023-08-10,11,1,1,0,11,24
3570,2023-08-11,9,0,2,1,4,16
3571,2023-08-12,4,0,3,0,4,11
3572,2023-08-13,6,0,1,0,3,10
3573,2023-08-14,9,0,3,0,6,18
3574,2023-08-15,6,0,3,0,3,12
3575,2023-08-16,10,0,0,1,0,11
3576,2023-08-17,11,1,2,0,2,16
3577,2023-08-18,1,0,2,1,6,10
3578,2023-08-19,7,0,3,0,1,11
3579,2023-08-20,8,0,2,0,0,10
3580,2023-08-21,7,0,0,0,0,7
3581,2023-08-22,7,0,3,0,0,10
3582,2023-08-23,6,0,1,0,2,9
3583,2023-08-24,1,0,1,0,2,4
3584,2023-08-25,9,0,1,2,1,13
3585,2023-08-26,24,0,2,0,3,29
3586,2023-08-27,6,0,2,0,0,8
3587,2023-08-28,8,0,3,0,0,11
3588,2023-08-29,7,1,0,0,1,9
3589,2023-08-30,5,1,5,0,3,14
3590,2023-08-31,3,2,3,0,1,9
3591,2023-09-01,7,0,2,0,4,13
3592,2023-09-02,7,0,0,0,1,8
3593,2023-09-03,8,0,0,0,2,10
3594,2023-09-05,10,0,4,0,2,16
3595,2023-09-06,10,0,0,0,2,12
3596,2023-09-07,9,0,1,0,3,13
3597,2023-09-08,4,0,1,0,2,7
3598,2023-09-09,6,0,0,0,1,7
3599,2023-09-10,3,0,2,0,0,5
3600,2023-09-11,8,0,1,0,3,12
3601,2023-09-12,16,0,1,0,0,17
3602,2023-09-13,2,0,3,0,2,7
3603,2023-09-14,8,0,3,0,0,11
3604,2023-09-15,4,0,1,1,2,8
3605,2023-09-16,3,1,1,0,0,5
3606,2023-09-17,2,0,0,0,1,3
3607,2023-09-18,9,0,2,0,2,13
3608,2023-09-19,8,0,4,0,1,13
3609,2023-09-20,6,1,1,0,1,9
3610,2023-09-21,4,0,2,0,0,6
3611,2023-09-22,5,0,1,0,12,18
3612,2023-09-23,5,0,2,0,1,8
3613,2023-09-24,7,0,2,1,0,10
3614,2023-09-25,6,0,2,0,1,9
3615,2023-09-26,9,1,3,0,1,14
3616,2023-09-27,11,1,3,0,3,18
3617,2023-09-28,6,0,0,0,2,8
3618,2023-09-29,9,1,7,0,1,18
3619,2023-09-30,1,1,0,0,0,2
3620,2023-10-01,4,0,0,0,1,5
3621,2023-10-02,12,0,4,0,0,16
3622,2023-10-03,4,2,3,0,3,12
3623,2023-10-04,4,1,2,1,9,17
3624,2023-10-05,3,0,1,0,0,4
3625,2023-10-06,7,1,2,0,0,10
3626,2023-10-07,11,0,0,1,0,12
3627,2023-10-08,5,0,3,0,0,8
3628,2023-10-09,8,0,0,0,11,19
3629,2023-10-10,11,0,1,0,4,16
3630,2023-10-11,10,0,1,0,3,14
3631,2023-10-12,7,0,4,0,0,11
3632,2023-10-13,7,0,0,0,3,10
3633,2023-10-14,5,0,1,0,4,10
3634,2023-10-15,5,0,2,0,2,9
3635,2023-10-16,6,2,1,1,0,10
3636,2023-10-17,7,0,2,0,1,10
3637,2023-10-18,7,0,2,0,8,17
3638,2023-10-19,5,0,1,0,2,8
3639,2023-10-20,12,0,1,0,7,20
3640,2023-10-21,8,0,1,1,10,20
3641,2023-10-22,8,0,1,0,1,10
3642,2023-10-23,11,0,2,0,0,13
3643,2023-10-24,2,1,1,0,3,7
3644,2023-10-25,5,1,1,1,7,15
3645,2023-10-26,17,1,4,0,4,26
3646,2023-10-27,6,0,6,0,9,21
3647,2023-10-28,4,0,3,0,0,7
3648,2023-10-29,2,0,0,0,1,3
3649,2023-10-30,8,0,1,1,1,11
3650,2023-10-31,13,0,0,0,6,19
3651,2023-11-01,9,0,2,0,1,12
3652,2023-11-02,11,0,1,0,0,12
3653,2023-11-03,1,0,2,0,0,3
3654,2023-11-04,1,0,3,0,0,4
3655,2023-11-05,11,1,4,0,0,16
3656,2023-11-06,13,0,1,0,2,16
3657,2023-11-07,5,0,1,0,2,8
3658,2023-11-08,11,0,0,1,16,28
3659,2023-11-09,10,1,12,0,2,25
3660,2023-11-10,0,2,0,0,1,3
3661,2023-11-11,9,0,1,1,1,12
3662,2023-11-12,6,0,0,0,1,7
3663,2023-11-13,8,0,1,2,3,14
3664,2023-11-14,10,0,2,0,0,12
3665,2023-11-15,11,0,2,1,6,20
3666,2023-11-16,11,0,0,0,2,13
3667,2023-11-17,10,1,1,0,0,12
3668,2023-11-18,2,0,0,0,5,7
3669,2023-11-19,10,0,1,0,0,11
3670,2023-11-20,12,0,1,0,0,13
3671,2023-11-21,17,0,4,0,5,26
3672,2023-11-22,25,0,2,0,2,29
3673,2023-11-24,0,0,0,0,1,1
3674,2023-11-25,14,0,3,0,0,17
3675,2023-11-26,10,0,1,0,0,11
3676,2023-11-27,12,0,1,0,0,13
3677,2023-11-28,9,0,7,0,1,17
3678,2023-11-29,6,0,2,0,2,10
3679,2023-11-30,7,1,4,1,1,14
3680,2023-12-01,15,0,2,0,2,19
3681,2023-12-02,6,0,4,0,0,10
3682,2023-12-03,5,0,0,0,0,5
3683,2023-12-04,11,0,2,0,0,13
3684,2023-12-05,11,0,2,0,2,15
3685,2023-12-06,14,0,4,0,4,22
3686,2023-12-07,9,0,1,0,2,12
3687,2023-12-08,12,0,0,0,2,14
3688,2023-12-09,3,0,3,0,1,7
3689,2023-12-10,4,0,0,0,1,5
3690,2023-12-11,12,0,3,0,0,15
3691,2023-12-12,10,0,3,0,2,15
3692,2023-12-13,12,0,2,0,0,14
3693,2023-12-14,11,0,3,0,7,21
3694,2023-12-15,10,1,0,0,11,22
3695,2023-12-16,10,0,1,0,1,12
3696,2023-12-17,5,0,2,0,1,8
3697,2023-12-18,9,0,1,0,0,10
3698,2023-12-19,10,0,4,1,4,19
3699,2023-12-20,15,0,2,0,0,17
3700,2023-12-21,12,0,1,0,1,14
3701,2023-12-22,9,0,2,1,14,26
3702,2023-12-23,1,0,2,0,1,4
3703,2023-12-24,4,1,1,0,0,6
3704,2023-12-25,0,1,0,0,0,1
3705,2023-12-26,0,0,0,0,4,4
3706,2023-12-27,7,0,5,0,3,15
3707,2023-12-28,21,1,0,0,1,23
3708,2023-12-29,8,0,2,0,5,15
3709,2023-12-30,8,0,1,0,0,9
3710,2023-12-31,1,0,3,0,0,4
3711,2024-01-02,19,0,7,0,1,27
3712,2024-01-03,11,0,1,0,3,15
3713,2024-01-04,14,0,5,1,3,23
3714,2024-01-05,24,0,3,0,2,29
3715,2024-01-06,6,0,2,0,0,8
3716,2024-01-07,3,0,2,0,1,6
3717,2024-01-08,13,1,2,0,2,18
3718,2024-01-09,10,1,3,0,2,16
3719,2024-01-10,9,0,1,0,3,13
3720,2024-01-11,12,0,4,0,3,19
3721,2024-01-12,16,0,1,0,0,17
3722,2024-01-13,7,0,5,0,4,16
3723,2024-01-14,10,0,2,0,0,12
3724,2024-01-16,27,1,3,0,3,34
3725,2024-01-17,8,0,5,0,2,15
3726,2024-01-18,14,0,4,0,1,19
3727,2024-01-19,15,1,3,0,6,25
3728,2024-01-20,7,2,3,1,3,16
3729,2024-01-21,21,0,0,0,1,22
3730,2024-01-22,7,1,0,0,8,16
3731,2024-01-23,12,0,1,0,0,13
3732,2024-01-24,8,0,1,1,1,11
3733,2024-01-25,8,1,1,0,0,10
3734,2024-01-26,2,0,0,0,1,3
3735,2024-01-27,11,0,0,0,1,12
3736,2024-01-28,20,0,2,0,0,22
3737,2024-01-29,23,2,2,0,4,31
3738,2024-01-30,13,0,4,0,1,18
3739,2024-01-31,10,0,0,0,2,12
3740,2024-02-01,9,0,4,0,1,14
3741,2024-02-02,10,0,2,0,3,15
3742,2024-02-03,9,0,0,0,2,11
3743,2024-02-04,12,1,4,0,2,19
3744,2024-02-05,13,1,3,0,0,17
3745,2024-02-06,7,0,2,0,0,9
3746,2024-02-07,10,0,5,0,2,17
3747,2024-02-08,16,0,4,0,8,28
3748,2024-02-09,14,0,3,0,3,20
3749,2024-02-10,17,0,0,0,2,19
3750,2024-02-11,6,0,0,0,3,9
3751,2024-02-12,18,0,4,0,3,25
3752,2024-02-13,15,0,7,0,2,24
3753,2024-02-14,10,0,3,0,4,17
3754,2024-02-15,9,0,1,0,3,13
3755,2024-02-16,11,0,2,0,2,15
3756,2024-02-17,8,0,5,0,0,13
3757,2024-02-18,10,2,2,1,6,21
3758,2024-02-19,0,0,0,0,2,2
3759,2024-02-20,18,1,3,0,1,23
3760,2024-02-21,10,0,3,2,8,23
3761,2024-02-22,13,0,2,0,0,15
3762,2024-02-23,11,1,3,0,1,16
3763,2024-02-24,10,0,1,0,0,11
3764,2024-02-25,12,0,4,0,0,16
3765,2024-02-26,17,0,1,1,0,19
3766,2024-02-27,14,0,3,0,2,19
3767,2024-02-28,8,0,0,0,5,13
3768,2024-02-29,15,1,4,0,1,21
3769,2024-03-01,10,2,1,0,1,14
3770,2024-03-02,6,1,4,0,7,18
3771,2024-03-03,11,0,0,0,1,12
3772,2024-03-04,7,1,8,1,5,22
3773,2024-03-05,15,0,6,0,8,29
3774,2024-03-06,8,0,2,0,2,12
3775,2024-03-07,12,0,4,0,2,18
3776,2024-03-08,15,0,3,0,1,19
3777,2024-03-09,6,0,3,0,1,10
3778,2024-03-10,3,0,0,1,0,4
3779,2024-03-11,14,0,2,0,2,18
3780,2024-03-12,18,0,1,0,5,24
3781,2024-03-13,8,0,8,0,2,18
3782,2024-03-14,6,0,5,0,1,12
3783,2024-03-15,8,0,2,0,1,11
3784,2024-03-16,7,0,0,0,0,7
3785,2024-03-17,4,0,4,0,2,10
3786,2024-03-18,10,0,0,0,1,11
3787,2024-03-19,7,1,5,0,0,13
3788,2024-03-20,10,0,2,0,2,14
3789,2024-03-21,14,0,1,0,1,16
3790,2024-03-22,9,1,3,1,0,14
3791,2024-03-23,13,1,1,0,4,19
3792,2024-03-24,13,0,0,0,1,14
3793,2024-03-25,22,1,2,0,4,29
3794,2024-03-26,12,0,2,0,3,17
3795,2024-03-27,4,0,3,0,0,7
3796,2024-03-28,11,0,3,0,14,28
3797,2024-03-29,4,1,1,0,1,7
3798,2024-03-30,16,0,3,0,6,25
3799,2024-03-31,4,0,0,1,2,7
3800,2024-04-01,13,0,1,0,1,15
3801,2024-04-02,12,0,2,0,2,16
3802,2024-04-03,9,0,3,0,0,12
3803,2024-04-04,4,1,4,0,1,10
3804,2024-04-05,5,0,2,0,3,10
3805,2024-04-06,6,0,1,0,1,8
3806,2024-04-07,13,0,1,0,1,15
3807,2024-04-08,3,0,3,1,0,7
3808,2024-04-09,15,0,13,0,3,31
3809,2024-04-10,14,0,0,0,6,20
3810,2024-04-11,7,0,0,0,0,7
3811,2024-04-12,4,0,2,0,5,11
3812,2024-04-13,12,0,1,0,3,16
3813,2024-04-14,10,0,1,0,4,15
3814,2024-04-15,13,0,4,0,2,19
3815,2024-04-16,9,1,2,0,2,14
3816,2024-04-17,10,0,4,0,3,17
3817,2024-04-18,9,0,6,0,1,16
3818,2024-04-19,8,0,0,0,2,10
3819,2024-04-20,9,1,4,0,3,17
3820,2024-04-21,1,0,0,0,1,2
3821,2024-04-22,4,0,2,0,0,6
3822,2024-04-23,12,0,2,1,7,22
3823,2024-04-24,7,0,1,1,6,15
3824,2024-04-25,21,3,4,0,9,37
3825,2024-04-26,14,0,3,0,1,18
3826,2024-04-27,7,0,5,0,2,14
3827,2024-04-28,7,0,1,0,2,10
3828,2024-04-29,3,0,2,0,13,18
3829,2024-04-30,11,0,1,0,4,16
3830,2024-05-01,2,0,2,0,0,4
3831,2024-05-02,9,0,2,0,2,13
3832,2024-05-03,12,0,2,1,5,20
3833,2024-05-04,6,0,3,0,1,10
3834,2024-05-05,5,0,3,0,3,11
3835,2024-05-06,20,1,6,0,4,31
3836,2024-05-07,9,0,5,0,1,15
3837,2024-05-08,5,2,3,0,1,11
3838,2024-05-09,19,0,3,0,3,25
3839,2024-05-10,5,0,1,0,1,7
3840,2024-05-11,19,1,1,0,0,21
3841,2024-05-12,5,0,1,0,0,6
3842,2024-05-13,8,0,2,0,6,16
3843,2024-05-14,5,0,1,0,4,10
3844,2024-05-15,10,1,4,2,3,20
3845,2024-05-16,11,1,1,0,8,21
3846,2024-05-17,7,0,1,0,5,13
3847,2024-05-18,3,0,1,0,0,4
