,DateTime,Stray_Abandoned,Euthanasia_Req,Public_Assist,Owner_Surrender,Other,TotalIntakes
0,2013-10-01,30,1,2,9,0,42
1,2013-10-02,20,0,4,4,0,28
2,2013-10-03,19,0,4,3,0,26
3,2013-10-04,24,0,0,6,0,30
4,2013-10-05,27,0,4,8,0,39
5,2013-10-06,15,1,3,6,0,25
6,2013-10-07,13,0,2,3,0,18
7,2013-10-08,32,0,3,7,0,42
8,2013-10-09,27,0,1,1,0,29
9,2013-10-10,23,1,2,4,0,30
10,2013-10-11,29,0,2,2,0,33
11,2013-10-12,26,0,3,7,0,36
12,2013-10-13,23,0,0,3,0,26
13,2013-10-14,30,1,1,4,0,36
14,2013-10-15,33,2,2,16,0,53
15,2013-10-16,38,0,2,4,0,44
16,2013-10-17,22,0,1,3,0,26
17,2013-10-18,14,0,3,6,0,23
18,2013-10-19,21,1,1,4,0,27
19,2013-10-20,19,0,2,5,0,26
20,2013-10-21,29,0,0,4,0,33
21,2013-10-22,20,0,2,5,0,27
22,2013-10-23,21,0,2,6,0,29
23,2013-10-24,17,1,2,9,0,29
24,2013-10-25,21,0,1,6,0,28
25,2013-10-26,23,0,5,6,0,34
26,2013-10-27,26,0,0,5,0,31
27,2013-10-28,23,1,0,7,0,31
28,2013-10-29,19,0,7,7,0,33
29,2013-10-30,19,0,3,7,0,29
30,2013-10-31,13,0,2,7,0,22
31,2013-11-01,21,0,4,15,0,40
32,2013-11-02,23,0,2,3,0,28
33,2013-11-03,16,0,1,5,0,22
34,2013-11-04,14,0,0,15,0,29
35,2013-11-05,24,0,2,4,0,30
36,2013-11-06,23,0,2,5,0,30
37,2013-11-07,25,0,3,2,0,30
38,2013-11-08,25,0,4,7,0,36
39,2013-11-09,27,0,1,5,0,33
40,2013-11-10,20,0,1,1,0,22
41,2013-11-11,10,0,0,5,0,15
42,2013-11-12,28,0,3,6,0,37
43,2013-11-13,12,0,2,3,0,17
44,2013-11-14,20,1,2,6,0,29
45,2013-11-15,21,0,0,7,0,28
46,2013-11-16,18,0,4,4,0,26
47,2013-11-17,21,0,2,11,0,34
48,2013-11-18,18,0,0,3,0,21
49,2013-11-19,17,0,1,6,0,24
50,2013-11-20,18,0,0,3,0,21
51,2013-11-21,18,0,1,2,0,21
52,2013-11-22,17,0,4,3,0,24
53,2013-11-23,18,0,0,6,0,24
54,2013-11-24,19,0,1,4,0,24
55,2013-11-25,37,0,0,6,0,43
56,2013-11-26,19,0,5,10,0,34
57,2013-11-27,31,0,1,6,0,38
58,2013-11-28,6,0,0,1,0,7
59,2013-11-29,24,0,1,1,0,26
60,2013-11-30,21,0,1,2,0,24
61,2013-12-01,7,0,2,2,0,11
62,2013-12-02,30,0,0,6,0,36
63,2013-12-03,23,0,0,2,0,25
64,2013-12-04,20,1,23,3,0,47
65,2013-12-05,17,0,7,4,0,28
66,2013-12-06,17,0,3,7,0,27
67,2013-12-07,17,0,1,4,0,22
68,2013-12-08,13,0,0,12,0,25
69,2013-12-09,24,0,2,6,0,32
70,2013-12-10,14,0,0,5,0,19
71,2013-12-11,15,1,1,6,0,23
72,2013-12-12,25,0,6,3,0,34
73,2013-12-13,10,1,1,5,0,17
74,2013-12-14,29,0,2,6,0,37
75,2013-12-15,18,0,3,3,0,24
76,2013-12-16,15,1,0,13,0,29
77,2013-12-17,33,0,0,6,0,39
78,2013-12-18,13,0,0,5,0,18
79,2013-12-19,18,0,2,3,0,23
80,2013-12-20,19,0,4,6,0,29
81,2013-12-21,28,2,2,4,0,36
82,2013-12-22,9,0,3,13,0,25
83,2013-12-23,17,1,1,12,0,31
84,2013-12-24,12,1,7,4,0,24
85,2013-12-25,4,0,2,0,0,6
86,2013-12-26,32,1,4,1,0,38
87,2013-12-27,19,0,1,2,0,22
88,2013-12-28,21,0,0,5,0,26
89,2013-12-29,26,0,3,5,0,34
90,2013-12-30,21,0,1,8,0,30
91,2013-12-31,27,0,2,6,0,35
92,2014-01-01,32,0,2,5,0,39
93,2014-01-02,32,0,0,2,0,34
94,2014-01-03,26,0,0,3,0,29
95,2014-01-04,29,0,2,7,0,38
96,2014-01-05,15,0,1,4,0,20
97,2014-01-06,12,1,0,9,0,22
98,2014-01-07,21,0,2,5,0,28
99,2014-01-08,18,0,3,10,0,31
100,2014-01-09,29,1,0,6,0,36
101,2014-01-10,17,0,1,3,0,21
102,2014-01-11,34,0,0,3,0,37
103,2014-01-12,18,0,0,5,0,23
104,2014-01-13,27,0,0,9,0,36
105,2014-01-14,28,0,0,7,0,35
106,2014-01-15,17,0,2,11,0,30
107,2014-01-16,14,0,3,5,0,22
108,2014-01-17,21,0,5,0,0,26
109,2014-01-18,21,0,4,13,0,38
110,2014-01-19,16,0,2,4,0,22
111,2014-01-20,19,0,3,4,0,26
112,2014-01-21,27,0,1,5,0,33
113,2014-01-22,12,0,4,5,0,21
114,2014-01-23,17,1,2,1,0,21
115,2014-01-24,8,1,4,9,0,22
116,2014-01-25,21,1,4,8,0,34
117,2014-01-26,9,1,2,5,0,17
118,2014-01-27,22,0,6,12,0,40
119,2014-01-28,10,0,2,6,0,18
120,2014-01-29,15,0,1,2,0,18
121,2014-01-30,25,0,1,5,0,31
122,2014-01-31,20,0,5,4,0,29
123,2014-02-01,14,0,0,6,0,20
124,2014-02-02,22,0,0,8,0,30
125,2014-02-03,11,2,0,3,0,16
126,2014-02-04,18,0,4,3,0,25
127,2014-02-05,28,0,2,9,0,39
128,2014-02-06,25,0,2,6,0,33
129,2014-02-07,10,0,2,2,0,14
130,2014-02-08,22,0,1,7,0,30
131,2014-02-09,19,0,0,9,0,28
132,2014-02-10,24,0,3,5,0,32
133,2014-02-11,13,0,0,5,0,18
134,2014-02-12,30,0,2,3,0,35
135,2014-02-13,16,0,4,7,0,27
136,2014-02-14,18,0,2,2,0,22
137,2014-02-15,14,0,3,6,0,23
138,2014-02-16,13,0,3,5,0,21
139,2014-02-17,19,0,2,6,0,27
140,2014-02-18,19,0,5,3,0,27
141,2014-02-19,23,0,52,7,0,82
142,2014-02-20,18,0,3,9,0,30
143,2014-02-21,18,0,1,7,0,26
144,2014-02-22,22,2,0,13,0,37
145,2014-02-23,15,0,3,9,0,27
146,2014-02-24,23,0,3,4,0,30
147,2014-02-25,18,0,1,6,0,25
148,2014-02-26,18,1,2,7,0,28
149,2014-02-27,24,1,5,10,0,40
150,2014-02-28,17,0,3,6,0,26
151,2014-03-01,17,0,0,5,0,22
152,2014-03-02,14,0,2,3,0,19
153,2014-03-03,15,0,0,4,0,19
154,2014-03-04,25,0,0,3,0,28
155,2014-03-05,24,1,2,8,0,35
156,2014-03-06,18,0,4,4,0,26
157,2014-03-07,22,0,4,5,0,31
158,2014-03-08,20,0,1,3,0,24
159,2014-03-09,16,0,2,4,0,22
160,2014-03-10,23,0,3,7,0,33
161,2014-03-11,17,0,1,9,0,27
162,2014-03-12,33,0,2,4,0,39
163,2014-03-13,34,1,2,4,0,41
164,2014-03-14,19,0,5,11,0,35
165,2014-03-15,29,0,1,8,0,38
166,2014-03-16,32,0,2,5,0,39
167,2014-03-17,16,1,4,6,0,27
168,2014-03-18,15,2,4,8,0,29
169,2014-03-19,27,0,4,3,0,34
170,2014-03-20,14,1,3,6,0,24
171,2014-03-21,24,0,4,5,0,33
172,2014-03-22,19,0,2,6,0,27
173,2014-03-23,17,0,1,7,0,25
174,2014-03-24,9,0,2,4,0,15
175,2014-03-25,24,0,1,8,0,33
176,2014-03-26,38,0,1,3,0,42
177,2014-03-27,9,0,7,3,0,19
178,2014-03-28,14,0,2,5,0,21
179,2014-03-29,19,0,1,10,0,30
180,2014-03-30,26,0,1,2,0,29
181,2014-03-31,21,0,2,6,0,29
182,2014-04-01,26,0,2,1,0,29
183,2014-04-02,25,0,3,13,0,41
184,2014-04-03,15,0,2,5,0,22
185,2014-04-04,18,0,3,6,0,27
186,2014-04-05,27,0,7,8,0,42
187,2014-04-06,25,0,1,7,0,33
188,2014-04-07,21,0,1,6,0,28
189,2014-04-08,30,1,3,0,0,34
190,2014-04-09,15,0,3,2,0,20
191,2014-04-10,9,0,1,5,0,15
192,2014-04-11,23,0,2,8,0,33
193,2014-04-12,19,0,7,7,0,33
194,2014-04-13,15,0,1,3,0,19
195,2014-04-14,37,0,3,3,0,43
196,2014-04-15,26,0,2,5,0,33
197,2014-04-16,19,0,5,4,0,28
198,2014-04-17,16,1,2,10,0,29
199,2014-04-18,21,0,5,6,0,32
200,2014-04-19,20,0,2,6,0,28
201,2014-04-20,16,0,1,0,0,17
202,2014-04-21,28,1,2,4,0,35
203,2014-04-22,12,0,3,3,0,18
204,2014-04-23,19,0,8,5,0,32
205,2014-04-24,12,0,1,1,0,14
206,2014-04-25,18,0,5,5,0,28
207,2014-04-26,20,0,2,8,0,30
208,2014-04-27,29,1,0,4,0,34
209,2014-04-28,20,0,3,4,0,27
210,2014-04-29,15,0,2,5,0,22
211,2014-04-30,24,0,3,5,0,32
212,2014-05-01,15,1,8,3,0,27
213,2014-05-02,7,0,1,7,0,15
214,2014-05-03,14,1,1,7,0,23
215,2014-05-04,15,0,2,5,0,22
216,2014-05-05,20,0,5,7,0,32
217,2014-05-06,24,0,6,9,0,39
218,2014-05-07,21,0,4,6,0,31
219,2014-05-08,18,1,2,4,0,25
220,2014-05-09,23,0,2,3,0,28
221,2014-05-10,29,0,5,5,0,39
222,2014-05-11,14,0,1,2,0,17
223,2014-05-12,30,0,4,10,0,44
224,2014-05-13,30,0,1,5,0,36
225,2014-05-14,34,0,0,8,0,42
226,2014-05-15,19,0,3,2,0,24
227,2014-05-16,23,0,6,2,0,31
228,2014-05-17,35,0,4,7,0,46
229,2014-05-18,13,0,2,1,0,16
230,2014-05-19,19,0,8,4,0,31
231,2014-05-20,19,0,2,6,0,27
232,2014-05-21,25,0,1,6,0,32
233,2014-05-22,12,0,1,3,0,16
234,2014-05-23,27,0,2,5,0,34
235,2014-05-24,25,0,5,5,0,35
236,2014-05-25,33,0,2,3,0,38
237,2014-05-26,16,0,0,0,0,16
238,2014-05-27,23,0,9,5,0,37
239,2014-05-28,31,0,2,9,0,42
240,2014-05-29,31,0,3,6,0,40
241,2014-05-30,35,0,5,8,0,48
242,2014-05-31,27,0,4,2,0,33
243,2014-06-01,17,0,1,9,0,27
244,2014-06-02,26,0,5,6,0,37
245,2014-06-03,22,0,2,8,0,32
246,2014-06-04,21,0,3,3,0,27
247,2014-06-05,18,0,2,2,0,22
248,2014-06-06,12,0,1,3,0,16
249,2014-06-07,20,0,2,6,0,28
250,2014-06-08,13,0,1,5,0,19
251,2014-06-09,24,0,0,5,0,29
252,2014-06-10,19,0,2,7,0,28
253,2014-06-11,23,0,4,2,0,29
254,2014-06-12,9,0,2,5,0,16
255,2014-06-13,34,0,3,6,0,43
256,2014-06-14,31,0,1,10,0,42
257,2014-06-15,16,0,2,4,0,22
258,2014-06-16,16,0,1,5,0,22
259,2014-06-17,29,0,5,5,0,39
260,2014-06-18,31,0,4,4,0,39
261,2014-06-19,23,1,2,7,0,33
262,2014-06-20,14,0,6,3,0,23
263,2014-06-21,15,0,5,11,0,31
264,2014-06-22,17,0,1,5,0,23
265,2014-06-23,13,0,4,5,0,22
266,2014-06-24,29,0,2,2,0,33
267,2014-06-25,26,0,3,7,0,36
268,2014-06-26,19,0,3,12,0,34
269,2014-06-27,21,2,4,5,0,32
270,2014-06-28,20,0,0,3,0,23
271,2014-06-29,24,1,7,7,0,39
272,2014-06-30,23,1,1,7,0,32
273,2014-07-01,21,1,1,3,0,26
274,2014-07-02,18,0,2,3,0,23
275,2014-07-03,31,0,2,5,0,38
276,2014-07-04,19,0,0,2,0,21
277,2014-07-05,35,0,0,9,0,44
278,2014-07-06,31,0,1,2,0,34
279,2014-07-07,22,0,4,4,0,30
280,2014-07-08,13,0,0,3,0,16
281,2014-07-09,26,0,11,5,0,42
282,2014-07-10,27,0,5,3,0,35
283,2014-07-11,29,0,1,2,0,32
284,2014-07-12,23,0,0,5,0,28
285,2014-07-13,14,0,0,11,0,25
286,2014-07-14,14,0,5,3,0,22
287,2014-07-15,33,0,1,6,0,40
288,2014-07-16,18,0,2,5,0,25
289,2014-07-17,17,0,1,4,0,22
290,2014-07-18,20,1,2,7,0,30
291,2014-07-19,26,0,8,5,0,39
292,2014-07-20,16,0,5,4,0,25
293,2014-07-21,23,1,4,15,0,43
294,2014-07-22,18,0,3,4,0,25
295,2014-07-23,24,1,4,7,0,36
296,2014-07-24,20,0,9,5,0,34
297,2014-07-25,29,1,5,1,0,36
298,2014-07-26,17,0,1,3,0,21
299,2014-07-27,21,0,0,5,0,26
300,2014-07-28,13,0,4,10,0,27
301,2014-07-29,14,1,2,11,0,28
302,2014-07-30,30,2,1,1,0,34
303,2014-07-31,12,0,3,4,0,19
304,2014-08-01,15,1,5,6,0,27
305,2014-08-02,25,1,0,4,0,30
306,2014-08-03,24,0,3,3,0,30
307,2014-08-04,24,1,1,8,0,34
308,2014-08-05,14,1,1,5,0,21
309,2014-08-06,25,0,2,0,0,27
310,2014-08-07,25,0,1,7,0,33
311,2014-08-08,16,1,3,6,0,26
312,2014-08-09,22,0,2,13,0,37
313,2014-08-10,18,0,1,6,0,25
314,2014-08-11,17,0,4,3,0,24
315,2014-08-12,29,1,0,9,0,39
316,2014-08-13,15,0,5,4,0,24
317,2014-08-14,23,0,3,6,0,32
318,2014-08-15,22,0,2,11,0,35
319,2014-08-16,17,0,2,3,0,22
320,2014-08-17,13,0,1,5,0,19
321,2014-08-18,16,0,4,6,0,26
322,2014-08-19,20,0,3,4,0,27
323,2014-08-20,13,0,5,3,0,21
324,2014-08-21,25,0,3,5,0,33
325,2014-08-22,10,0,0,1,0,11
326,2014-08-23,17,0,3,4,0,24
327,2014-08-24,19,0,0,13,0,32
328,2014-08-25,24,1,1,4,0,30
329,2014-08-26,11,0,3,7,0,21
330,2014-08-27,19,0,0,7,0,26
331,2014-08-28,21,0,2,2,0,25
332,2014-08-29,22,0,3,4,0,29
333,2014-08-30,27,0,1,3,0,31
334,2014-08-31,11,0,4,5,0,20
335,2014-09-01,19,0,3,6,0,28
336,2014-09-02,19,0,5,20,0,44
337,2014-09-03,26,0,2,5,0,33
338,2014-09-04,32,0,1,7,0,40
339,2014-09-05,14,1,8,3,0,26
340,2014-09-06,23,0,4,1,0,28
341,2014-09-07,22,0,4,7,0,33
342,2014-09-08,13,0,1,9,0,23
343,2014-09-09,15,0,3,4,0,22
344,2014-09-10,20,0,1,19,0,40
345,2014-09-11,11,0,2,6,0,19
346,2014-09-12,21,0,2,4,0,27
347,2014-09-13,21,0,4,2,0,27
348,2014-09-14,21,1,1,7,0,30
349,2014-09-15,28,1,2,7,0,38
350,2014-09-16,20,1,1,12,0,34
351,2014-09-17,18,0,1,10,0,29
352,2014-09-18,32,0,2,3,0,37
353,2014-09-19,33,1,4,12,0,50
354,2014-09-20,34,0,1,3,0,38
355,2014-09-21,20,0,0,3,0,23
356,2014-09-22,35,0,2,3,0,40
357,2014-09-23,17,0,2,8,0,27
358,2014-09-24,15,1,5,3,0,24
359,2014-09-25,19,0,1,6,0,26
360,2014-09-26,19,0,0,4,0,23
361,2014-09-27,17,0,2,3,0,22
362,2014-09-28,11,0,1,13,0,25
363,2014-09-29,25,0,2,1,0,28
364,2014-09-30,20,0,2,11,0,33
365,2014-10-01,30,0,1,2,0,33
366,2014-10-02,23,0,4,5,0,32
367,2014-10-03,21,0,1,6,0,28
368,2014-10-04,26,1,3,4,0,34
369,2014-10-05,11,1,6,2,0,20
370,2014-10-06,18,0,1,4,0,23
371,2014-10-07,22,0,5,4,0,31
372,2014-10-08,21,0,1,2,0,24
373,2014-10-09,24,1,3,7,0,35
374,2014-10-10,21,2,1,2,0,26
375,2014-10-11,15,2,4,3,0,24
376,2014-10-12,13,1,3,1,0,18
377,2014-10-13,21,0,4,3,0,28
378,2014-10-14,25,0,3,6,0,34
379,2014-10-15,19,0,2,4,0,25
380,2014-10-16,25,0,1,5,0,31
381,2014-10-17,16,0,1,4,0,21
382,2014-10-18,19,1,4,4,0,28
383,2014-10-19,16,0,2,7,0,25
384,2014-10-20,9,0,2,6,0,17
385,2014-10-21,27,2,1,8,0,38
386,2014-10-22,20,0,3,6,0,29
387,2014-10-23,17,1,3,9,0,30
388,2014-10-24,21,0,2,4,0,27
389,2014-10-25,20,0,4,9,0,33
390,2014-10-26,9,0,0,12,0,21
391,2014-10-27,19,0,1,11,0,31
392,2014-10-28,28,0,2,4,0,34
393,2014-10-29,24,0,2,5,0,31
394,2014-10-30,14,0,4,3,0,21
395,2014-10-31,18,0,1,2,0,21
396,2014-11-01,16,0,2,5,0,23
397,2014-11-02,17,0,3,5,0,25
398,2014-11-03,25,2,2,10,0,39
399,2014-11-04,19,0,2,3,0,24
400,2014-11-05,14,0,2,5,0,21
401,2014-11-06,15,0,6,5,0,26
402,2014-11-07,28,0,0,3,0,31
403,2014-11-08,37,0,1,13,0,51
404,2014-11-09,16,0,0,2,0,18
405,2014-11-10,25,1,6,4,0,36
406,2014-11-11,22,0,2,7,0,31
407,2014-11-12,15,0,4,4,0,23
408,2014-11-13,16,0,6,5,0,27
409,2014-11-14,30,0,0,3,0,33
410,2014-11-15,17,0,3,2,0,22
411,2014-11-16,12,0,2,3,0,17
412,2014-11-17,19,0,2,5,0,26
413,2014-11-18,16,1,0,8,0,25
414,2014-11-19,19,2,0,13,0,34
415,2014-11-20,25,1,1,8,0,35
416,2014-11-21,33,0,0,7,0,40
417,2014-11-22,29,0,2,4,0,35
418,2014-11-23,33,0,3,4,0,40
419,2014-11-24,15,0,2,3,0,20
420,2014-11-25,18,0,1,2,0,21
421,2014-11-26,21,0,3,3,0,27
422,2014-11-27,5,0,1,1,0,7
423,2014-11-28,24,1,3,4,0,32
424,2014-11-29,22,0,0,11,0,33
425,2014-11-30,15,1,1,8,0,25
426,2014-12-01,23,0,5,8,0,36
427,2014-12-02,24,1,1,3,0,29
428,2014-12-03,23,0,3,7,0,33
429,2014-12-04,19,0,3,4,0,26
430,2014-12-05,28,0,1,13,0,42
431,2014-12-06,19,0,0,6,0,25
432,2014-12-07,28,1,2,10,0,41
433,2014-12-08,21,1,2,10,0,34
434,2014-12-09,18,0,3,2,0,23
435,2014-12-10,19,0,2,15,0,36
436,2014-12-11,16,0,0,5,0,21
437,2014-12-12,29,0,4,3,0,36
438,2014-12-13,17,1,2,15,0,35
439,2014-12-14,30,1,1,2,0,34
440,2014-12-15,29,0,3,5,0,37
441,2014-12-16,23,0,2,3,0,28
442,2014-12-17,12,0,10,5,0,27
443,2014-12-18,25,2,3,5,0,35
444,2014-12-19,20,0,3,6,0,29
445,2014-12-20,15,0,0,6,0,21
446,2014-12-21,15,0,0,5,0,20
447,2014-12-22,22,1,1,3,0,27
448,2014-12-23,15,0,1,9,0,25
449,2014-12-24,13,0,1,5,0,19
450,2014-12-25,15,0,1,0,0,16
451,2014-12-26,11,0,0,5,0,16
452,2014-12-27,20,0,2,3,0,25
453,2014-12-28,19,1,2,9,0,31
454,2014-12-29,29,0,1,7,0,37
455,2014-12-30,18,1,1,7,0,27
456,2014-12-31,18,1,1,1,0,21
457,2015-01-01,17,0,0,6,0,23
458,2015-01-02,22,0,1,2,0,25
459,2015-01-03,16,0,0,10,0,26
460,2015-01-04,15,0,1,6,0,22
461,2015-01-05,35,0,1,3,0,39
462,2015-01-06,28,0,0,6,0,34
463,2015-01-07,29,0,2,6,0,37
464,2015-01-08,14,0,0,5,0,19
465,2015-01-09,12,1,1,2,0,16
466,2015-01-10,19,0,2,5,0,26
467,2015-01-11,27,0,0,5,0,32
468,2015-01-12,14,0,3,7,0,24
469,2015-01-13,23,0,1,2,0,26
470,2015-01-14,18,0,1,13,0,32
471,2015-01-15,13,0,3,9,0,25
472,2015-01-16,15,0,5,3,0,23
473,2015-01-17,20,0,1,4,0,25
474,2015-01-18,23,0,1,10,0,34
475,2015-01-19,15,1,2,8,0,26
476,2015-01-20,18,1,5,6,0,30
477,2015-01-21,16,0,1,10,0,27
478,2015-01-22,14,0,2,6,0,22
479,2015-01-23,17,0,2,3,0,22
480,2015-01-24,27,0,2,2,0,31
481,2015-01-25,18,1,1,14,0,34
482,2015-01-26,28,0,0,10,0,38
483,2015-01-27,22,0,2,8,0,32
484,2015-01-28,25,0,5,4,0,34
485,2015-01-29,16,0,4,5,0,25
486,2015-01-30,24,0,2,9,0,35
487,2015-01-31,16,0,2,4,0,22
488,2015-02-01,21,0,1,12,0,34
489,2015-02-02,15,0,1,4,0,20
490,2015-02-03,19,0,0,4,0,23
491,2015-02-04,25,0,5,4,0,34
492,2015-02-05,13,1,0,7,0,21
493,2015-02-06,19,0,3,5,0,27
494,2015-02-07,21,1,1,11,0,34
495,2015-02-08,16,1,4,3,0,24
496,2015-02-09,18,0,1,4,0,23
497,2015-02-10,18,0,1,5,0,24
498,2015-02-11,22,1,5,8,0,36
499,2015-02-12,28,0,4,2,0,34
500,2015-02-13,22,0,3,11,0,36
501,2015-02-14,16,0,8,5,0,29
502,2015-02-15,24,1,0,4,0,29
503,2015-02-16,24,0,2,6,0,32
504,2015-02-17,14,0,1,8,0,23
505,2015-02-18,20,0,2,9,0,31
506,2015-02-19,35,0,0,5,0,40
507,2015-02-20,22,1,2,7,0,32
508,2015-02-21,17,1,3,9,0,30
509,2015-02-22,19,0,1,5,0,25
510,2015-02-23,20,1,1,6,0,28
511,2015-02-24,18,0,3,2,0,23
512,2015-02-25,31,0,9,5,0,45
513,2015-02-26,20,0,3,8,0,31
514,2015-02-27,13,0,1,10,0,24
515,2015-02-28,13,0,3,5,0,21
516,2015-03-01,7,0,1,2,0,10
517,2015-03-02,21,0,3,7,0,31
518,2015-03-03,7,0,1,4,0,12
519,2015-03-04,18,0,6,10,0,34
520,2015-03-05,12,0,2,4,0,18
521,2015-03-06,35,0,3,6,0,44
522,2015-03-07,27,0,3,4,0,34
523,2015-03-08,8,0,2,5,0,15
524,2015-03-09,8,0,1,3,0,12
525,2015-03-10,28,0,3,4,0,35
526,2015-03-11,25,0,2,6,0,33
527,2015-03-12,22,0,5,3,0,30
528,2015-03-13,24,2,4,9,0,39
529,2015-03-14,13,0,1,4,0,18
530,2015-03-15,18,0,12,5,0,35
531,2015-03-16,14,1,7,4,0,26
532,2015-03-17,24,0,3,9,0,36
533,2015-03-18,29,0,3,3,0,35
534,2015-03-19,26,0,3,4,0,33
535,2015-03-20,21,0,3,3,0,27
536,2015-03-21,13,0,2,8,0,23
537,2015-03-22,21,0,1,5,0,27
538,2015-03-23,20,0,1,6,0,27
539,2015-03-24,31,0,1,6,0,38
540,2015-03-25,29,0,1,2,0,32
541,2015-03-26,22,0,2,4,0,28
542,2015-03-27,15,0,3,3,0,21
543,2015-03-28,18,0,4,3,0,25
544,2015-03-29,24,0,1,7,0,32
545,2015-03-30,18,1,7,4,0,30
546,2015-03-31,14,0,1,2,0,17
547,2015-04-01,14,1,3,3,0,21
548,2015-04-02,15,1,3,34,0,53
549,2015-04-03,16,0,7,10,0,33
550,2015-04-04,26,1,2,3,0,32
551,2015-04-05,12,0,1,7,0,20
552,2015-04-06,18,0,1,4,0,23
553,2015-04-07,17,0,3,6,0,26
554,2015-04-08,20,0,7,4,0,31
555,2015-04-09,21,0,1,3,0,25
556,2015-04-10,27,0,1,6,0,34
557,2015-04-11,23,0,1,5,0,29
558,2015-04-12,16,0,7,8,0,31
559,2015-04-13,23,0,4,4,0,31
560,2015-04-14,15,0,4,6,0,25
561,2015-04-15,15,1,1,4,0,21
562,2015-04-16,20,0,4,7,0,31
563,2015-04-17,19,0,6,12,0,37
564,2015-04-18,21,0,3,5,0,29
565,2015-04-19,12,0,5,6,0,23
566,2015-04-20,28,3,1,5,0,37
567,2015-04-21,22,0,3,5,0,30
568,2015-04-22,27,0,1,5,0,33
569,2015-04-23,14,0,1,9,0,24
570,2015-04-24,28,0,5,15,0,48
571,2015-04-25,18,0,1,3,0,22
572,2015-04-26,19,0,3,5,0,27
573,2015-04-27,20,0,1,4,0,25
574,2015-04-28,28,0,7,2,0,37
575,2015-04-29,23,0,5,8,0,36
576,2015-04-30,16,0,2,7,0,25
577,2015-05-01,24,0,2,4,0,30
578,2015-05-02,21,0,7,0,0,28
579,2015-05-03,10,0,3,7,0,20
580,2015-05-04,24,0,1,10,0,35
581,2015-05-05,14,0,2,5,0,21
582,2015-05-06,30,0,2,2,0,34
583,2015-05-07,21,0,3,5,0,29
584,2015-05-08,18,0,1,4,0,23
585,2015-05-09,23,0,3,6,0,32
586,2015-05-10,18,0,1,5,0,24
587,2015-05-11,27,0,0,4,0,31
588,2015-05-12,25,0,2,6,0,33
589,2015-05-13,18,0,2,5,0,25
590,2015-05-14,31,1,4,7,0,43
591,2015-05-15,26,0,3,4,0,33
592,2015-05-16,27,0,3,11,0,41
593,2015-05-17,28,0,2,6,0,36
594,2015-05-18,32,0,1,6,0,39
595,2015-05-19,21,0,2,12,0,35
596,2015-05-20,20,0,4,6,0,30
597,2015-05-21,26,0,1,1,0,28
598,2015-05-22,29,0,0,5,0,34
599,2015-05-23,27,0,4,5,0,36
600,2015-05-24,31,0,4,3,0,38
601,2015-05-25,23,0,3,3,0,29
602,2015-05-26,14,0,3,0,0,17
603,2015-05-27,32,0,5,9,0,46
604,2015-05-28,38,0,2,4,0,44
605,2015-05-29,20,0,10,7,0,37
606,2015-05-30,24,0,2,3,0,29
607,2015-05-31,17,0,2,9,0,28
608,2015-06-01,28,1,6,7,0,42
609,2015-06-02,28,0,7,5,0,40
610,2015-06-03,35,0,1,10,0,46
611,2015-06-04,15,0,3,14,0,32
612,2015-06-05,34,0,2,6,0,42
613,2015-06-06,25,0,2,6,0,33
614,2015-06-07,26,1,1,5,0,33
615,2015-06-08,19,0,1,8,0,28
616,2015-06-09,16,0,3,6,0,25
617,2015-06-10,8,0,3,6,0,17
618,2015-06-11,20,0,5,3,0,28
619,2015-06-12,20,1,8,0,0,29
620,2015-06-13,19,0,8,9,0,36
621,2015-06-14,26,0,3,3,0,32
622,2015-06-15,16,0,6,9,0,31
623,2015-06-16,21,0,5,2,0,28
624,2015-06-17,19,0,4,4,0,27
625,2015-06-18,28,0,5,3,0,36
626,2015-06-19,28,0,2,11,0,41
627,2015-06-20,28,0,1,4,0,33
628,2015-06-21,32,0,1,5,0,38
629,2015-06-22,24,0,7,10,0,41
630,2015-06-23,26,0,2,6,0,34
631,2015-06-24,14,0,3,3,0,20
632,2015-06-25,21,0,3,2,0,26
633,2015-06-26,24,1,10,5,0,40
634,2015-06-27,27,0,0,9,0,36
635,2015-06-28,32,0,2,8,0,42
636,2015-06-29,31,1,1,4,0,37
637,2015-06-30,25,0,2,14,0,41
638,2015-07-01,15,0,1,2,0,18
639,2015-07-02,23,1,0,3,0,27
640,2015-07-03,13,0,0,4,0,17
641,2015-07-04,29,0,2,0,0,31
642,2015-07-05,24,0,5,2,0,31
643,2015-07-06,30,0,3,2,0,35
644,2015-07-07,20,0,3,8,0,31
645,2015-07-08,23,0,2,5,0,30
646,2015-07-09,19,2,5,5,0,31
647,2015-07-10,14,0,6,5,0,25
648,2015-07-11,36,0,3,1,0,40
649,2015-07-12,23,0,1,2,0,26
650,2015-07-13,20,0,2,3,0,25
651,2015-07-14,16,0,1,4,0,21
652,2015-07-15,21,1,4,3,0,29
653,2015-07-16,4,0,3,7,0,14
654,2015-07-17,21,0,2,5,0,28
655,2015-07-18,19,0,2,3,0,24
656,2015-07-19,15,0,3,2,0,20
657,2015-07-20,24,0,6,5,0,35
658,2015-07-21,14,1,2,5,0,22
659,2015-07-22,11,0,1,3,0,15
660,2015-07-23,14,0,2,11,0,27
661,2015-07-24,11,0,4,3,0,18
662,2015-07-25,13,0,0,2,0,15
663,2015-07-26,13,0,3,4,0,20
664,2015-07-27,29,1,1,5,0,36
665,2015-07-28,18,1,3,4,0,26
666,2015-07-29,28,1,5,2,0,36
667,2015-07-30,12,0,6,5,0,23
668,2015-07-31,14,0,2,3,0,19
669,2015-08-01,29,0,2,6,0,37
670,2015-08-02,12,1,0,3,0,16
671,2015-08-03,19,1,1,5,0,26
672,2015-08-04,31,1,0,4,0,36
673,2015-08-05,23,0,3,9,0,35
674,2015-08-06,16,0,3,3,0,22
675,2015-08-07,12,0,0,6,0,18
676,2015-08-08,18,1,3,5,0,27
677,2015-08-09,15,0,1,4,0,20
678,2015-08-10,18,0,1,7,0,26
679,2015-08-11,17,1,1,3,0,22
680,2015-08-12,15,1,4,4,0,24
681,2015-08-13,15,1,3,8,0,27
682,2015-08-14,19,0,6,3,0,28
683,2015-08-15,22,0,3,4,0,29
684,2015-08-16,28,0,0,4,0,32
685,2015-08-17,17,0,0,6,0,23
686,2015-08-18,9,0,4,4,0,17
687,2015-08-19,20,0,3,4,0,27
688,2015-08-20,25,0,2,5,0,32
689,2015-08-21,14,0,2,3,0,19
690,2015-08-22,36,0,1,7,0,44
691,2015-08-23,22,0,2,6,0,30
692,2015-08-24,21,0,0,4,0,25
693,2015-08-25,22,0,2,6,0,30
694,2015-08-26,19,0,1,5,0,25
695,2015-08-27,21,0,5,4,0,30
696,2015-08-28,12,0,3,2,0,17
697,2015-08-29,19,0,4,2,0,25
698,2015-08-30,17,0,6,3,0,26
699,2015-08-31,13,0,3,5,0,21
700,2015-09-01,12,0,4,9,0,25
701,2015-09-02,24,0,1,1,0,26
702,2015-09-03,13,0,3,7,0,23
703,2015-09-04,25,0,1,4,0,30
704,2015-09-05,19,0,1,4,0,24
705,2015-09-06,22,0,1,7,0,30
706,2015-09-07,25,0,2,6,0,33
707,2015-09-08,15,0,11,5,0,31
708,2015-09-09,22,1,2,3,0,28
709,2015-09-10,13,0,0,7,0,20
710,2015-09-11,21,0,4,8,0,33
711,2015-09-12,40,0,0,8,0,48
712,2015-09-13,21,0,1,4,0,26
713,2015-09-14,24,0,1,4,0,29
714,2015-09-15,13,0,3,7,0,23
715,2015-09-16,26,0,2,6,0,34
716,2015-09-17,12,0,2,4,0,18
717,2015-09-18,18,0,3,2,0,23
718,2015-09-19,21,0,2,9,0,32
719,2015-09-20,8,0,0,8,0,16
720,2015-09-21,16,0,3,7,0,26
721,2015-09-22,10,1,3,0,0,14
722,2015-09-23,10,0,3,9,0,22
723,2015-09-24,12,0,0,4,0,16
724,2015-09-25,14,0,2,3,0,19
725,2015-09-26,32,0,0,7,0,39
726,2015-09-27,14,0,0,2,0,16
727,2015-09-28,19,0,1,4,0,24
728,2015-09-29,15,0,1,4,0,20
729,2015-09-30,24,0,2,10,0,36
730,2015-10-01,16,0,3,2,0,21
731,2015-10-02,22,0,2,2,0,26
732,2015-10-03,25,1,1,9,0,36
733,2015-10-04,16,1,2,3,0,22
734,2015-10-05,22,0,2,3,0,27
735,2015-10-06,29,0,4,7,0,40
736,2015-10-07,23,0,2,7,0,32
737,2015-10-08,22,0,3,6,0,31
738,2015-10-09,12,0,6,4,0,22
739,2015-10-10,12,0,0,1,0,13
740,2015-10-11,21,0,3,10,0,34
741,2015-10-12,15,0,1,2,0,18
742,2015-10-13,14,0,2,4,0,20
743,2015-10-14,16,0,3,4,0,23
744,2015-10-15,18,0,0,7,0,25
745,2015-10-16,14,0,4,5,0,23
746,2015-10-17,14,1,1,5,0,21
747,2015-10-18,17,0,1,9,0,27
748,2015-10-19,25,0,0,5,0,30
749,2015-10-20,14,0,0,3,0,17
750,2015-10-21,11,0,3,4,0,18
751,2015-10-22,13,0,1,7,0,21
752,2015-10-23,17,0,4,5,0,26
753,2015-10-24,26,0,1,0,0,27
754,2015-10-25,27,1,3,5,0,36
755,2015-10-26,31,1,4,2,0,38
756,2015-10-27,22,0,1,11,0,34
757,2015-10-28,18,0,1,4,0,23
758,2015-10-29,18,0,1,14,0,33
759,2015-10-30,25,0,21,1,0,47
760,2015-10-31,35,0,4,3,0,42
761,2015-11-01,29,0,0,5,0,34
762,2015-11-02,23,0,2,10,0,35
763,2015-11-03,34,0,4,3,0,41
764,2015-11-04,25,0,2,9,0,36
765,2015-11-05,23,0,4,3,0,30
766,2015-11-06,31,0,4,4,0,39
767,2015-11-07,16,0,0,6,0,22
768,2015-11-08,22,0,1,3,0,26
769,2015-11-09,21,2,1,2,0,26
770,2015-11-10,19,0,3,2,0,24
771,2015-11-11,25,0,4,5,0,34
772,2015-11-12,27,0,4,4,0,35
773,2015-11-13,20,0,3,5,0,28
774,2015-11-14,19,0,3,3,0,25
775,2015-11-15,28,0,3,3,0,34
776,2015-11-16,15,0,1,7,0,23
777,2015-11-17,22,0,0,4,0,26
778,2015-11-18,35,0,1,2,0,38
779,2015-11-19,20,0,0,4,0,24
780,2015-11-20,18,0,2,6,0,26
781,2015-11-21,24,0,0,7,0,31
782,2015-11-22,19,0,1,5,0,25
783,2015-11-23,12,0,3,7,0,22
784,2015-11-24,24,0,4,1,0,29
785,2015-11-25,24,0,9,2,0,35
786,2015-11-26,7,0,0,0,0,7
787,2015-11-27,27,0,2,6,0,35
788,2015-11-28,24,0,1,1,0,26
789,2015-11-29,18,0,0,5,0,23
790,2015-11-30,19,0,3,4,0,26
791,2015-12-01,34,1,0,1,0,36
792,2015-12-02,23,1,1,5,0,30
793,2015-12-03,23,2,2,7,0,34
794,2015-12-04,5,0,1,9,0,15
795,2015-12-05,12,0,1,6,0,19
796,2015-12-06,15,0,0,4,0,19
797,2015-12-07,29,0,2,11,0,42
798,2015-12-08,17,0,0,3,0,20
799,2015-12-09,26,0,3,3,0,32
800,2015-12-10,13,0,10,2,0,25
801,2015-12-11,22,1,1,3,0,27
802,2015-12-12,17,0,2,1,0,20
803,2015-12-13,17,0,0,3,0,20
804,2015-12-14,10,0,4,8,0,22
805,2015-12-15,17,0,1,3,0,21
806,2015-12-16,37,0,2,3,0,42
807,2015-12-17,31,1,1,6,0,39
808,2015-12-18,14,0,1,5,0,20
809,2015-12-19,17,0,1,5,0,23
810,2015-12-20,23,0,1,4,0,28
811,2015-12-21,22,0,2,9,0,33
812,2015-12-22,13,1,0,2,0,16
813,2015-12-23,14,0,1,4,0,19
814,2015-12-24,8,0,1,0,0,9
815,2015-12-25,8,0,2,1,0,11
816,2015-12-26,35,0,3,4,0,42
817,2015-12-27,13,0,2,2,0,17
818,2015-12-28,21,0,2,0,0,23
819,2015-12-29,17,0,2,7,0,26
820,2015-12-30,14,0,2,3,0,19
821,2015-12-31,19,0,4,4,0,27
822,2016-01-01,31,0,3,0,0,34
823,2016-01-02,31,0,2,8,0,41
824,2016-01-03,14,0,1,5,0,20
825,2016-01-04,22,0,2,3,0,27
826,2016-01-05,13,0,2,4,0,19
827,2016-01-06,23,0,2,4,0,29
828,2016-01-07,19,0,0,3,0,22
829,2016-01-08,21,0,3,3,0,27
830,2016-01-09,16,0,2,4,0,22
831,2016-01-10,29,0,0,5,0,34
832,2016-01-11,20,1,2,9,0,32
833,2016-01-12,15,0,1,4,0,20
834,2016-01-13,29,0,4,5,0,38
835,2016-01-14,14,1,2,6,0,23
836,2016-01-15,20,0,4,4,0,28
837,2016-01-16,41,1,1,4,0,47
838,2016-01-17,20,0,2,5,0,27
839,2016-01-18,19,0,4,3,0,26
840,2016-01-19,11,0,2,13,0,26
841,2016-01-20,18,0,1,5,0,24
842,2016-01-21,15,0,5,5,0,25
843,2016-01-22,21,1,1,8,0,31
844,2016-01-23,21,0,2,3,0,26
845,2016-01-24,16,0,3,2,0,21
846,2016-01-25,13,0,1,7,0,21
847,2016-01-26,18,0,0,0,0,18
848,2016-01-27,25,0,1,8,0,34
849,2016-01-28,20,0,9,1,0,30
850,2016-01-29,12,0,4,2,0,18
851,2016-01-30,25,0,0,6,0,31
852,2016-01-31,16,1,6,3,0,26
853,2016-02-01,13,0,4,5,0,22
854,2016-02-02,12,0,15,2,0,29
855,2016-02-03,30,0,0,3,0,33
856,2016-02-04,12,0,1,9,0,22
857,2016-02-05,11,0,4,9,0,24
858,2016-02-06,10,0,3,4,0,17
859,2016-02-07,13,0,2,7,0,22
860,2016-02-08,8,0,1,4,0,13
861,2016-02-09,16,0,7,8,0,31
862,2016-02-10,16,0,1,10,0,27
863,2016-02-11,18,0,2,10,0,30
864,2016-02-12,16,0,2,7,0,25
865,2016-02-13,33,0,2,3,0,38
866,2016-02-14,13,0,1,1,0,15
867,2016-02-15,22,0,1,9,0,32
868,2016-02-16,17,0,2,6,0,25
869,2016-02-17,13,0,1,2,0,16
870,2016-02-18,20,0,0,14,0,34
871,2016-02-19,22,0,1,5,0,28
872,2016-02-20,37,1,2,6,0,46
873,2016-02-21,13,0,0,7,0,20
874,2016-02-22,17,0,3,8,0,28
875,2016-02-23,26,0,4,4,0,34
876,2016-02-24,21,0,3,19,0,43
877,2016-02-25,23,0,1,9,0,33
878,2016-02-26,28,0,4,12,0,44
879,2016-02-27,18,0,0,8,0,26
880,2016-02-28,24,0,0,10,0,34
881,2016-02-29,11,0,2,6,0,19
882,2016-03-01,27,0,0,6,0,33
883,2016-03-02,28,2,4,5,0,39
884,2016-03-03,12,0,1,6,0,19
885,2016-03-04,19,0,0,1,0,20
886,2016-03-05,19,0,6,3,0,28
887,2016-03-06,10,0,5,14,0,29
888,2016-03-07,17,0,0,3,0,20
889,2016-03-08,22,0,6,9,0,37
890,2016-03-09,22,0,2,1,0,25
891,2016-03-10,30,0,3,4,0,37
892,2016-03-11,20,0,3,7,0,30
893,2016-03-12,26,0,2,8,0,36
894,2016-03-13,17,0,1,3,0,21
895,2016-03-14,23,0,3,5,0,31
896,2016-03-15,12,0,3,2,0,17
897,2016-03-16,17,0,5,6,0,28
898,2016-03-17,21,0,0,4,0,25
899,2016-03-18,18,0,2,13,0,33
900,2016-03-19,18,0,5,5,0,28
901,2016-03-20,18,0,1,9,0,28
902,2016-03-21,12,0,5,8,0,25
903,2016-03-22,16,0,5,6,0,27
904,2016-03-23,14,0,6,8,0,28
905,2016-03-24,20,0,1,13,0,34
906,2016-03-25,15,0,3,8,0,26
907,2016-03-26,15,0,2,7,0,24
908,2016-03-27,17,0,5,4,0,26
909,2016-03-28,23,0,3,7,0,33
910,2016-03-29,17,0,1,7,0,25
911,2016-03-30,21,0,2,5,0,28
912,2016-03-31,17,0,3,3,0,23
913,2016-04-01,18,0,0,1,0,19
914,2016-04-02,19,0,3,4,0,26
915,2016-04-03,21,0,2,5,0,28
916,2016-04-04,16,0,0,5,0,21
917,2016-04-05,19,0,4,3,0,26
918,2016-04-06,12,0,1,0,0,13
919,2016-04-07,9,0,1,11,0,21
920,2016-04-08,14,0,5,6,0,25
921,2016-04-09,25,0,2,6,0,33
922,2016-04-10,13,1,3,4,0,21
923,2016-04-11,24,0,3,8,0,35
924,2016-04-12,21,1,0,5,0,27
925,2016-04-13,17,0,2,6,0,25
926,2016-04-14,17,0,2,5,0,24
927,2016-04-15,24,0,8,5,0,37
928,2016-04-16,21,0,1,9,0,31
929,2016-04-17,13,0,5,2,0,20
930,2016-04-18,19,0,2,5,0,26
931,2016-04-19,18,0,4,8,0,30
932,2016-04-20,28,0,0,5,0,33
933,2016-04-21,13,0,3,10,0,26
934,2016-04-22,41,0,1,4,0,46
935,2016-04-23,20,0,2,5,0,27
936,2016-04-24,12,0,4,6,0,22
937,2016-04-25,16,0,2,7,0,25
938,2016-04-26,16,0,1,5,0,22
939,2016-04-27,16,0,1,4,0,21
940,2016-04-28,22,0,6,3,0,31
941,2016-04-29,19,0,3,5,0,27
942,2016-04-30,36,0,1,6,0,43
943,2016-05-01,17,0,1,9,0,27
944,2016-05-02,25,0,4,6,0,35
945,2016-05-03,20,0,2,7,0,29
946,2016-05-04,20,0,3,8,0,31
947,2016-05-05,18,0,5,2,0,25
948,2016-05-06,21,0,1,3,0,25
949,2016-05-07,19,0,1,8,0,28
950,2016-05-08,19,0,2,1,0,22
951,2016-05-09,27,0,0,7,0,34
952,2016-05-10,24,1,3,4,0,32
953,2016-05-11,39,0,1,9,0,49
954,2016-05-12,43,0,5,3,0,51
955,2016-05-13,24,0,3,6,0,33
956,2016-05-14,32,0,2,6,0,40
957,2016-05-15,26,0,3,2,0,31
958,2016-05-16,24,0,0,5,0,29
959,2016-05-17,40,0,2,11,0,53
960,2016-05-18,29,0,5,8,0,42
961,2016-05-19,19,0,4,3,0,26
962,2016-05-20,21,0,3,11,0,35
963,2016-05-21,40,0,1,5,0,46
964,2016-05-22,20,0,2,6,0,28
965,2016-05-23,36,0,0,10,0,46
966,2016-05-24,17,0,3,2,0,22
967,2016-05-25,29,1,6,11,0,47
968,2016-05-26,27,0,2,11,0,40
969,2016-05-27,11,0,2,0,0,13
970,2016-05-28,14,0,1,1,0,16
971,2016-05-29,14,0,1,2,0,17
972,2016-05-30,26,0,3,6,0,35
973,2016-05-31,28,0,1,4,0,33
974,2016-06-01,62,0,1,6,0,69
975,2016-06-02,15,0,1,22,0,38
976,2016-06-03,17,0,1,6,0,24
977,2016-06-04,11,0,1,3,0,15
978,2016-06-05,28,0,0,6,0,34
979,2016-06-06,36,0,0,5,0,41
980,2016-06-07,24,0,3,5,0,32
981,2016-06-08,29,0,2,1,0,32
982,2016-06-09,17,0,1,6,0,24
983,2016-06-10,14,0,5,3,0,22
984,2016-06-11,11,0,1,8,0,20
985,2016-06-12,11,0,2,7,0,20
986,2016-06-13,13,0,5,7,0,25
987,2016-06-14,22,0,9,13,0,44
988,2016-06-15,19,0,7,2,0,28
989,2016-06-16,11,0,2,7,0,20
990,2016-06-17,11,0,3,3,0,17
991,2016-06-18,16,0,1,9,0,26
992,2016-06-19,21,0,2,4,0,27
993,2016-06-20,25,0,4,0,0,29
994,2016-06-21,16,0,1,7,0,24
995,2016-06-22,20,0,0,6,0,26
996,2016-06-23,15,0,3,2,0,20
997,2016-06-24,20,0,6,5,0,31
998,2016-06-25,21,0,4,7,0,32
999,2016-06-26,17,0,2,6,0,25
1000,2016-06-27,26,0,1,4,0,31
1001,2016-06-28,21,0,3,4,0,28
1002,2016-06-29,19,0,0,3,0,22
1003,2016-06-30,22,0,2,4,0,28
1004,2016-07-01,26,0,2,3,0,31
1005,2016-07-02,18,0,2,2,0,22
1006,2016-07-03,20,0,1,0,0,21
1007,2016-07-04,11,0,1,2,0,14
1008,2016-07-05,27,0,4,3,0,34
1009,2016-07-06,22,0,1,3,0,26
1010,2016-07-07,23,0,6,2,0,31
1011,2016-07-08,14,0,1,3,0,18
1012,2016-07-09,20,0,0,2,0,22
1013,2016-07-10,20,0,2,5,0,27
1014,2016-07-11,18,0,2,5,0,25
1015,2016-07-12,16,0,0,3,0,19
1016,2016-07-13,15,0,6,4,0,25
1017,2016-07-14,17,0,2,7,0,26
1018,2016-07-15,15,0,3,12,0,30
1019,2016-07-16,17,0,5,6,0,28
1020,2016-07-17,17,0,0,5,0,22
1021,2016-07-18,8,0,0,2,0,10
1022,2016-07-19,17,0,1,4,0,22
1023,2016-07-20,16,0,2,2,0,20
1024,2016-07-21,17,0,0,6,0,23
1025,2016-07-22,19,0,0,5,0,24
1026,2016-07-23,32,0,0,7,0,39
1027,2016-07-24,12,0,1,8,0,21
1028,2016-07-25,12,0,2,6,0,20
1029,2016-07-26,22,0,4,2,0,28
1030,2016-07-27,31,0,5,3,0,39
1031,2016-07-28,23,0,4,6,0,33
1032,2016-07-29,16,0,0,4,0,20
1033,2016-07-30,13,0,1,4,0,18
1034,2016-07-31,19,0,5,3,0,27
1035,2016-08-01,15,0,1,4,0,20
1036,2016-08-02,12,0,2,1,0,15
1037,2016-08-03,18,0,2,6,0,26
1038,2016-08-04,20,0,4,5,0,29
1039,2016-08-05,11,0,2,8,0,21
1040,2016-08-06,22,0,1,5,0,28
1041,2016-08-07,14,0,3,9,0,26
1042,2016-08-08,21,0,2,6,0,29
1043,2016-08-09,22,0,2,7,0,31
1044,2016-08-10,18,0,4,6,0,28
1045,2016-08-11,19,0,6,3,0,28
1046,2016-08-12,12,0,2,5,0,19
1047,2016-08-13,18,0,0,2,0,20
1048,2016-08-14,18,0,0,4,0,22
1049,2016-08-15,41,0,3,4,0,48
1050,2016-08-16,21,0,2,6,0,29
1051,2016-08-17,21,0,7,1,0,29
1052,2016-08-18,20,0,2,4,0,26
1053,2016-08-19,19,0,3,5,0,27
1054,2016-08-20,27,0,1,5,0,33
1055,2016-08-21,18,0,1,14,0,33
1056,2016-08-22,22,0,3,3,0,28
1057,2016-08-23,13,0,3,4,0,20
1058,2016-08-24,19,0,1,2,0,22
1059,2016-08-25,19,0,1,4,0,24
1060,2016-08-26,22,0,2,5,0,29
1061,2016-08-27,21,0,3,2,0,26
1062,2016-08-28,21,0,2,5,0,28
1063,2016-08-29,15,0,4,2,0,21
1064,2016-08-30,17,0,1,2,0,20
1065,2016-08-31,15,0,0,2,0,17
1066,2016-09-01,19,0,1,5,0,25
1067,2016-09-02,17,0,4,8,0,29
1068,2016-09-03,21,0,5,18,0,44
1069,2016-09-04,11,0,6,5,0,22
1070,2016-09-05,25,0,0,5,0,30
1071,2016-09-06,23,0,1,15,0,39
1072,2016-09-07,13,0,0,5,0,18
1073,2016-09-08,23,0,3,4,0,30
1074,2016-09-09,12,0,3,5,0,20
1075,2016-09-10,26,0,3,4,0,33
1076,2016-09-11,17,0,2,9,0,28
1077,2016-09-12,13,0,3,3,0,19
1078,2016-09-13,13,1,4,5,0,23
1079,2016-09-14,18,0,3,4,0,25
1080,2016-09-15,22,0,1,4,0,27
1081,2016-09-16,15,0,1,3,0,19
1082,2016-09-17,29,0,2,4,0,35
1083,2016-09-18,8,0,0,7,0,15
1084,2016-09-19,25,0,2,5,0,32
1085,2016-09-20,13,0,1,8,0,22
1086,2016-09-21,19,0,3,6,0,28
1087,2016-09-22,18,0,3,3,0,24
1088,2016-09-23,12,0,2,6,0,20
1089,2016-09-24,17,0,1,3,0,21
1090,2016-09-25,31,0,3,6,0,40
1091,2016-09-26,23,0,1,4,0,28
1092,2016-09-27,22,0,1,1,0,24
1093,2016-09-28,25,0,4,3,0,32
1094,2016-09-29,14,0,0,7,0,21
1095,2016-09-30,14,0,2,3,0,19
1096,2016-10-01,27,0,4,4,0,35
1097,2016-10-02,20,0,2,3,0,25
1098,2016-10-03,33,0,0,4,0,37
1099,2016-10-04,5,0,10,4,0,19
1100,2016-10-05,10,0,2,2,0,14
1101,2016-10-06,5,0,2,1,0,8
1102,2016-10-07,11,0,2,4,0,17
1103,2016-10-08,33,0,2,1,0,36
1104,2016-10-09,21,0,1,5,0,27
1105,2016-10-10,21,0,3,4,0,28
1106,2016-10-11,15,0,2,6,0,23
1107,2016-10-12,16,0,4,5,0,25
1108,2016-10-13,21,0,2,2,0,25
1109,2016-10-14,12,0,3,9,0,24
1110,2016-10-15,20,0,3,3,0,26
1111,2016-10-16,27,0,1,8,0,36
1112,2016-10-17,17,0,1,7,0,25
1113,2016-10-18,7,0,3,13,0,23
1114,2016-10-19,18,0,4,2,0,24
1115,2016-10-20,14,0,1,5,0,20
1116,2016-10-21,23,0,7,13,0,43
1117,2016-10-22,23,0,3,5,0,31
1118,2016-10-23,18,0,0,4,0,22
1119,2016-10-24,9,0,1,10,0,20
1120,2016-10-25,15,0,3,1,0,19
1121,2016-10-26,17,0,3,4,0,24
1122,2016-10-27,9,0,1,4,0,14
1123,2016-10-28,11,0,1,5,0,17
1124,2016-10-29,9,0,1,6,0,16
1125,2016-10-30,6,0,1,3,0,10
1126,2016-10-31,21,0,0,6,0,27
1127,2016-11-01,18,0,2,5,0,25
1128,2016-11-02,26,0,5,1,0,32
1129,2016-11-03,16,0,3,1,0,20
1130,2016-11-04,36,0,2,7,0,45
1131,2016-11-05,17,0,3,8,0,28
1132,2016-11-06,20,0,2,7,0,29
1133,2016-11-07,22,0,4,1,0,27
1134,2016-11-08,23,0,3,4,0,30
1135,2016-11-09,23,0,3,1,0,27
1136,2016-11-10,35,0,2,8,0,45
1137,2016-11-11,20,0,0,5,0,25
1138,2016-11-12,15,0,2,5,0,22
1139,2016-11-13,21,0,0,4,0,25
1140,2016-11-14,21,0,4,3,0,28
1141,2016-11-15,16,0,7,6,0,29
1142,2016-11-16,15,0,1,6,0,22
1143,2016-11-17,24,0,0,4,0,28
1144,2016-11-18,13,0,6,2,0,21
1145,2016-11-19,19,0,2,9,0,30
1146,2016-11-20,24,0,0,3,0,27
1147,2016-11-21,20,0,0,3,0,23
1148,2016-11-22,15,0,1,5,0,21
1149,2016-11-23,15,0,6,2,0,23
1150,2016-11-24,0,0,1,2,0,3
1151,2016-11-25,19,0,2,3,0,24
1152,2016-11-26,24,0,5,9,0,38
1153,2016-11-27,25,0,4,6,0,35
1154,2016-11-28,22,0,0,8,0,30
1155,2016-11-29,16,0,7,2,0,25
1156,2016-11-30,21,0,3,4,0,28
1157,2016-12-01,12,0,1,8,0,21
1158,2016-12-02,16,1,2,1,0,20
1159,2016-12-03,31,0,2,4,0,37
1160,2016-12-04,20,0,2,1,0,23
1161,2016-12-05,19,1,4,13,0,37
1162,2016-12-06,19,0,2,8,0,29
1163,2016-12-07,23,0,6,8,0,37
1164,2016-12-08,26,0,2,6,0,34
1165,2016-12-09,25,0,1,12,0,38
1166,2016-12-10,20,0,1,4,0,25
1167,2016-12-11,17,0,0,8,0,25
1168,2016-12-12,13,0,0,5,0,18
1169,2016-12-13,11,0,2,4,0,17
1170,2016-12-14,16,0,1,4,0,21
1171,2016-12-15,16,0,3,6,0,25
1172,2016-12-16,26,0,1,6,0,33
1173,2016-12-17,21,0,1,8,0,30
1174,2016-12-18,12,0,2,10,0,24
1175,2016-12-19,28,0,1,9,0,38
1176,2016-12-20,10,0,2,4,0,16
1177,2016-12-21,13,0,2,3,0,18
1178,2016-12-22,9,0,2,6,0,17
1179,2016-12-23,13,0,6,3,0,22
1180,2016-12-24,8,0,3,2,0,13
1181,2016-12-25,3,0,0,0,0,3
1182,2016-12-26,44,0,1,2,0,47
1183,2016-12-27,12,0,1,8,0,21
1184,2016-12-28,28,0,2,1,0,31
1185,2016-12-29,27,0,5,3,0,35
1186,2016-12-30,16,0,15,4,0,35
1187,2016-12-31,18,0,1,4,0,23
1188,2017-01-01,19,0,3,1,0,23
1189,2017-01-02,34,0,2,2,0,38
1190,2017-01-03,33,0,7,3,0,43
1191,2017-01-04,15,0,0,0,0,15
1192,2017-01-05,18,0,0,2,0,20
1193,2017-01-06,15,0,1,3,0,19
1194,2017-01-07,15,0,1,4,0,20
1195,2017-01-08,22,0,1,5,0,28
1196,2017-01-09,18,0,1,4,0,23
1197,2017-01-10,16,0,3,3,0,22
1198,2017-01-11,15,0,0,4,0,19
1199,2017-01-12,17,0,2,11,0,30
1200,2017-01-13,15,0,1,3,0,19
1201,2017-01-14,25,0,1,7,0,33
1202,2017-01-15,15,0,3,6,0,24
1203,2017-01-16,21,0,1,3,0,25
1204,2017-01-17,10,0,3,6,0,19
1205,2017-01-18,22,0,1,8,0,31
1206,2017-01-19,17,0,2,4,0,23
1207,2017-01-20,23,0,0,1,0,24
1208,2017-01-21,29,0,3,10,0,42
1209,2017-01-22,32,0,1,5,0,38
1210,2017-01-23,21,0,0,5,0,26
1211,2017-01-24,13,0,0,10,0,23
1212,2017-01-25,24,0,2,8,0,34
1213,2017-01-26,19,0,1,6,0,26
1214,2017-01-27,16,0,1,17,0,34
1215,2017-01-28,12,0,1,13,0,26
1216,2017-01-29,13,0,2,10,0,25
1217,2017-01-30,18,0,1,11,0,30
1218,2017-01-31,15,0,1,7,0,23
1219,2017-02-01,12,0,6,2,0,20
1220,2017-02-02,17,0,4,10,0,31
1221,2017-02-03,29,0,0,6,0,35
1222,2017-02-04,24,0,1,10,0,35
1223,2017-02-05,19,0,0,9,0,28
1224,2017-02-06,19,0,6,7,0,32
1225,2017-02-07,13,0,2,17,0,32
1226,2017-02-08,16,0,8,5,0,29
1227,2017-02-09,17,0,0,7,0,24
1228,2017-02-10,29,0,5,9,0,43
1229,2017-02-11,13,0,0,17,0,30
1230,2017-02-12,16,0,2,21,0,39
1231,2017-02-13,16,0,1,20,0,37
1232,2017-02-14,18,0,1,10,0,29
1233,2017-02-15,20,0,1,9,0,30
1234,2017-02-16,15,0,3,16,0,34
1235,2017-02-17,13,0,0,9,0,22
1236,2017-02-18,16,0,2,15,0,33
1237,2017-02-19,14,0,1,4,0,19
1238,2017-02-20,20,1,2,9,0,32
1239,2017-02-21,18,0,0,5,0,23
1240,2017-02-22,20,0,0,9,0,29
1241,2017-02-23,26,1,4,9,0,40
1242,2017-02-24,14,0,4,3,0,21
1243,2017-02-25,24,0,5,4,0,33
1244,2017-02-26,19,0,1,4,0,24
1245,2017-02-27,24,0,8,6,0,38
1246,2017-02-28,20,0,4,7,0,31
1247,2017-03-01,18,0,4,4,0,26
1248,2017-03-02,28,0,4,3,0,35
1249,2017-03-03,23,0,2,2,0,27
1250,2017-03-04,14,0,2,4,0,20
1251,2017-03-05,16,0,2,3,0,21
1252,2017-03-06,15,0,8,3,0,26
1253,2017-03-07,16,0,7,2,0,25
1254,2017-03-08,17,0,4,2,0,23
1255,2017-03-09,29,0,1,4,0,34
1256,2017-03-10,24,0,0,6,0,30
1257,2017-03-11,16,0,1,5,0,22
1258,2017-03-12,21,0,1,6,0,28
1259,2017-03-13,29,0,2,7,0,38
1260,2017-03-14,22,0,5,7,0,34
1261,2017-03-15,20,0,5,5,0,30
1262,2017-03-16,20,0,0,8,0,28
1263,2017-03-17,18,0,5,6,0,29
1264,2017-03-18,8,0,2,12,0,22
1265,2017-03-19,7,0,1,1,0,9
1266,2017-03-20,15,0,1,5,0,21
1267,2017-03-21,20,0,2,5,0,27
1268,2017-03-22,19,0,3,1,0,23
1269,2017-03-23,15,0,2,5,0,22
1270,2017-03-24,15,0,2,10,0,27
1271,2017-03-25,25,0,1,9,0,35
1272,2017-03-26,18,0,1,4,0,23
1273,2017-03-27,22,0,0,12,0,34
1274,2017-03-28,21,0,2,6,0,29
1275,2017-03-29,28,0,1,7,0,36
1276,2017-03-30,13,0,4,2,0,19
1277,2017-03-31,19,0,4,4,0,27
1278,2017-04-01,14,0,4,5,0,23
1279,2017-04-02,11,0,0,3,0,14
1280,2017-04-03,29,0,3,3,0,35
1281,2017-04-04,21,0,4,5,0,30
1282,2017-04-05,22,0,9,10,0,41
1283,2017-04-06,10,0,1,7,0,18
1284,2017-04-07,14,0,1,4,0,19
1285,2017-04-08,29,0,1,4,0,34
1286,2017-04-09,11,0,3,6,0,20
1287,2017-04-10,17,0,1,9,0,27
1288,2017-04-11,27,0,3,6,0,36
1289,2017-04-12,22,0,2,16,0,40
1290,2017-04-13,15,0,1,6,0,22
1291,2017-04-14,17,0,0,3,0,20
1292,2017-04-15,16,0,2,4,0,22
1293,2017-04-16,8,0,0,7,0,15
1294,2017-04-17,19,0,4,5,0,28
1295,2017-04-18,19,0,5,10,0,34
1296,2017-04-19,15,0,3,3,0,21
1297,2017-04-20,17,0,1,7,0,25
1298,2017-04-21,16,0,2,8,0,26
1299,2017-04-22,25,0,1,3,0,29
1300,2017-04-23,15,0,1,2,0,18
1301,2017-04-24,14,0,5,4,0,23
1302,2017-04-25,25,0,4,5,0,34
1303,2017-04-26,16,0,2,2,0,20
1304,2017-04-27,25,0,3,6,0,34
1305,2017-04-28,13,0,3,10,0,26
1306,2017-04-29,24,0,3,5,0,32
1307,2017-04-30,18,0,0,6,0,24
1308,2017-05-01,23,0,5,12,0,40
1309,2017-05-02,14,0,5,6,0,25
1310,2017-05-03,26,0,11,5,0,42
1311,2017-05-04,16,0,5,5,0,26
1312,2017-05-05,22,0,2,4,0,28
1313,2017-05-06,11,0,2,4,0,17
1314,2017-05-07,11,0,1,11,0,23
1315,2017-05-08,11,0,1,8,0,20
1316,2017-05-09,17,0,1,7,0,25
1317,2017-05-10,16,0,1,7,0,24
1318,2017-05-11,26,0,5,9,0,40
1319,2017-05-12,21,0,1,7,0,29
1320,2017-05-13,16,0,1,6,0,23
1321,2017-05-14,23,0,1,7,0,31
1322,2017-05-15,23,0,1,5,0,29
1323,2017-05-16,13,0,1,9,0,23
1324,2017-05-17,34,0,2,3,0,39
1325,2017-05-18,28,0,3,6,0,37
1326,2017-05-19,29,0,4,5,0,38
1327,2017-05-20,15,0,1,7,0,23
1328,2017-05-21,28,1,1,6,0,36
1329,2017-05-22,13,0,0,2,0,15
1330,2017-05-23,17,0,1,7,0,25
1331,2017-05-24,25,0,0,5,0,30
1332,2017-05-25,13,0,2,5,0,20
1333,2017-05-26,22,0,1,4,0,27
1334,2017-05-27,17,0,5,6,0,28
1335,2017-05-28,17,0,2,6,0,25
1336,2017-05-29,17,1,5,11,0,34
1337,2017-05-30,23,0,1,10,0,34
1338,2017-05-31,24,0,6,13,0,43
1339,2017-06-01,27,0,3,6,0,36
1340,2017-06-02,22,0,0,6,0,28
1341,2017-06-03,18,0,0,9,0,27
1342,2017-06-04,28,0,1,6,0,35
1343,2017-06-05,21,0,3,12,0,36
1344,2017-06-06,27,0,0,2,0,29
1345,2017-06-07,17,0,4,9,0,30
1346,2017-06-08,22,0,2,5,0,29
1347,2017-06-09,18,0,4,7,0,29
1348,2017-06-10,13,0,5,11,0,29
1349,2017-06-11,16,0,3,4,0,23
1350,2017-06-12,11,0,0,7,0,18
1351,2017-06-13,7,0,4,6,0,17
1352,2017-06-14,11,0,4,5,0,20
1353,2017-06-15,19,0,2,7,0,28
1354,2017-06-16,15,0,1,5,0,21
1355,2017-06-17,16,0,2,5,0,23
1356,2017-06-18,15,0,1,0,0,16
1357,2017-06-19,27,0,2,10,0,39
1358,2017-06-20,22,0,3,1,0,26
1359,2017-06-21,40,0,5,5,0,50
1360,2017-06-22,26,0,5,5,0,36
1361,2017-06-23,8,0,2,5,0,15
1362,2017-06-24,11,0,3,1,0,15
1363,2017-06-25,15,0,4,6,0,25
1364,2017-06-26,9,0,2,6,0,17
1365,2017-06-27,31,0,3,9,0,43
1366,2017-06-28,22,0,5,5,0,32
1367,2017-06-29,20,0,3,7,0,30
1368,2017-06-30,14,0,3,2,0,19
1369,2017-07-01,14,0,1,0,0,15
1370,2017-07-02,18,0,3,0,0,21
1371,2017-07-03,20,0,2,16,0,38
1372,2017-07-04,15,0,4,4,0,23
1373,2017-07-05,27,0,4,3,0,34
1374,2017-07-06,26,0,3,6,0,35
1375,2017-07-07,16,0,2,7,0,25
1376,2017-07-08,23,0,0,3,0,26
1377,2017-07-09,38,0,0,7,0,45
1378,2017-07-10,21,0,4,7,0,32
1379,2017-07-11,19,0,2,4,0,25
1380,2017-07-12,16,0,0,7,0,23
1381,2017-07-13,19,0,5,7,0,31
1382,2017-07-14,32,0,1,6,0,39
1383,2017-07-15,17,0,3,7,0,27
1384,2017-07-16,21,0,2,4,0,27
1385,2017-07-17,20,0,1,8,0,29
1386,2017-07-18,18,0,2,6,0,26
1387,2017-07-19,20,0,6,4,0,30
1388,2017-07-20,16,0,2,5,0,23
1389,2017-07-21,26,0,0,5,0,31
1390,2017-07-22,20,0,3,6,0,29
1391,2017-07-23,13,0,0,2,0,15
1392,2017-07-24,16,0,1,3,0,20
1393,2017-07-25,24,0,2,1,0,27
1394,2017-07-26,22,0,1,11,0,34
1395,2017-07-27,8,0,2,7,0,17
1396,2017-07-28,14,0,2,1,0,17
1397,2017-07-29,24,0,1,7,0,32
1398,2017-07-30,17,0,0,3,0,20
1399,2017-07-31,20,0,0,4,0,24
1400,2017-08-01,24,0,4,2,0,30
1401,2017-08-02,23,0,3,5,0,31
1402,2017-08-03,30,0,2,10,0,42
1403,2017-08-04,14,0,3,8,0,25
1404,2017-08-05,10,0,5,3,0,18
1405,2017-08-06,22,0,1,2,0,25
1406,2017-08-07,13,0,3,5,0,21
1407,2017-08-08,16,0,2,6,0,24
1408,2017-08-09,10,0,3,6,0,19
1409,2017-08-10,21,0,1,7,0,29
1410,2017-08-11,15,0,15,6,0,36
1411,2017-08-12,17,0,1,3,0,21
1412,2017-08-13,12,0,0,3,0,15
1413,2017-08-14,29,0,3,2,0,34
1414,2017-08-15,17,0,1,11,0,29
1415,2017-08-16,12,0,0,8,0,20
1416,2017-08-17,14,0,3,9,0,26
1417,2017-08-18,18,0,0,7,0,25
1418,2017-08-19,16,0,4,11,0,31
1419,2017-08-20,15,0,0,8,0,23
1420,2017-08-21,15,0,0,9,0,24
1421,2017-08-22,11,0,4,9,0,24
1422,2017-08-23,15,0,2,5,0,22
1423,2017-08-24,18,0,1,10,0,29
1424,2017-08-25,15,0,1,4,0,20
1425,2017-08-26,14,0,6,4,0,24
1426,2017-08-27,19,0,0,3,0,22
1427,2017-08-28,35,0,1,4,0,40
1428,2017-08-29,23,0,6,9,0,38
1429,2017-08-30,20,0,3,4,0,27
1430,2017-08-31,23,0,4,3,0,30
1431,2017-09-01,14,0,65,4,0,83
1432,2017-09-02,25,0,14,1,0,40
1433,2017-09-03,22,0,40,4,0,66
1434,2017-09-04,13,0,42,5,0,60
1435,2017-09-05,20,0,6,6,0,32
1436,2017-09-06,22,0,8,3,0,33
1437,2017-09-07,21,0,7,2,0,30
1438,2017-09-08,13,0,2,10,0,25
1439,2017-09-09,11,0,2,6,0,19
1440,2017-09-10,14,0,6,4,0,24
1441,2017-09-11,12,0,22,7,0,41
1442,2017-09-12,14,0,2,8,0,24
1443,2017-09-13,25,0,7,10,0,42
1444,2017-09-14,12,0,2,3,0,17
1445,2017-09-15,14,0,4,3,0,21
1446,2017-09-16,11,0,3,5,0,19
1447,2017-09-17,11,0,4,7,0,22
1448,2017-09-18,15,0,5,4,0,24
1449,2017-09-19,18,0,5,8,0,31
1450,2017-09-20,17,0,2,9,0,28
1451,2017-09-21,17,0,1,7,0,25
1452,2017-09-22,13,0,1,3,0,17
1453,2017-09-23,25,0,5,5,0,35
1454,2017-09-24,11,0,1,5,0,17
1455,2017-09-25,17,0,2,14,0,33
1456,2017-09-26,18,0,0,8,0,26
1457,2017-09-27,23,0,2,5,0,30
1458,2017-09-28,17,0,3,5,0,25
1459,2017-09-29,18,0,5,3,0,26
1460,2017-09-30,22,0,4,2,0,28
1461,2017-10-01,25,0,1,7,0,33
1462,2017-10-02,30,0,4,16,0,50
1463,2017-10-03,25,0,0,5,0,30
1464,2017-10-04,21,0,2,3,0,26
1465,2017-10-05,15,0,4,2,0,21
1466,2017-10-06,15,0,4,3,0,22
1467,2017-10-07,28,0,0,3,0,31
1468,2017-10-08,16,0,4,3,0,23
1469,2017-10-09,21,0,0,8,0,29
1470,2017-10-10,22,0,0,5,0,27
1471,2017-10-11,32,0,3,6,0,41
1472,2017-10-12,16,0,2,3,0,21
1473,2017-10-13,21,1,3,9,0,34
1474,2017-10-14,16,0,4,0,0,20
1475,2017-10-15,26,0,3,1,0,30
1476,2017-10-16,21,0,0,7,0,28
1477,2017-10-17,16,0,1,2,0,19
1478,2017-10-18,17,0,4,6,0,27
1479,2017-10-19,13,0,0,5,0,18
1480,2017-10-20,17,0,1,5,0,23
1481,2017-10-21,10,0,3,3,0,16
1482,2017-10-22,20,0,1,10,0,31
1483,2017-10-23,20,0,3,3,0,26
1484,2017-10-24,25,0,0,2,0,27
1485,2017-10-25,21,0,2,3,0,26
1486,2017-10-26,15,0,4,2,0,21
1487,2017-10-27,16,0,4,1,0,21
1488,2017-10-28,21,0,2,6,0,29
1489,2017-10-29,19,0,7,7,0,33
1490,2017-10-30,14,0,1,7,0,22
1491,2017-10-31,12,0,1,3,0,16
1492,2017-11-01,23,0,2,2,0,27
1493,2017-11-02,17,0,5,4,0,26
1494,2017-11-03,10,0,4,4,0,18
1495,2017-11-04,24,0,1,4,0,29
1496,2017-11-05,18,0,3,10,0,31
1497,2017-11-06,28,0,2,1,0,31
1498,2017-11-07,16,0,4,6,0,26
1499,2017-11-08,18,0,4,3,0,25
1500,2017-11-09,19,0,0,6,0,25
1501,2017-11-10,8,0,2,3,0,13
1502,2017-11-11,22,0,0,1,0,23
1503,2017-11-12,21,0,1,3,0,25
1504,2017-11-13,21,0,1,7,0,29
1505,2017-11-14,18,0,0,5,0,23
1506,2017-11-15,15,0,2,1,0,18
1507,2017-11-16,15,0,3,16,0,34
1508,2017-11-17,15,0,2,2,0,19
1509,2017-11-18,15,0,0,6,0,21
1510,2017-11-19,17,0,1,6,0,24
1511,2017-11-20,35,0,0,5,0,40
1512,2017-11-21,19,0,0,7,0,26
1513,2017-11-22,18,0,3,4,0,25
1514,2017-11-23,2,0,0,1,0,3
1515,2017-11-24,15,0,3,5,0,23
1516,2017-11-25,11,0,1,5,0,17
1517,2017-11-26,9,0,1,3,0,13
1518,2017-11-27,13,0,4,3,0,20
1519,2017-11-28,16,0,7,6,0,29
1520,2017-11-29,13,0,2,6,0,21
1521,2017-11-30,29,0,1,3,0,33
1522,2017-12-01,12,0,3,5,0,20
1523,2017-12-02,16,0,4,3,0,23
1524,2017-12-03,20,0,2,4,0,26
1525,2017-12-04,14,0,7,5,0,26
1526,2017-12-05,24,0,1,16,0,41
1527,2017-12-06,20,0,2,5,0,27
1528,2017-12-07,19,0,1,8,0,28
1529,2017-12-08,18,0,1,4,0,23
1530,2017-12-09,24,0,5,2,0,31
1531,2017-12-10,11,0,2,3,0,16
1532,2017-12-11,14,0,3,9,0,26
1533,2017-12-12,18,0,2,9,0,29
1534,2017-12-13,11,0,3,3,0,17
1535,2017-12-14,10,0,3,4,0,17
1536,2017-12-15,15,0,2,7,0,24
1537,2017-12-16,20,0,4,6,0,30
1538,2017-12-17,19,0,0,3,0,22
1539,2017-12-18,25,0,2,6,0,33
1540,2017-12-19,22,0,1,11,0,34
1541,2017-12-20,17,0,2,5,0,24
1542,2017-12-21,15,0,1,11,0,27
1543,2017-12-22,16,0,0,4,0,20
1544,2017-12-23,17,0,4,5,0,26
1545,2017-12-24,11,0,2,0,0,13
1546,2017-12-25,0,0,2,0,0,2
1547,2017-12-26,20,0,4,9,0,33
1548,2017-12-27,18,0,2,8,0,28
1549,2017-12-28,14,0,3,4,0,21
1550,2017-12-29,18,0,1,6,0,25
1551,2017-12-30,26,0,0,8,0,34
1552,2017-12-31,21,0,2,8,0,31
1553,2018-01-01,7,0,5,1,0,13
1554,2018-01-02,25,0,6,7,0,38
1555,2018-01-03,24,0,0,2,0,26
1556,2018-01-04,13,0,1,3,0,17
1557,2018-01-05,18,0,0,8,0,26
1558,2018-01-06,20,0,1,9,0,30
1559,2018-01-07,18,0,0,4,0,22
1560,2018-01-08,28,0,1,6,0,35
1561,2018-01-09,13,0,4,4,0,21
1562,2018-01-10,15,0,3,6,0,24
1563,2018-01-11,13,0,2,2,0,17
1564,2018-01-12,21,0,4,5,0,30
1565,2018-01-13,18,0,1,6,0,25
1566,2018-01-14,14,0,1,5,0,20
1567,2018-01-15,15,0,1,16,0,32
1568,2018-01-16,8,0,2,0,0,10
1569,2018-01-17,33,0,3,7,0,43
1570,2018-01-18,22,0,0,4,0,26
1571,2018-01-19,9,0,3,1,0,13
1572,2018-01-20,26,0,1,3,0,30
1573,2018-01-21,18,0,4,8,0,30
1574,2018-01-22,26,0,1,9,0,36
1575,2018-01-23,13,0,2,13,0,28
1576,2018-01-24,20,0,1,6,0,27
1577,2018-01-25,15,0,1,6,0,22
1578,2018-01-26,17,0,4,8,0,29
1579,2018-01-27,16,0,2,5,0,23
1580,2018-01-28,20,0,4,4,0,28
1581,2018-01-29,16,0,2,6,0,24
1582,2018-01-30,18,0,1,7,0,26
1583,2018-01-31,18,0,3,5,0,26
1584,2018-02-01,24,0,2,5,0,31
1585,2018-02-02,11,0,2,4,0,17
1586,2018-02-03,15,0,1,4,0,20
1587,2018-02-04,16,0,3,10,0,29
1588,2018-02-05,11,0,1,8,0,20
1589,2018-02-06,17,0,1,5,0,23
1590,2018-02-07,25,0,5,7,0,37
1591,2018-02-08,27,0,2,5,0,34
1592,2018-02-09,12,0,2,11,0,25
1593,2018-02-10,17,0,4,2,0,23
1594,2018-02-11,22,0,2,9,0,33
1595,2018-02-12,12,0,2,6,0,20
1596,2018-02-13,19,0,0,4,0,23
1597,2018-02-14,15,0,2,5,0,22
1598,2018-02-15,32,0,2,3,0,37
1599,2018-02-16,24,0,0,3,0,27
1600,2018-02-17,24,0,1,4,0,29
1601,2018-02-18,17,0,1,8,0,26
1602,2018-02-19,14,0,4,4,0,22
1603,2018-02-20,16,0,1,8,0,25
1604,2018-02-21,11,0,2,6,0,19
1605,2018-02-22,9,0,1,6,0,16
1606,2018-02-23,19,0,4,6,0,29
1607,2018-02-24,29,0,2,2,0,33
1608,2018-02-25,22,0,1,6,0,29
1609,2018-02-26,23,0,4,6,0,33
1610,2018-02-27,19,0,3,4,0,26
1611,2018-02-28,21,0,2,6,0,29
1612,2018-03-01,25,0,2,2,0,29
1613,2018-03-02,23,0,1,6,0,30
1614,2018-03-03,19,0,0,17,0,36
1615,2018-03-04,14,0,0,5,0,19
1616,2018-03-05,24,0,3,8,0,35
1617,2018-03-06,43,0,2,3,0,48
1618,2018-03-07,6,0,3,4,0,13
1619,2018-03-08,21,0,6,6,0,33
1620,2018-03-09,16,0,2,7,0,25
1621,2018-03-10,18,0,2,6,0,26
1622,2018-03-11,13,0,5,8,0,26
1623,2018-03-12,13,0,2,6,0,21
1624,2018-03-13,20,0,0,15,0,35
1625,2018-03-14,15,0,4,3,0,22
1626,2018-03-15,12,0,3,6,0,21
1627,2018-03-16,10,0,0,3,0,13
1628,2018-03-17,20,0,1,5,0,26
1629,2018-03-18,15,0,2,7,0,24
1630,2018-03-19,12,0,4,5,0,21
1631,2018-03-20,21,0,2,10,0,33
1632,2018-03-21,24,0,5,3,0,32
1633,2018-03-22,19,0,3,3,0,25
1634,2018-03-23,29,0,2,14,0,45
1635,2018-03-24,23,0,3,4,0,30
1636,2018-03-25,24,0,1,4,0,29
1637,2018-03-26,17,0,4,6,0,27
1638,2018-03-27,18,0,2,5,0,25
1639,2018-03-28,27,0,5,5,0,37
1640,2018-03-29,16,0,4,6,0,26
1641,2018-03-30,29,0,3,4,0,36
1642,2018-03-31,16,0,1,3,0,20
1643,2018-04-01,18,0,4,8,0,30
1644,2018-04-02,19,0,3,7,0,29
1645,2018-04-03,11,0,4,6,0,21
1646,2018-04-04,33,0,0,9,0,42
1647,2018-04-05,19,0,6,7,0,32
1648,2018-04-06,21,0,2,6,0,29
1649,2018-04-07,19,0,2,10,0,31
1650,2018-04-08,10,0,0,3,0,13
1651,2018-04-09,9,0,4,8,0,21
1652,2018-04-10,23,0,2,9,0,34
1653,2018-04-11,13,0,4,6,0,23
1654,2018-04-12,26,0,2,6,0,34
1655,2018-04-13,15,0,1,6,0,22
1656,2018-04-14,17,0,4,8,0,29
1657,2018-04-15,12,0,2,10,0,24
1658,2018-04-16,29,0,2,5,0,36
1659,2018-04-17,19,0,9,7,0,35
1660,2018-04-18,17,0,4,2,0,23
1661,2018-04-19,9,0,1,4,0,14
1662,2018-04-20,16,0,0,7,0,23
1663,2018-04-21,11,0,3,5,0,19
1664,2018-04-22,11,0,4,4,0,19
1665,2018-04-23,13,0,5,6,0,24
1666,2018-04-24,18,0,1,5,0,24
1667,2018-04-25,23,0,5,7,0,35
1668,2018-04-26,26,0,1,7,0,34
1669,2018-04-27,24,0,2,5,0,31
1670,2018-04-28,16,0,3,7,0,26
1671,2018-04-29,14,0,0,5,0,19
1672,2018-04-30,30,0,0,7,0,37
1673,2018-05-01,11,0,2,13,0,26
1674,2018-05-02,9,0,6,6,0,21
1675,2018-05-03,19,0,5,4,0,28
1676,2018-05-04,15,0,1,5,0,21
1677,2018-05-05,18,0,2,10,0,30
1678,2018-05-06,20,0,0,3,0,23
1679,2018-05-07,21,0,0,9,0,30
1680,2018-05-08,15,0,1,3,0,19
1681,2018-05-09,17,0,2,7,0,26
1682,2018-05-10,14,0,0,7,0,21
1683,2018-05-11,13,0,1,11,0,25
1684,2018-05-12,21,0,1,5,0,27
1685,2018-05-13,14,0,4,4,0,22
1686,2018-05-14,11,0,0,11,0,22
1687,2018-05-15,18,0,5,4,0,27
1688,2018-05-16,11,0,6,6,0,23
1689,2018-05-17,8,0,2,5,0,15
1690,2018-05-18,13,0,3,6,0,22
1691,2018-05-19,17,0,2,11,0,30
1692,2018-05-20,25,0,4,14,0,43
1693,2018-05-21,20,0,1,7,0,28
1694,2018-05-22,31,0,3,7,0,41
1695,2018-05-23,21,0,2,2,0,25
1696,2018-05-24,28,0,2,0,0,30
1697,2018-05-25,11,0,0,7,0,18
1698,2018-05-26,10,0,3,4,0,17
1699,2018-05-27,25,0,1,4,0,30
1700,2018-05-28,15,0,0,1,0,16
1701,2018-05-29,31,0,2,6,0,39
1702,2018-05-30,27,0,6,8,0,41
1703,2018-05-31,9,0,2,8,0,19
1704,2018-06-01,19,0,2,5,0,26
1705,2018-06-02,17,0,1,18,0,36
1706,2018-06-03,19,0,3,15,0,37
1707,2018-06-04,20,0,3,9,0,32
1708,2018-06-05,19,0,4,9,0,32
1709,2018-06-06,17,0,1,13,0,31
1710,2018-06-07,21,0,2,4,0,27
1711,2018-06-08,21,0,3,7,0,31
1712,2018-06-09,20,0,2,3,0,25
1713,2018-06-10,17,0,0,4,0,21
1714,2018-06-11,18,0,3,6,0,27
1715,2018-06-12,15,0,1,5,0,21
1716,2018-06-13,9,0,5,7,0,21
1717,2018-06-14,16,0,1,14,0,31
1718,2018-06-15,14,0,0,5,0,19
1719,2018-06-16,21,0,3,2,0,26
1720,2018-06-17,14,0,2,0,0,16
1721,2018-06-18,19,0,1,11,0,31
1722,2018-06-19,18,0,1,1,0,20
1723,2018-06-20,28,0,0,8,0,36
1724,2018-06-21,34,0,3,3,0,40
1725,2018-06-22,17,0,1,3,0,21
1726,2018-06-23,24,0,0,5,0,29
1727,2018-06-24,12,0,0,2,0,14
1728,2018-06-25,17,0,0,3,0,20
1729,2018-06-26,12,0,4,2,0,18
1730,2018-06-27,40,0,2,7,0,49
1731,2018-06-28,20,0,1,6,0,27
1732,2018-06-29,18,0,1,5,0,24
1733,2018-06-30,11,0,2,4,0,17
1734,2018-07-01,12,0,1,11,0,24
1735,2018-07-02,30,0,4,7,0,41
1736,2018-07-03,25,0,8,3,0,36
1737,2018-07-04,13,0,2,5,0,20
1738,2018-07-05,38,0,3,1,0,42
1739,2018-07-06,38,0,1,3,0,42
1740,2018-07-07,22,0,2,2,0,26
1741,2018-07-08,21,0,2,3,0,26
1742,2018-07-09,34,0,0,8,0,42
1743,2018-07-10,20,0,7,8,0,35
1744,2018-07-11,32,0,0,5,0,37
1745,2018-07-12,16,0,4,2,0,22
1746,2018-07-13,18,0,1,2,0,21
1747,2018-07-14,22,0,1,10,0,33
1748,2018-07-15,16,0,6,7,0,29
1749,2018-07-16,14,0,5,5,0,24
1750,2018-07-17,16,0,4,5,0,25
1751,2018-07-18,20,0,1,4,0,25
1752,2018-07-19,20,0,1,4,0,25
1753,2018-07-20,20,0,1,4,0,25
1754,2018-07-21,18,0,5,6,0,29
1755,2018-07-22,10,0,0,5,0,15
1756,2018-07-23,24,0,3,10,0,37
1757,2018-07-24,22,0,0,6,0,28
1758,2018-07-25,14,0,3,9,0,26
1759,2018-07-26,8,0,3,4,0,15
1760,2018-07-27,15,0,7,4,0,26
1761,2018-07-28,17,0,2,4,0,23
1762,2018-07-29,8,0,2,5,0,15
1763,2018-07-30,5,0,3,7,0,15
1764,2018-07-31,20,0,4,9,0,33
1765,2018-08-01,13,0,2,8,0,23
1766,2018-08-02,19,0,1,0,0,20
1767,2018-08-03,19,0,3,5,0,27
1768,2018-08-04,24,0,1,7,0,32
1769,2018-08-05,21,0,1,6,0,28
1770,2018-08-06,19,0,3,19,0,41
1771,2018-08-07,16,0,5,23,0,44
1772,2018-08-08,21,0,2,1,0,24
1773,2018-08-09,19,0,2,7,0,28
1774,2018-08-10,17,0,0,12,0,29
1775,2018-08-11,15,0,0,1,0,16
1776,2018-08-12,15,0,2,2,0,19
1777,2018-08-13,25,0,3,2,0,30
1778,2018-08-14,19,0,3,5,0,27
1779,2018-08-15,22,0,4,2,0,28
1780,2018-08-16,23,0,3,2,0,28
1781,2018-08-17,21,0,1,5,0,27
1782,2018-08-18,11,0,2,10,0,23
1783,2018-08-19,20,0,2,5,0,27
1784,2018-08-20,15,0,7,8,0,30
1785,2018-08-21,8,0,3,5,0,16
1786,2018-08-22,15,0,5,8,0,28
1787,2018-08-23,15,0,2,10,0,27
1788,2018-08-24,25,0,3,10,0,38
1789,2018-08-25,13,0,3,5,0,21
1790,2018-08-26,19,0,4,5,0,28
1791,2018-08-27,12,0,2,4,0,18
1792,2018-08-28,11,0,2,6,0,19
1793,2018-08-29,26,0,1,4,0,31
1794,2018-08-30,14,0,0,5,0,19
1795,2018-08-31,18,0,4,6,0,28
1796,2018-09-01,17,0,2,8,0,27
1797,2018-09-02,17,0,5,6,0,28
1798,2018-09-03,29,0,3,4,0,36
1799,2018-09-04,13,0,1,6,0,20
1800,2018-09-05,26,0,3,7,0,36
1801,2018-09-06,15,0,2,3,0,20
1802,2018-09-07,24,0,2,4,0,30
1803,2018-09-08,29,0,1,8,0,38
1804,2018-09-09,17,0,3,8,0,28
1805,2018-09-10,38,0,2,7,0,47
1806,2018-09-11,28,0,5,2,0,35
1807,2018-09-12,19,0,7,7,0,33
1808,2018-09-13,29,0,7,1,0,37
1809,2018-09-14,21,0,1,6,0,28
1810,2018-09-15,17,0,2,8,0,27
1811,2018-09-16,19,0,0,5,0,24
1812,2018-09-17,17,0,3,7,0,27
1813,2018-09-18,14,0,1,5,0,20
1814,2018-09-19,13,0,2,13,0,28
1815,2018-09-20,25,0,3,6,0,34
1816,2018-09-21,28,0,3,7,0,38
1817,2018-09-22,25,0,1,11,0,37
1818,2018-09-23,31,0,3,9,0,43
1819,2018-09-24,35,0,1,9,0,45
1820,2018-09-25,23,0,2,10,0,35
1821,2018-09-26,12,0,1,5,0,18
1822,2018-09-27,22,0,0,6,0,28
1823,2018-09-28,18,0,3,4,0,25
1824,2018-09-29,20,0,0,6,0,26
1825,2018-09-30,18,0,1,6,0,25
1826,2018-10-01,15,0,2,12,0,29
1827,2018-10-02,13,0,4,2,0,19
1828,2018-10-03,23,0,3,6,0,32
1829,2018-10-04,23,0,2,6,0,31
1830,2018-10-05,19,0,4,1,0,24
1831,2018-10-06,31,0,3,8,0,42
1832,2018-10-07,12,0,0,6,0,18
1833,2018-10-08,20,0,6,7,0,33
1834,2018-10-09,35,0,2,7,0,44
1835,2018-10-10,35,0,0,4,0,39
1836,2018-10-11,21,0,2,3,0,26
1837,2018-10-12,25,0,0,8,0,33
1838,2018-10-13,29,0,7,14,0,50
1839,2018-10-14,24,0,2,2,0,28
1840,2018-10-15,10,0,3,1,0,14
1841,2018-10-16,16,0,1,0,0,17
1842,2018-10-17,19,0,2,5,0,26
1843,2018-10-18,19,0,1,3,0,23
1844,2018-10-19,27,0,1,13,0,41
1845,2018-10-20,38,0,5,6,0,49
1846,2018-10-21,27,0,1,6,0,34
1847,2018-10-22,30,0,5,4,0,39
1848,2018-10-23,44,0,2,7,0,53
1849,2018-10-24,18,0,3,6,0,27
1850,2018-10-25,20,0,1,3,0,24
1851,2018-10-26,9,0,1,5,0,15
1852,2018-10-27,30,0,1,7,0,38
1853,2018-10-28,9,0,1,4,0,14
1854,2018-10-29,22,0,1,8,0,31
1855,2018-10-30,24,0,2,5,0,31
1856,2018-10-31,22,0,1,10,0,33
1857,2018-11-01,17,0,3,7,0,27
1858,2018-11-02,14,0,4,6,0,24
1859,2018-11-03,15,0,1,3,0,19
1860,2018-11-04,22,0,1,2,0,25
1861,2018-11-05,22,0,3,7,0,32
1862,2018-11-06,19,0,2,3,0,24
1863,2018-11-07,22,0,5,6,0,33
1864,2018-11-08,16,0,2,10,0,28
1865,2018-11-09,30,0,1,5,0,36
1866,2018-11-10,20,0,2,6,0,28
1867,2018-11-11,28,0,1,1,0,30
1868,2018-11-12,25,0,0,3,0,28
1869,2018-11-13,20,0,4,4,0,28
1870,2018-11-14,23,0,2,1,0,26
1871,2018-11-15,16,0,9,3,0,28
1872,2018-11-16,20,0,1,4,0,25
1873,2018-11-17,18,0,3,6,0,27
1874,2018-11-18,20,0,0,4,0,24
1875,2018-11-19,34,0,4,3,0,41
1876,2018-11-20,20,0,3,9,0,32
1877,2018-11-21,23,0,0,3,0,26
1878,2018-11-22,1,0,0,0,0,1
1879,2018-11-23,32,0,1,7,0,40
1880,2018-11-24,20,0,4,3,0,27
1881,2018-11-25,26,0,1,5,0,32
1882,2018-11-26,13,0,1,4,0,18
1883,2018-11-27,14,0,1,10,0,25
1884,2018-11-28,14,0,1,4,0,19
1885,2018-11-29,16,0,3,6,0,25
1886,2018-11-30,10,0,4,3,0,17
1887,2018-12-01,18,0,4,3,0,25
1888,2018-12-02,23,0,1,1,0,25
1889,2018-12-03,26,0,4,14,0,44
1890,2018-12-04,12,0,3,10,0,25
1891,2018-12-05,20,0,4,7,0,31
1892,2018-12-06,12,0,6,4,0,22
1893,2018-12-07,22,0,0,10,0,32
1894,2018-12-08,21,0,5,2,0,28
1895,2018-12-09,20,0,3,1,0,24
1896,2018-12-10,28,0,6,7,0,41
1897,2018-12-11,15,0,6,1,0,22
1898,2018-12-12,20,0,1,4,0,25
1899,2018-12-13,22,0,4,3,0,29
1900,2018-12-14,29,0,1,5,0,35
1901,2018-12-15,16,0,1,8,0,25
1902,2018-12-16,14,0,1,2,0,17
1903,2018-12-17,13,0,1,3,0,17
1904,2018-12-18,10,0,0,4,0,14
1905,2018-12-19,17,0,1,7,0,25
1906,2018-12-20,17,0,4,12,0,33
1907,2018-12-21,17,0,3,7,0,27
1908,2018-12-22,16,0,0,13,0,29
1909,2018-12-23,25,0,0,3,0,28
1910,2018-12-24,18,0,1,0,0,19
1911,2018-12-25,4,0,0,0,0,4
1912,2018-12-26,18,0,2,11,0,31
1913,2018-12-27,28,0,6,12,0,46
1914,2018-12-28,25,0,3,8,0,36
1915,2018-12-29,10,0,0,6,0,16
1916,2018-12-30,10,0,2,4,0,16
1917,2018-12-31,17,0,2,7,0,26
1918,2019-01-01,12,0,0,2,0,14
1919,2019-01-02,38,0,4,4,0,46
1920,2019-01-03,29,0,1,5,0,35
1921,2019-01-04,20,0,3,7,0,30
1922,2019-01-05,23,0,1,4,0,28
1923,2019-01-06,20,0,3,7,0,30
1924,2019-01-07,23,0,3,3,0,29
1925,2019-01-08,24,0,0,2,0,26
1926,2019-01-09,28,0,3,4,0,35
1927,2019-01-10,28,0,2,3,0,33
1928,2019-01-11,23,0,2,10,0,35
1929,2019-01-12,23,0,4,7,0,34
1930,2019-01-13,16,0,1,2,0,19
1931,2019-01-14,25,0,0,9,0,34
1932,2019-01-15,19,0,2,4,0,25
1933,2019-01-16,13,0,1,8,0,22
1934,2019-01-17,25,0,5,3,0,33
1935,2019-01-18,26,0,7,5,0,38
1936,2019-01-19,29,0,2,4,0,35
1937,2019-01-20,19,0,0,6,0,25
1938,2019-01-21,18,0,2,7,0,27
1939,2019-01-22,16,0,0,13,0,29
1940,2019-01-23,11,0,3,8,0,22
1941,2019-01-24,6,0,2,7,0,15
1942,2019-01-25,28,0,2,2,0,32
1943,2019-01-26,17,0,3,12,0,32
1944,2019-01-27,19,0,1,9,0,29
1945,2019-01-28,9,0,3,3,0,15
1946,2019-01-29,22,0,3,6,0,31
1947,2019-01-30,23,0,2,2,0,27
1948,2019-01-31,13,0,1,5,0,19
1949,2019-02-01,20,0,2,10,0,32
1950,2019-02-02,29,0,5,8,0,42
1951,2019-02-03,13,0,1,2,0,16
1952,2019-02-04,27,0,2,12,0,41
1953,2019-02-05,19,0,2,6,0,27
1954,2019-02-06,13,0,2,7,0,22
1955,2019-02-07,24,0,1,8,0,33
1956,2019-02-08,20,0,4,5,0,29
1957,2019-02-09,15,0,3,5,0,23
1958,2019-02-10,21,0,0,3,0,24
1959,2019-02-11,10,0,2,8,0,20
1960,2019-02-12,31,0,4,4,0,39
1961,2019-02-13,24,0,0,7,0,31
1962,2019-02-14,11,0,2,7,0,20
1963,2019-02-15,15,0,3,9,0,27
1964,2019-02-16,20,0,2,4,0,26
1965,2019-02-17,14,0,0,8,0,22
1966,2019-02-18,25,0,0,6,0,31
1967,2019-02-19,11,0,2,16,0,29
1968,2019-02-20,19,0,5,4,0,28
1969,2019-02-21,25,0,2,3,0,30
1970,2019-02-22,18,0,1,5,0,24
1971,2019-02-23,17,0,0,4,0,21
1972,2019-02-24,21,0,2,7,0,30
1973,2019-02-25,16,0,0,8,0,24
1974,2019-02-26,20,0,4,12,0,36
1975,2019-02-27,11,0,2,7,0,20
1976,2019-02-28,24,0,3,1,0,28
1977,2019-03-01,24,0,4,7,0,35
1978,2019-03-02,19,0,5,13,0,37
1979,2019-03-03,25,0,2,6,0,33
1980,2019-03-04,27,0,5,4,0,36
1981,2019-03-05,31,0,1,12,0,44
1982,2019-03-06,25,0,1,7,0,33
1983,2019-03-07,27,0,3,12,0,42
1984,2019-03-08,19,0,1,7,0,27
1985,2019-03-09,22,0,1,5,0,28
1986,2019-03-10,28,0,2,3,0,33
1987,2019-03-11,23,0,1,7,0,31
1988,2019-03-12,24,0,1,10,0,35
1989,2019-03-13,19,0,2,4,0,25
1990,2019-03-14,12,0,4,10,0,26
1991,2019-03-15,23,0,1,4,0,28
1992,2019-03-16,21,0,4,11,0,36
1993,2019-03-17,11,0,2,7,0,20
1994,2019-03-18,27,0,3,8,0,38
1995,2019-03-19,23,0,5,2,0,30
1996,2019-03-20,17,0,3,13,0,33
1997,2019-03-21,39,0,2,5,0,46
1998,2019-03-22,28,0,3,6,0,37
1999,2019-03-23,13,0,4,13,0,30
2000,2019-03-24,10,0,1,8,0,19
2001,2019-03-25,16,0,6,11,0,33
2002,2019-03-26,20,0,3,6,0,29
2003,2019-03-27,18,0,6,4,0,28
2004,2019-03-28,23,0,3,5,0,31
2005,2019-03-29,12,0,3,5,0,20
2006,2019-03-30,18,0,3,6,0,27
2007,2019-03-31,26,0,3,4,0,33
2008,2019-04-01,19,0,2,11,0,32
2009,2019-04-02,8,0,4,8,0,20
2010,2019-04-03,19,0,2,15,0,36
2011,2019-04-04,16,0,4,7,0,27
2012,2019-04-05,16,0,4,2,0,22
2013,2019-04-06,14,0,0,4,0,18
2014,2019-04-07,29,0,3,4,0,36
2015,2019-04-08,35,0,0,6,0,41
2016,2019-04-09,28,0,3,12,0,43
2017,2019-04-10,30,0,1,4,0,35
2018,2019-04-11,23,0,0,10,0,33
2019,2019-04-12,16,0,5,1,0,22
2020,2019-04-13,25,0,2,6,0,33
2021,2019-04-14,16,0,3,6,0,25
2022,2019-04-15,25,0,1,8,0,34
2023,2019-04-16,13,0,3,10,0,26
2024,2019-04-17,22,0,3,15,0,40
2025,2019-04-18,33,0,0,6,0,39
2026,2019-04-19,21,0,3,5,0,29
2027,2019-04-20,16,0,0,6,0,22
2028,2019-04-21,10,0,2,4,0,16
2029,2019-04-22,19,0,3,8,0,30
2030,2019-04-23,13,0,0,13,0,26
2031,2019-04-24,10,0,1,4,0,15
2032,2019-04-25,22,0,2,8,0,32
2033,2019-04-26,30,0,2,16,0,48
2034,2019-04-27,23,0,9,6,0,38
2035,2019-04-28,21,0,1,3,0,25
2036,2019-04-29,19,0,3,10,0,32
2037,2019-04-30,15,0,4,5,0,24
2038,2019-05-01,18,0,5,4,0,27
2039,2019-05-02,23,0,1,8,0,32
2040,2019-05-03,20,0,3,6,0,29
2041,2019-05-04,36,0,2,9,0,47
2042,2019-05-05,17,0,1,6,0,24
2043,2019-05-06,27,0,3,7,0,37
2044,2019-05-07,20,0,1,4,0,25
2045,2019-05-08,34,0,1,8,0,43
2046,2019-05-09,24,0,2,7,0,33
2047,2019-05-10,29,0,4,5,0,38
2048,2019-05-11,30,0,3,17,0,50
2049,2019-05-12,21,0,1,2,0,24
2050,2019-05-13,11,0,2,6,0,19
2051,2019-05-14,18,0,1,1,0,20
2052,2019-05-15,25,0,0,7,0,32
2053,2019-05-16,17,0,3,4,0,24
2054,2019-05-17,15,0,0,5,0,20
2055,2019-05-18,28,0,1,8,0,37
2056,2019-05-19,15,0,0,8,0,23
2057,2019-05-20,29,0,4,20,0,53
2058,2019-05-21,23,0,3,3,0,29
2059,2019-05-22,15,0,1,3,0,19
2060,2019-05-23,32,0,4,4,0,40
2061,2019-05-24,20,0,1,11,0,32
2062,2019-05-25,14,0,3,8,0,25
2063,2019-05-26,14,0,2,3,0,19
2064,2019-05-27,16,0,2,9,0,27
2065,2019-05-28,35,0,3,12,0,50
2066,2019-05-29,16,0,3,2,0,21
2067,2019-05-30,25,0,3,9,0,37
2068,2019-05-31,19,0,2,3,0,24
2069,2019-06-01,19,0,3,3,0,25
2070,2019-06-02,31,0,2,6,0,39
2071,2019-06-03,37,0,2,6,0,45
2072,2019-06-04,40,0,5,6,0,51
2073,2019-06-05,20,0,2,14,0,36
2074,2019-06-06,24,0,3,6,0,33
2075,2019-06-07,22,0,4,5,0,31
2076,2019-06-08,20,0,2,7,0,29
2077,2019-06-09,17,0,2,6,0,25
2078,2019-06-10,36,0,3,12,0,51
2079,2019-06-11,20,0,3,8,0,31
2080,2019-06-12,14,0,4,7,0,25
2081,2019-06-13,22,0,2,8,0,32
2082,2019-06-14,15,0,2,16,0,33
2083,2019-06-15,22,0,2,1,0,25
2084,2019-06-16,14,0,0,8,0,22
2085,2019-06-17,33,0,1,10,0,44
2086,2019-06-18,23,0,2,9,0,34
2087,2019-06-19,34,0,1,4,0,39
2088,2019-06-20,11,0,1,3,0,15
2089,2019-06-21,23,0,4,9,0,36
2090,2019-06-22,31,0,3,5,0,39
2091,2019-06-23,20,0,1,4,0,25
2092,2019-06-24,23,0,2,10,0,35
2093,2019-06-25,22,0,2,6,0,30
2094,2019-06-26,37,0,3,5,0,45
2095,2019-06-27,22,0,2,13,0,37
2096,2019-06-28,8,0,2,5,0,15
2097,2019-06-29,12,0,3,1,0,16
2098,2019-06-30,14,0,3,10,0,27
2099,2019-07-01,25,0,3,11,0,39
2100,2019-07-02,21,0,2,7,0,30
2101,2019-07-03,26,0,3,5,0,34
2102,2019-07-04,2,0,4,1,0,7
2103,2019-07-05,42,0,5,12,0,59
2104,2019-07-06,29,0,9,18,0,56
2105,2019-07-07,12,0,10,8,0,30
2106,2019-07-08,48,0,0,0,0,48
2107,2019-07-09,10,0,4,1,0,15
2108,2019-07-10,31,0,24,6,0,61
2109,2019-07-11,32,0,3,9,0,44
2110,2019-07-12,22,0,5,5,0,32
2111,2019-07-13,18,0,2,13,0,33
2112,2019-07-14,13,0,0,6,0,19
2113,2019-07-15,17,0,3,9,0,29
2114,2019-07-16,18,0,6,7,0,31
2115,2019-07-17,16,0,5,7,0,28
2116,2019-07-18,9,0,4,4,0,17
2117,2019-07-19,19,0,1,7,0,27
2118,2019-07-20,21,0,2,10,0,33
2119,2019-07-21,18,0,1,3,0,22
2120,2019-07-22,30,0,7,5,0,42
2121,2019-07-23,13,0,4,7,0,24
2122,2019-07-24,29,0,6,3,0,38
2123,2019-07-25,9,0,1,2,0,12
2124,2019-07-26,28,0,3,6,0,37
2125,2019-07-27,12,0,2,16,0,30
2126,2019-07-28,26,0,5,6,0,37
2127,2019-07-29,17,0,2,10,0,29
2128,2019-07-30,14,0,4,5,0,23
2129,2019-07-31,29,0,4,7,0,40
2130,2019-08-01,15,0,5,12,0,32
2131,2019-08-02,20,0,4,4,0,28
2132,2019-08-03,25,0,1,2,0,28
2133,2019-08-04,26,0,0,9,0,35
2134,2019-08-05,29,0,2,6,0,37
2135,2019-08-06,22,0,1,3,0,26
2136,2019-08-07,24,0,5,3,0,32
2137,2019-08-08,10,0,1,3,0,14
2138,2019-08-09,18,0,3,11,0,32
2139,2019-08-10,12,0,3,3,0,18
2140,2019-08-11,12,0,2,6,0,20
2141,2019-08-12,23,0,4,4,0,31
2142,2019-08-13,26,0,3,6,0,35
2143,2019-08-14,9,0,2,2,0,13
2144,2019-08-15,44,0,0,11,0,55
2145,2019-08-16,23,0,1,11,0,35
2146,2019-08-17,24,0,0,8,0,32
2147,2019-08-18,19,0,4,3,0,26
2148,2019-08-19,10,0,5,10,0,25
2149,2019-08-20,22,0,3,10,0,35
2150,2019-08-21,28,0,0,3,0,31
2151,2019-08-22,21,0,0,11,0,32
2152,2019-08-23,20,0,0,3,0,23
2153,2019-08-24,27,0,0,6,0,33
2154,2019-08-25,13,0,2,12,0,27
2155,2019-08-26,22,0,0,6,0,28
2156,2019-08-27,24,0,5,2,0,31
2157,2019-08-28,19,0,1,10,0,30
2158,2019-08-29,20,0,5,9,0,34
2159,2019-08-30,14,0,6,5,0,25
2160,2019-08-31,32,0,8,11,0,51
2161,2019-09-01,13,0,0,6,0,19
2162,2019-09-02,33,0,2,7,0,42
2163,2019-09-03,21,0,12,9,0,42
2164,2019-09-04,16,0,2,6,0,24
2165,2019-09-05,22,0,2,2,0,26
2166,2019-09-06,18,0,1,2,0,21
2167,2019-09-07,14,0,2,2,0,18
2168,2019-09-08,22,0,2,7,0,31
2169,2019-09-09,21,0,1,9,0,31
2170,2019-09-10,19,0,1,12,0,32
2171,2019-09-11,29,0,3,12,0,44
2172,2019-09-12,34,0,1,4,0,39
2173,2019-09-13,19,0,1,9,0,29
2174,2019-09-14,15,0,2,14,0,31
2175,2019-09-15,18,0,2,7,0,27
2176,2019-09-16,24,0,2,5,0,31
2177,2019-09-17,33,0,2,7,0,42
2178,2019-09-18,15,0,2,9,0,26
2179,2019-09-19,23,0,1,2,0,26
2180,2019-09-20,15,0,6,7,0,28
2181,2019-09-21,36,0,1,13,0,50
2182,2019-09-22,17,0,0,10,0,27
2183,2019-09-23,23,0,0,18,0,41
2184,2019-09-24,24,0,3,8,0,35
2185,2019-09-25,13,0,2,4,0,19
2186,2019-09-26,12,0,1,9,0,22
2187,2019-09-27,22,0,2,11,0,35
2188,2019-09-28,17,0,1,11,0,29
2189,2019-09-29,11,0,1,22,0,34
2190,2019-09-30,12,0,2,8,0,22
2191,2019-10-01,23,0,1,9,0,33
2192,2019-10-02,35,0,4,8,0,47
2193,2019-10-03,19,0,1,17,0,37
2194,2019-10-04,22,0,0,8,0,30
2195,2019-10-05,24,0,2,12,0,38
2196,2019-10-06,27,0,6,3,0,36
2197,2019-10-07,20,0,0,4,0,24
2198,2019-10-08,12,0,2,10,0,24
2199,2019-10-09,14,0,1,6,0,21
2200,2019-10-10,15,0,3,8,0,26
2201,2019-10-11,27,0,1,5,0,33
2202,2019-10-12,19,0,2,9,0,30
2203,2019-10-13,25,0,6,4,0,35
2204,2019-10-14,13,0,2,7,0,22
2205,2019-10-15,11,0,2,4,0,17
2206,2019-10-16,22,0,2,12,0,36
2207,2019-10-17,14,0,1,3,0,18
2208,2019-10-18,16,0,2,6,0,24
2209,2019-10-19,16,0,0,15,0,31
2210,2019-10-20,21,0,3,2,0,26
2211,2019-10-21,32,0,0,5,0,37
2212,2019-10-22,15,0,4,14,0,33
2213,2019-10-23,18,0,4,25,0,47
2214,2019-10-24,33,0,0,9,0,42
2215,2019-10-25,19,0,0,14,0,33
2216,2019-10-26,19,0,1,5,0,25
2217,2019-10-27,14,0,0,5,0,19
2218,2019-10-28,22,0,2,6,0,30
2219,2019-10-29,14,0,1,2,0,17
2220,2019-10-30,19,0,0,5,0,24
2221,2019-10-31,28,0,0,7,0,35
2222,2019-11-01,13,0,1,9,0,23
2223,2019-11-02,13,0,1,15,0,29
2224,2019-11-03,23,0,0,9,0,32
2225,2019-11-04,20,0,2,7,0,29
2226,2019-11-05,21,0,2,7,0,30
2227,2019-11-06,14,0,1,12,0,27
2228,2019-11-07,26,0,1,5,0,32
2229,2019-11-08,18,0,1,4,0,23
2230,2019-11-09,21,0,1,3,0,25
2231,2019-11-10,26,0,0,15,0,41
2232,2019-11-11,22,0,2,3,0,27
2233,2019-11-12,13,0,0,2,0,15
2234,2019-11-13,22,0,5,4,0,31
2235,2019-11-14,36,0,2,4,0,42
2236,2019-11-15,22,0,2,3,0,27
2237,2019-11-16,14,0,0,6,0,20
2238,2019-11-17,27,0,0,7,0,34
2239,2019-11-18,28,0,4,8,0,40
2240,2019-11-19,15,0,0,5,0,20
2241,2019-11-20,21,0,0,8,0,29
2242,2019-11-21,24,0,0,7,0,31
2243,2019-11-22,22,0,0,8,0,30
2244,2019-11-23,35,0,1,9,0,45
2245,2019-11-24,13,0,0,5,0,18
2246,2019-11-25,26,0,0,12,0,38
2247,2019-11-26,16,0,2,3,0,21
2248,2019-11-27,22,0,1,5,0,28
2249,2019-11-28,2,0,0,0,0,2
2250,2019-11-29,17,0,1,10,0,28
2251,2019-11-30,21,0,0,14,0,35
2252,2019-12-01,16,0,2,8,0,26
2253,2019-12-02,24,0,0,6,0,30
2254,2019-12-03,31,0,2,6,0,39
2255,2019-12-04,22,0,1,6,0,29
2256,2019-12-05,17,0,1,1,0,19
2257,2019-12-06,13,0,2,4,0,19
2258,2019-12-07,21,0,0,12,0,33
2259,2019-12-08,26,0,2,2,0,30
2260,2019-12-09,15,0,4,12,0,31
2261,2019-12-10,11,0,2,9,0,22
2262,2019-12-11,17,0,1,11,0,29
2263,2019-12-12,14,0,2,3,0,19
2264,2019-12-13,16,0,1,11,0,28
2265,2019-12-14,17,0,2,12,0,31
2266,2019-12-15,17,0,1,3,0,21
2267,2019-12-16,19,0,2,6,0,27
2268,2019-12-17,18,0,1,5,0,24
2269,2019-12-18,39,0,4,5,0,48
2270,2019-12-19,12,0,0,6,0,18
2271,2019-12-20,11,0,2,8,0,21
2272,2019-12-21,22,0,1,3,0,26
2273,2019-12-22,15,0,0,13,0,28
2274,2019-12-23,21,0,1,14,0,36
2275,2019-12-24,0,0,2,0,0,2
2276,2019-12-26,30,0,0,4,0,34
2277,2019-12-27,21,0,0,4,0,25
2278,2019-12-28,14,0,3,4,0,21
2279,2019-12-29,19,0,3,6,0,28
2280,2019-12-30,25,0,1,6,0,32
2281,2019-12-31,31,0,2,5,0,38
2282,2020-01-01,9,0,0,0,0,9
2283,2020-01-02,38,0,3,6,0,47
2284,2020-01-03,29,0,1,5,0,35
2285,2020-01-04,31,0,0,12,0,43
2286,2020-01-05,20,0,3,4,0,27
2287,2020-01-06,14,0,2,14,0,30
2288,2020-01-07,25,0,1,7,0,33
2289,2020-01-08,13,0,2,2,0,17
2290,2020-01-09,19,0,0,0,0,19
2291,2020-01-10,11,0,2,7,0,20
2292,2020-01-11,18,0,0,10,0,28
2293,2020-01-12,15,0,2,4,0,21
2294,2020-01-13,18,0,2,7,0,27
2295,2020-01-14,11,0,2,5,0,18
2296,2020-01-15,17,0,3,8,0,28
2297,2020-01-16,20,0,2,10,0,32
2298,2020-01-17,21,0,1,6,0,28
2299,2020-01-18,23,0,0,17,0,40
2300,2020-01-19,19,0,0,5,0,24
2301,2020-01-20,3,0,1,0,0,4
2302,2020-01-21,25,0,1,10,0,36
2303,2020-01-22,19,0,5,12,0,36
2304,2020-01-23,29,0,0,10,0,39
2305,2020-01-24,10,0,0,8,0,18
2306,2020-01-25,17,0,1,14,0,32
2307,2020-01-26,11,0,2,5,0,18
2308,2020-01-27,20,0,1,10,0,31
2309,2020-01-28,25,0,3,9,0,37
2310,2020-01-29,13,0,1,19,0,33
2311,2020-01-30,14,0,2,6,0,22
2312,2020-01-31,18,0,3,7,0,28
2313,2020-02-01,18,0,1,6,0,25
2314,2020-02-02,16,0,1,4,0,21
2315,2020-02-03,21,0,7,3,0,31
2316,2020-02-04,16,0,2,6,0,24
2317,2020-02-05,22,0,1,3,0,26
2318,2020-02-06,19,0,1,6,0,26
2319,2020-02-07,21,0,5,3,0,29
2320,2020-02-08,25,0,0,6,0,31
2321,2020-02-09,19,0,3,5,0,27
2322,2020-02-10,13,0,1,1,0,15
2323,2020-02-11,18,0,2,6,0,26
2324,2020-02-12,8,0,1,0,0,9
2325,2020-02-13,20,0,0,9,0,29
2326,2020-02-14,35,0,1,6,0,42
2327,2020-02-15,18,0,1,12,0,31
2328,2020-02-16,16,0,2,8,0,26
2329,2020-02-17,10,0,0,1,0,11
2330,2020-02-18,18,0,0,15,0,33
2331,2020-02-19,12,0,1,12,0,25
2332,2020-02-20,18,0,0,6,0,24
2333,2020-02-21,16,0,0,9,0,25
2334,2020-02-22,13,0,0,9,0,22
2335,2020-02-23,25,0,1,10,0,36
2336,2020-02-24,22,0,4,4,0,30
2337,2020-02-25,18,0,3,15,0,36
2338,2020-02-26,26,0,0,10,0,36
2339,2020-02-27,24,0,0,5,0,29
2340,2020-02-28,16,0,1,11,0,28
2341,2020-02-29,20,0,1,7,0,28
2342,2020-03-01,16,0,2,7,0,25
2343,2020-03-02,30,0,2,6,0,38
2344,2020-03-03,20,0,2,14,0,36
2345,2020-03-04,17,0,1,9,0,27
2346,2020-03-05,13,0,1,14,0,28
2347,2020-03-06,19,0,1,6,0,26
2348,2020-03-07,25,0,0,4,0,29
2349,2020-03-08,21,0,0,5,0,26
2350,2020-03-09,23,0,2,7,0,32
2351,2020-03-10,20,0,1,6,0,27
2352,2020-03-11,26,0,2,6,0,34
2353,2020-03-12,17,0,20,6,0,43
2354,2020-03-13,13,0,6,13,0,32
2355,2020-03-14,13,0,0,7,0,20
2356,2020-03-15,19,0,2,14,0,35
2357,2020-03-16,6,0,3,1,0,10
2358,2020-03-17,4,0,0,0,0,4
2359,2020-03-18,1,0,1,1,0,3
2360,2020-03-19,1,0,0,1,0,2
2361,2020-03-20,8,0,0,0,0,8
2362,2020-03-21,3,0,3,0,0,6
2363,2020-03-22,3,0,1,1,0,5
2364,2020-03-23,16,0,0,0,0,16
2365,2020-03-24,0,0,3,4,0,7
2366,2020-03-25,1,0,2,1,0,4
2367,2020-03-26,4,0,3,0,0,7
2368,2020-03-27,0,0,1,0,0,1
2369,2020-03-28,6,0,2,2,0,10
2370,2020-03-29,3,0,0,2,0,5
2371,2020-03-30,7,0,2,0,0,9
2372,2020-03-31,3,0,1,0,0,4
2373,2020-04-01,3,0,0,1,0,4
2374,2020-04-02,6,0,2,1,0,9
2375,2020-04-03,4,0,1,3,0,8
2376,2020-04-04,2,0,1,1,0,4
2377,2020-04-05,3,0,1,0,0,4
2378,2020-04-06,2,0,1,0,0,3
2379,2020-04-07,5,0,2,1,0,8
2380,2020-04-08,8,0,2,0,0,10
2381,2020-04-09,1,0,5,0,0,6
2382,2020-04-10,5,0,2,0,0,7
2383,2020-04-11,2,0,2,1,0,5
2384,2020-04-12,2,0,0,0,0,2
2385,2020-04-13,4,0,2,2,0,8
2386,2020-04-14,10,0,2,3,0,15
2387,2020-04-15,4,0,1,1,0,6
2388,2020-04-16,4,0,1,0,0,5
2389,2020-04-17,4,0,1,0,0,5
2390,2020-04-18,3,0,1,5,0,9
2391,2020-04-19,0,0,8,0,0,8
2392,2020-04-20,1,0,1,0,0,2
2393,2020-04-22,5,0,0,1,0,6
2394,2020-04-23,5,0,1,0,0,6
2395,2020-04-24,3,0,0,3,0,6
2396,2020-04-25,1,0,1,0,0,2
2397,2020-04-26,2,0,1,1,0,4
2398,2020-04-27,3,0,1,2,0,6
2399,2020-04-28,8,0,3,1,0,12
2400,2020-04-29,3,0,1,1,0,5
2401,2020-04-30,4,0,1,0,0,5
2402,2020-05-01,4,0,1,2,0,7
2403,2020-05-02,1,0,1,2,0,4
2404,2020-05-03,2,0,2,0,0,4
2405,2020-05-04,1,0,1,1,0,3
2406,2020-05-05,4,0,0,0,0,4
2407,2020-05-06,6,0,1,0,0,7
2408,2020-05-07,10,0,1,1,0,12
2409,2020-05-08,9,0,2,4,0,15
2410,2020-05-09,0,0,1,1,0,2
2411,2020-05-11,4,0,1,2,0,7
2412,2020-05-12,5,0,2,1,0,8
2413,2020-05-13,7,0,4,4,0,15
2414,2020-05-14,4,0,1,1,0,6
2415,2020-05-15,6,0,0,0,0,6
2416,2020-05-16,3,0,1,4,0,8
2417,2020-05-17,3,0,1,2,0,6
2418,2020-05-18,1,0,1,1,0,3
2419,2020-05-19,5,0,1,2,0,8
2420,2020-05-20,2,0,0,2,0,4
2421,2020-05-21,3,0,0,4,0,7
2422,2020-05-22,4,0,0,6,0,10
2423,2020-05-23,4,0,5,3,0,12
2424,2020-05-24,12,0,2,0,0,14
2425,2020-05-25,7,0,1,0,0,8
2426,2020-05-26,7,0,1,6,0,14
2427,2020-05-27,12,0,0,0,0,12
2428,2020-05-28,5,0,1,0,0,6
2429,2020-05-29,6,0,0,2,0,8
2430,2020-05-30,12,0,1,0,0,13
2431,2020-05-31,3,0,1,1,0,5
2432,2020-06-01,7,0,0,7,0,14
2433,2020-06-02,10,0,0,6,0,16
2434,2020-06-03,11,0,0,6,0,17
2435,2020-06-04,6,0,2,5,0,13
2436,2020-06-05,5,0,0,4,0,9
2437,2020-06-06,4,0,0,0,0,4
2438,2020-06-07,6,0,0,1,0,7
2439,2020-06-08,12,0,3,6,0,21
2440,2020-06-09,10,0,4,1,0,15
2441,2020-06-10,6,0,2,7,0,15
2442,2020-06-11,7,0,1,4,0,12
2443,2020-06-12,8,0,1,8,0,17
2444,2020-06-13,5,0,7,0,0,12
2445,2020-06-14,3,0,2,0,0,5
2446,2020-06-15,13,0,4,4,0,21
2447,2020-06-16,8,0,0,1,0,9
2448,2020-06-17,4,0,1,4,0,9
2449,2020-06-18,9,0,1,7,0,17
2450,2020-06-19,1,0,2,1,0,4
2451,2020-06-20,2,0,0,0,0,2
2452,2020-06-21,6,0,0,1,0,7
2453,2020-06-22,9,0,0,5,0,14
2454,2020-06-23,13,0,1,4,0,18
2455,2020-06-24,7,0,1,4,0,12
2456,2020-06-25,9,0,1,4,0,14
2457,2020-06-26,7,0,2,17,0,26
2458,2020-06-27,6,0,1,1,0,8
2459,2020-06-28,11,0,0,0,0,11
2460,2020-06-29,13,0,1,3,0,17
2461,2020-06-30,11,0,0,6,0,17
2462,2020-07-01,6,0,0,5,0,11
2463,2020-07-02,9,0,0,6,0,15
2464,2020-07-03,3,0,4,0,0,7
2465,2020-07-04,5,0,1,2,0,8
2466,2020-07-05,9,0,0,0,0,9
2467,2020-07-06,7,0,0,5,0,12
2468,2020-07-07,14,0,1,3,0,18
2469,2020-07-08,4,0,1,1,0,6
2470,2020-07-09,8,0,2,3,0,13
2471,2020-07-10,8,0,1,5,0,14
2472,2020-07-11,5,0,0,0,0,5
2473,2020-07-12,5,0,2,1,0,8
2474,2020-07-13,11,0,1,2,0,14
2475,2020-07-14,9,0,0,6,0,15
2476,2020-07-15,14,0,0,3,0,17
2477,2020-07-16,8,0,0,3,0,11
2478,2020-07-17,10,0,3,1,0,14
2479,2020-07-18,7,0,1,1,0,9
2480,2020-07-19,5,0,0,0,0,5
2481,2020-07-20,7,0,2,2,0,11
2482,2020-07-21,2,0,0,1,0,3
2483,2020-07-22,12,0,1,3,0,16
2484,2020-07-23,9,0,1,4,0,14
2485,2020-07-24,5,0,0,3,0,8
2486,2020-07-25,4,0,1,2,0,7
2487,2020-07-26,10,0,0,1,0,11
2488,2020-07-27,6,0,0,6,0,12
2489,2020-07-28,14,0,0,0,0,14
2490,2020-07-29,5,0,1,5,0,11
2491,2020-07-30,3,0,0,7,0,10
2492,2020-07-31,5,0,1,4,0,10
2493,2020-08-01,6,0,1,0,0,7
2494,2020-08-02,25,0,1,0,0,26
2495,2020-08-03,16,0,0,17,0,33
2496,2020-08-04,7,0,1,4,0,12
2497,2020-08-05,12,0,1,5,0,18
2498,2020-08-06,13,0,0,7,0,20
2499,2020-08-07,5,0,0,1,0,6
2500,2020-08-08,4,0,0,2,0,6
2501,2020-08-09,4,0,1,2,0,7
2502,2020-08-10,5,0,0,5,0,10
2503,2020-08-11,6,0,1,4,0,11
2504,2020-08-12,5,0,2,3,0,10
2505,2020-08-13,5,0,0,8,0,13
2506,2020-08-14,7,0,2,3,0,12
2507,2020-08-15,3,0,3,0,0,6
2508,2020-08-16,4,0,0,0,0,4
2509,2020-08-17,5,0,0,2,0,7
2510,2020-08-18,15,0,6,5,0,26
2511,2020-08-19,5,0,1,6,0,12
2512,2020-08-20,8,0,0,5,0,13
2513,2020-08-21,7,0,2,2,0,11
2514,2020-08-22,6,0,1,0,0,7
2515,2020-08-23,4,0,1,0,0,5
2516,2020-08-24,8,0,0,5,0,13
2517,2020-08-25,10,0,4,5,0,19
2518,2020-08-26,5,0,1,7,0,13
2519,2020-08-27,9,0,4,7,0,20
2520,2020-08-28,19,0,3,5,0,27
2521,2020-08-29,5,0,0,1,0,6
2522,2020-08-30,7,0,0,1,0,8
2523,2020-08-31,6,0,1,2,0,9
2524,2020-09-01,14,0,0,4,0,18
2525,2020-09-02,14,0,1,7,0,22
2526,2020-09-03,8,0,1,10,0,19
2527,2020-09-04,13,0,10,1,0,24
2528,2020-09-05,8,0,1,0,0,9
2529,2020-09-06,1,0,1,0,0,2
2530,2020-09-07,4,0,1,0,0,5
2531,2020-09-08,7,0,2,1,0,10
2532,2020-09-09,11,0,0,1,0,12
2533,2020-09-10,19,0,0,3,0,22
2534,2020-09-11,6,0,2,6,0,14
2535,2020-09-12,7,0,1,1,0,9
2536,2020-09-13,8,0,2,0,0,10
2537,2020-09-14,9,0,1,3,0,13
2538,2020-09-15,8,0,1,4,0,13
2539,2020-09-16,4,0,0,6,0,10
2540,2020-09-17,7,0,2,2,0,11
2541,2020-09-18,11,0,2,4,0,17
2542,2020-09-19,9,0,1,1,0,11
2543,2020-09-20,7,0,1,0,0,8
2544,2020-09-21,12,0,0,3,0,15
2545,2020-09-22,6,0,2,5,0,13
2546,2020-09-23,13,0,0,4,0,17
2547,2020-09-24,11,0,2,7,0,20
2548,2020-09-25,6,0,1,4,0,11
2549,2020-09-26,10,0,2,0,0,12
2550,2020-09-27,6,0,0,0,0,6
2551,2020-09-28,6,0,9,3,0,18
2552,2020-09-29,8,0,0,7,0,15
2553,2020-09-30,12,0,1,7,0,20
2554,2020-10-01,14,0,2,18,0,34
2555,2020-10-02,12,0,4,3,0,19
2556,2020-10-03,7,0,1,1,0,9
2557,2020-10-04,7,0,3,0,0,10
2558,2020-10-05,12,0,2,9,0,23
2559,2020-10-06,3,0,5,6,0,14
2560,2020-10-07,6,0,2,3,0,11
2561,2020-10-08,3,0,1,9,0,13
2562,2020-10-09,5,0,4,6,0,15
2563,2020-10-10,2,0,0,0,0,2
2564,2020-10-11,2,0,0,1,0,3
2565,2020-10-12,6,0,0,6,0,12
2566,2020-10-13,13,0,1,7,0,21
2567,2020-10-14,11,0,1,2,0,14
2568,2020-10-15,8,0,1,3,0,12
2569,2020-10-16,6,0,1,3,0,10
2570,2020-10-17,2,0,0,1,0,3
2571,2020-10-18,3,0,1,3,0,7
2572,2020-10-19,8,0,0,0,0,8
2573,2020-10-20,3,0,1,1,0,5
2574,2020-10-21,14,0,0,7,0,21
2575,2020-10-22,9,0,0,8,0,17
2576,2020-10-23,18,0,2,0,0,20
2577,2020-10-24,8,0,1,1,0,10
2578,2020-10-25,5,0,0,1,0,6
2579,2020-10-26,12,0,1,3,0,16
2580,2020-10-27,16,0,3,6,0,25
2581,2020-10-28,13,0,0,5,0,18
2582,2020-10-29,17,0,1,8,0,26
2583,2020-10-30,7,0,1,8,0,16
2584,2020-10-31,4,0,0,2,0,6
2585,2020-11-01,8,0,1,2,0,11
2586,2020-11-02,12,0,0,2,0,14
2587,2020-11-03,3,0,1,1,0,5
2588,2020-11-04,9,0,0,9,0,18
2589,2020-11-05,15,0,2,2,0,19
2590,2020-11-06,7,0,0,5,0,12
2591,2020-11-07,8,0,0,3,0,11
2592,2020-11-08,10,0,0,1,0,11
2593,2020-11-09,8,0,2,3,0,13
2594,2020-11-10,14,0,3,7,0,24
2595,2020-11-11,2,0,2,1,0,5
2596,2020-11-12,9,0,1,13,0,23
2597,2020-11-13,6,0,0,7,0,13
2598,2020-11-14,8,0,0,0,0,8
2599,2020-11-15,8,0,1,2,0,11
2600,2020-11-16,6,0,1,4,0,11
2601,2020-11-17,16,0,1,6,0,23
2602,2020-11-18,6,0,2,8,0,16
2603,2020-11-19,5,0,0,15,0,20
2604,2020-11-20,9,0,0,6,0,15
2605,2020-11-21,3,0,1,5,0,9
2606,2020-11-22,9,0,0,1,0,10
2607,2020-11-23,17,0,1,4,0,22
2608,2020-11-24,14,0,1,4,0,19
2609,2020-11-25,21,0,0,4,0,25
2610,2020-11-26,2,0,4,2,0,8
2611,2020-11-27,4,0,0,0,0,4
2612,2020-11-28,6,0,2,0,0,8
2613,2020-11-29,5,0,0,1,0,6
2614,2020-11-30,19,0,1,4,0,24
2615,2020-12-01,9,0,2,3,0,14
2616,2020-12-02,13,0,2,10,0,25
2617,2020-12-03,11,0,1,4,0,16
2618,2020-12-04,11,0,1,10,0,22
2619,2020-12-05,7,0,1,2,0,10
2620,2020-12-06,12,0,2,1,0,15
2621,2020-12-07,8,0,1,17,0,26
2622,2020-12-08,5,0,1,7,0,13
2623,2020-12-09,12,0,1,4,0,17
2624,2020-12-10,15,0,2,10,0,27
2625,2020-12-11,6,0,4,6,0,16
2626,2020-12-12,4,0,0,1,0,5
2627,2020-12-13,9,0,1,2,0,12
2628,2020-12-14,9,0,0,6,0,15
2629,2020-12-15,6,0,1,1,0,8
2630,2020-12-16,13,0,2,4,0,19
2631,2020-12-17,11,0,0,4,0,15
2632,2020-12-18,12,0,0,7,0,19
2633,2020-12-19,4,0,2,4,0,10
2634,2020-12-20,5,0,2,0,0,7
2635,2020-12-21,10,0,1,1,0,12
2636,2020-12-22,14,0,0,2,0,16
2637,2020-12-23,8,0,0,7,0,15
2638,2020-12-24,3,0,3,0,0,6
2639,2020-12-25,3,0,0,1,0,4
2640,2020-12-26,5,0,1,0,0,6
2641,2020-12-27,5,0,0,0,0,5
2642,2020-12-28,14,0,4,4,0,22
2643,2020-12-29,5,0,3,2,0,10
2644,2020-12-30,9,0,0,3,0,12
2645,2020-12-31,11,0,0,3,0,14
2646,2021-01-01,2,0,2,0,0,4
2647,2021-01-02,8,0,0,2,0,10
2648,2021-01-03,9,0,0,0,0,9
2649,2021-01-04,5,0,1,2,0,8
2650,2021-01-05,16,0,0,2,0,18
2651,2021-01-06,8,0,4,1,0,13
2652,2021-01-07,9,0,1,1,0,11
2653,2021-01-08,10,0,0,1,0,11
2654,2021-01-09,3,0,1,1,0,5
2655,2021-01-10,3,0,0,1,0,4
2656,2021-01-11,10,0,2,4,0,16
2657,2021-01-12,13,0,4,0,0,17
2658,2021-01-13,11,0,0,1,0,12
2659,2021-01-14,7,0,0,4,0,11
2660,2021-01-15,9,0,1,0,0,10
2661,2021-01-16,8,0,2,3,0,13
2662,2021-01-17,5,0,0,2,0,7
2663,2021-01-18,3,0,1,0,0,4
2664,2021-01-19,7,0,2,6,0,15
2665,2021-01-20,12,0,1,2,0,15
2666,2021-01-21,10,0,1,10,0,21
2667,2021-01-22,7,0,2,4,0,13
2668,2021-01-23,7,0,1,0,0,8
2669,2021-01-24,14,0,0,0,0,14
2670,2021-01-25,11,0,1,3,0,15
2671,2021-01-26,16,0,4,10,0,30
2672,2021-01-27,13,0,1,3,0,17
2673,2021-01-28,11,0,0,4,0,15
2674,2021-01-29,6,0,0,7,0,13
2675,2021-01-30,2,0,2,3,0,7
2676,2021-01-31,4,0,2,0,0,6
2677,2021-02-01,8,0,1,9,0,18
2678,2021-02-02,9,0,7,5,0,21
2679,2021-02-03,7,0,1,4,0,12
2680,2021-02-04,8,0,3,3,0,14
2681,2021-02-05,3,0,3,4,0,10
2682,2021-02-06,2,0,1,0,0,3
2683,2021-02-07,4,0,1,1,0,6
2684,2021-02-08,12,0,1,3,0,16
2685,2021-02-09,13,0,1,5,0,19
2686,2021-02-10,8,0,0,6,0,14
2687,2021-02-11,7,0,0,11,0,18
2688,2021-02-12,7,0,1,0,0,8
2689,2021-02-13,6,0,0,0,0,6
2690,2021-02-17,1,0,4,0,0,5
2691,2021-02-18,0,0,2,0,0,2
2692,2021-02-19,2,0,1,1,0,4
2693,2021-02-20,8,0,3,1,0,12
2694,2021-02-21,2,0,0,1,0,3
2695,2021-02-22,11,0,1,7,0,19
2696,2021-02-23,7,0,0,4,0,11
2697,2021-02-24,1,0,2,1,0,4
2698,2021-02-25,7,0,1,3,0,11
2699,2021-02-26,10,0,1,1,0,12
2700,2021-02-27,8,0,0,0,0,8
2701,2021-02-28,5,0,0,0,0,5
2702,2021-03-01,6,0,0,2,0,8
2703,2021-03-02,16,0,1,9,0,26
2704,2021-03-03,17,0,0,12,0,29
2705,2021-03-04,3,0,1,2,0,6
2706,2021-03-05,9,0,0,6,0,15
2707,2021-03-06,1,0,1,0,0,2
2708,2021-03-07,8,0,2,0,0,10
2709,2021-03-08,15,0,1,3,0,19
2710,2021-03-09,7,0,0,6,0,13
2711,2021-03-10,9,0,1,5,0,15
2712,2021-03-11,9,0,1,15,0,25
2713,2021-03-12,6,0,1,5,0,12
2714,2021-03-13,1,0,1,0,0,2
2715,2021-03-14,5,0,1,1,0,7
2716,2021-03-15,6,0,1,6,0,13
2717,2021-03-16,6,0,5,4,0,15
2718,2021-03-17,5,0,0,2,0,7
2719,2021-03-18,3,0,2,14,0,19
2720,2021-03-19,5,0,0,9,0,14
2721,2021-03-20,7,0,0,1,0,8
2722,2021-03-21,11,0,2,1,0,14
2723,2021-03-22,12,0,3,3,0,18
2724,2021-03-23,6,0,1,5,0,12
2725,2021-03-24,11,0,0,10,0,21
2726,2021-03-25,8,0,0,3,0,11
2727,2021-03-26,9,0,0,6,0,15
2728,2021-03-27,3,0,0,3,0,6
2729,2021-03-28,10,0,1,2,0,13
2730,2021-03-29,7,0,2,4,0,13
2731,2021-03-30,3,0,0,14,0,17
2732,2021-03-31,10,0,4,13,0,27
2733,2021-04-01,6,0,1,4,0,11
2734,2021-04-02,7,0,2,3,0,12
2735,2021-04-03,4,0,0,0,0,4
2736,2021-04-04,6,0,0,0,0,6
2737,2021-04-05,15,0,2,3,0,20
2738,2021-04-06,7,0,1,4,0,12
2739,2021-04-07,7,0,1,2,0,10
2740,2021-04-08,8,0,2,3,0,13
2741,2021-04-09,4,0,1,5,0,10
2742,2021-04-10,4,0,1,1,0,6
2743,2021-04-11,6,0,0,1,0,7
2744,2021-04-12,7,0,1,7,0,15
2745,2021-04-13,24,0,2,5,0,31
2746,2021-04-14,15,0,0,6,0,21
2747,2021-04-15,10,0,2,4,0,16
2748,2021-04-16,22,0,1,4,0,27
2749,2021-04-17,11,0,0,0,0,11
2750,2021-04-18,3,0,6,1,0,10
2751,2021-04-19,12,0,2,5,0,19
2752,2021-04-20,11,0,1,5,0,17
2753,2021-04-21,14,0,0,17,0,31
2754,2021-04-22,5,0,1,5,0,11
2755,2021-04-23,15,0,2,5,0,22
2756,2021-04-24,8,0,0,1,0,9
2757,2021-04-25,5,0,1,0,0,6
2758,2021-04-26,6,0,2,6,0,14
2759,2021-04-27,5,0,1,3,0,9
2760,2021-04-28,9,0,1,3,0,13
2761,2021-04-29,14,0,1,7,0,22
2762,2021-04-30,10,0,3,3,0,16
2763,2021-05-01,8,0,1,2,0,11
2764,2021-05-02,8,0,0,1,0,9
2765,2021-05-03,13,0,0,12,0,25
2766,2021-05-04,11,0,2,2,0,15
2767,2021-05-05,7,0,0,6,0,13
2768,2021-05-06,9,0,0,4,0,13
2769,2021-05-07,7,0,2,5,0,14
2770,2021-05-08,9,0,2,0,0,11
2771,2021-05-09,6,0,1,2,0,9
2772,2021-05-10,8,0,1,6,0,15
2773,2021-05-11,10,0,0,2,0,12
2774,2021-05-12,14,0,0,5,0,19
2775,2021-05-13,10,0,5,7,0,22
2776,2021-05-14,8,0,4,3,0,15
2777,2021-05-15,16,0,0,1,0,17
2778,2021-05-16,8,0,0,1,0,9
2779,2021-05-17,9,0,3,5,0,17
2780,2021-05-18,13,0,1,2,0,16
2781,2021-05-19,9,0,0,4,0,13
2782,2021-05-20,10,0,0,10,0,20
2783,2021-05-21,5,0,0,4,0,9
2784,2021-05-22,7,0,0,1,0,8
2785,2021-05-23,8,0,3,0,0,11
2786,2021-05-24,13,0,3,4,0,20
2787,2021-05-25,17,0,2,9,0,28
2788,2021-05-26,10,0,3,6,0,19
2789,2021-05-27,18,0,0,7,0,25
2790,2021-05-28,11,0,1,3,0,15
2791,2021-05-29,6,0,1,2,0,9
2792,2021-05-30,13,0,7,0,0,20
2793,2021-05-31,5,0,2,4,0,11
2794,2021-06-01,13,0,1,6,0,20
2795,2021-06-02,11,0,1,5,0,17
2796,2021-06-03,19,0,0,9,0,28
2797,2021-06-04,10,0,1,5,0,16
2798,2021-06-05,4,0,0,1,0,5
2799,2021-06-06,8,0,1,1,0,10
2800,2021-06-07,14,0,1,6,0,21
2801,2021-06-08,9,0,1,12,0,22
2802,2021-06-09,15,0,0,9,0,24
2803,2021-06-10,21,0,1,4,0,26
2804,2021-06-11,33,0,5,7,0,45
2805,2021-06-12,10,0,11,3,0,24
2806,2021-06-13,20,0,1,1,0,22
2807,2021-06-14,7,0,1,2,0,10
2808,2021-06-15,14,0,26,8,0,48
2809,2021-06-16,19,0,2,7,0,28
2810,2021-06-17,12,0,0,12,0,24
2811,2021-06-18,6,0,3,0,0,9
2812,2021-06-19,1,0,1,4,0,6
2813,2021-06-20,8,0,1,0,0,9
2814,2021-06-21,13,0,1,19,0,33
2815,2021-06-22,8,0,1,10,0,19
2816,2021-06-23,16,0,2,11,0,29
2817,2021-06-24,7,0,0,7,0,14
2818,2021-06-25,12,0,0,7,0,19
2819,2021-06-26,8,0,0,5,0,13
2820,2021-06-27,2,0,0,1,0,3
2821,2021-06-28,18,0,1,6,0,25
2822,2021-06-29,10,0,1,7,0,18
2823,2021-06-30,14,0,1,5,0,20
2824,2021-07-01,8,0,0,7,0,15
2825,2021-07-02,26,0,1,8,0,35
2826,2021-07-03,7,0,2,2,0,11
2827,2021-07-04,7,0,3,1,0,11
2828,2021-07-05,3,0,4,1,0,8
2829,2021-07-06,21,0,4,9,0,34
2830,2021-07-07,24,0,1,12,0,37
2831,2021-07-08,31,0,1,7,0,39
2832,2021-07-09,15,0,1,8,0,24
2833,2021-07-10,9,0,0,1,0,10
2834,2021-07-11,2,0,0,1,0,3
2835,2021-07-12,20,0,0,7,0,27
2836,2021-07-13,22,0,0,5,0,27
2837,2021-07-14,11,0,5,12,0,28
2838,2021-07-15,17,0,0,5,0,22
2839,2021-07-16,17,0,0,11,0,28
2840,2021-07-17,15,0,1,2,0,18
2841,2021-07-18,9,0,0,2,0,11
2842,2021-07-19,10,0,2,7,0,19
2843,2021-07-20,19,0,1,4,0,24
2844,2021-07-21,13,0,1,3,0,17
2845,2021-07-22,17,0,0,6,0,23
2846,2021-07-23,12,0,4,13,0,29
2847,2021-07-24,15,0,2,0,0,17
2848,2021-07-25,4,0,0,1,0,5
2849,2021-07-26,7,0,0,6,0,13
2850,2021-07-27,11,0,2,8,0,21
2851,2021-07-28,15,0,1,16,0,32
2852,2021-07-29,15,0,0,17,0,32
2853,2021-07-30,8,0,1,9,0,18
2854,2021-07-31,8,0,2,2,0,12
2855,2021-08-01,4,0,0,3,0,7
2856,2021-08-02,21,0,0,8,0,29
2857,2021-08-03,18,0,1,13,0,32
2858,2021-08-04,15,0,2,8,0,25
2859,2021-08-05,9,0,0,7,0,16
2860,2021-08-06,14,0,0,7,0,21
2861,2021-08-07,9,0,0,7,0,16
2862,2021-08-08,7,0,1,1,0,9
2863,2021-08-09,8,0,1,16,0,25
2864,2021-08-10,13,0,2,4,0,19
2865,2021-08-11,6,0,1,12,0,19
2866,2021-08-12,14,0,2,6,0,22
2867,2021-08-13,13,0,1,1,0,15
2868,2021-08-14,3,0,2,2,0,7
2869,2021-08-15,3,0,1,0,0,4
2870,2021-08-16,20,0,2,17,0,39
2871,2021-08-17,18,0,0,9,0,27
2872,2021-08-18,11,0,3,6,0,20
2873,2021-08-19,9,0,2,11,0,22
2874,2021-08-20,14,0,1,6,0,21
2875,2021-08-21,5,0,0,2,0,7
2876,2021-08-22,15,0,2,1,0,18
2877,2021-08-23,11,0,3,14,0,28
2878,2021-08-24,15,0,1,9,0,25
2879,2021-08-25,17,0,0,1,0,18
2880,2021-08-26,5,0,0,20,0,25
2881,2021-08-27,19,0,0,7,0,26
2882,2021-08-28,8,0,2,4,0,14
2883,2021-08-29,3,0,2,1,0,6
2884,2021-08-30,21,0,1,8,0,30
2885,2021-08-31,12,0,1,13,0,26
2886,2021-09-01,13,0,0,9,0,22
2887,2021-09-02,12,0,1,3,0,16
2888,2021-09-03,12,0,1,9,0,22
2889,2021-09-04,12,0,1,2,0,15
2890,2021-09-05,5,0,0,2,0,7
2891,2021-09-06,2,0,1,0,0,3
2892,2021-09-07,12,0,4,5,0,21
2893,2021-09-08,12,0,1,9,0,22
2894,2021-09-09,17,0,1,4,0,22
2895,2021-09-10,12,0,0,9,0,21
2896,2021-09-11,4,0,1,2,0,7
2897,2021-09-12,9,0,1,11,0,21
2898,2021-09-13,12,0,0,7,0,19
2899,2021-09-14,15,0,2,9,0,26
2900,2021-09-15,12,0,3,11,0,26
2901,2021-09-16,13,0,4,8,0,25
2902,2021-09-17,25,0,0,9,0,34
2903,2021-09-18,9,0,0,2,0,11
2904,2021-09-19,2,0,2,3,0,7
2905,2021-09-20,13,0,1,5,0,19
2906,2021-09-21,21,0,0,17,0,38
2907,2021-09-22,12,0,0,7,0,19
2908,2021-09-23,14,0,1,8,0,23
2909,2021-09-24,13,0,3,10,0,26
2910,2021-09-25,10,0,1,1,0,12
2911,2021-09-26,8,0,0,0,0,8
2912,2021-09-27,14,0,1,8,0,23
2913,2021-09-28,9,0,0,9,0,18
2914,2021-09-29,13,0,0,25,0,38
2915,2021-09-30,8,0,9,13,0,30
2916,2021-10-01,10,0,0,12,0,22
2917,2021-10-02,11,1,1,4,0,17
2918,2021-10-03,9,0,2,2,0,13
2919,2021-10-04,8,0,0,5,0,13
2920,2021-10-05,12,0,0,9,0,21
2921,2021-10-06,16,0,1,9,0,26
2922,2021-10-07,13,0,0,16,0,29
2923,2021-10-08,12,0,0,9,0,21
2924,2021-10-09,7,0,2,2,0,11
2925,2021-10-10,6,0,0,2,0,8
2926,2021-10-11,13,0,1,13,0,27
2927,2021-10-12,13,0,0,9,0,22
2928,2021-10-13,14,0,2,6,0,22
2929,2021-10-14,11,0,2,7,0,20
2930,2021-10-15,13,0,0,7,0,20
2931,2021-10-16,9,0,1,0,0,10
2932,2021-10-17,14,0,1,0,0,15
2933,2021-10-18,19,0,0,5,0,24
2934,2021-10-19,13,0,2,4,0,19
2935,2021-10-20,26,0,1,6,0,33
2936,2021-10-21,12,0,1,4,0,17
2937,2021-10-22,16,0,0,4,0,20
2938,2021-10-23,8,0,1,1,0,10
2939,2021-10-24,9,0,1,1,0,11
2940,2021-10-25,19,0,1,8,0,28
2941,2021-10-26,9,0,3,8,0,20
2942,2021-10-27,17,0,0,4,0,21
2943,2021-10-28,15,0,0,6,0,21
2944,2021-10-29,11,0,0,5,0,16
2945,2021-10-30,7,0,2,0,0,9
2946,2021-10-31,7,0,4,2,0,13
2947,2021-11-01,10,0,1,12,0,23
2948,2021-11-02,8,0,1,10,0,19
2949,2021-11-03,12,0,4,5,0,21
2950,2021-11-04,9,0,0,10,0,19
2951,2021-11-05,23,0,0,9,0,32
2952,2021-11-06,8,0,0,4,0,12
2953,2021-11-07,6,0,0,0,0,6
2954,2021-11-08,11,0,1,8,0,20
2955,2021-11-09,16,0,0,8,0,24
2956,2021-11-10,13,0,3,19,0,35
2957,2021-11-11,6,0,1,0,0,7
2958,2021-11-12,19,0,4,5,0,28
2959,2021-11-13,9,0,0,2,0,11
2960,2021-11-14,3,0,0,2,0,5
2961,2021-11-15,9,0,1,19,0,29
2962,2021-11-16,8,0,5,6,0,19
2963,2021-11-17,25,0,1,11,0,37
2964,2021-11-18,12,0,1,18,0,31
2965,2021-11-19,10,0,0,5,0,15
2966,2021-11-20,6,0,0,1,0,7
2967,2021-11-21,8,0,0,1,0,9
2968,2021-11-22,16,0,2,11,0,29
2969,2021-11-23,23,0,2,3,0,28
2970,2021-11-24,11,0,5,10,0,26
2971,2021-11-25,3,0,0,0,0,3
2972,2021-11-26,4,0,5,0,0,9
2973,2021-11-27,7,0,0,2,0,9
2974,2021-11-28,7,0,1,4,0,12
2975,2021-11-29,16,0,2,9,0,27
2976,2021-11-30,7,0,0,5,0,12
2977,2021-12-01,13,0,0,3,0,16
2978,2021-12-02,19,0,0,15,0,34
2979,2021-12-03,14,0,2,9,0,25
2980,2021-12-04,12,0,3,2,0,17
2981,2021-12-05,9,0,1,2,0,12
2982,2021-12-06,23,0,4,12,0,39
2983,2021-12-07,9,0,0,1,0,10
2984,2021-12-08,8,0,0,13,0,21
2985,2021-12-09,16,0,1,4,0,21
2986,2021-12-10,8,0,2,9,0,19
2987,2021-12-11,8,0,5,1,0,14
2988,2021-12-12,6,0,0,0,0,6
2989,2021-12-13,19,0,2,12,0,33
2990,2021-12-14,13,0,4,8,0,25
2991,2021-12-15,10,0,3,5,0,18
2992,2021-12-16,10,0,2,4,0,16
2993,2021-12-17,19,0,0,10,0,29
2994,2021-12-18,8,0,0,1,0,9
2995,2021-12-19,5,0,2,2,0,9
2996,2021-12-20,21,0,1,8,0,30
2997,2021-12-21,12,0,1,9,0,22
2998,2021-12-22,5,0,1,18,0,24
2999,2021-12-23,9,0,0,3,0,12
3000,2021-12-24,3,0,1,0,0,4
3001,2021-12-26,15,0,0,3,0,18
3002,2021-12-27,23,0,2,11,0,36
3003,2021-12-28,21,0,12,7,0,40
3004,2021-12-29,28,0,0,10,0,38
3005,2021-12-30,9,0,0,6,0,15
3006,2021-12-31,27,0,0,5,0,32
3007,2022-01-01,2,0,0,0,0,2
3008,2022-01-02,16,0,1,4,0,21
3009,2022-01-03,23,0,0,7,0,30
3010,2022-01-04,12,0,0,16,0,28
3011,2022-01-05,9,0,1,4,0,14
3012,2022-01-06,14,0,3,5,0,22
3013,2022-01-07,20,0,2,5,0,27
3014,2022-01-08,19,0,2,0,0,21
3015,2022-01-09,5,0,1,0,0,6
3016,2022-01-10,13,0,4,19,0,36
3017,2022-01-11,11,0,0,11,0,22
3018,2022-01-12,8,0,2,9,0,19
3019,2022-01-13,15,0,0,5,0,20
3020,2022-01-14,9,0,1,10,0,20
3021,2022-01-15,15,0,0,0,0,15
3022,2022-01-16,6,0,0,3,0,9
3023,2022-01-17,7,0,2,0,0,9
3024,2022-01-18,27,0,1,9,0,37
3025,2022-01-19,15,0,3,6,0,24
3026,2022-01-20,8,0,4,6,0,18
3027,2022-01-21,31,0,1,11,0,43
3028,2022-01-22,7,0,0,5,0,12
3029,2022-01-24,13,0,2,8,0,23
3030,2022-01-25,15,0,2,6,0,23
3031,2022-01-26,23,0,2,5,0,30
3032,2022-01-27,17,0,1,5,0,23
3033,2022-01-28,10,0,0,4,0,14
3034,2022-01-29,9,0,1,4,0,14
3035,2022-01-30,7,0,0,0,0,7
3036,2022-01-31,17,0,3,15,0,35
3037,2022-02-01,19,0,0,5,0,24
3038,2022-02-02,14,0,2,17,0,33
3039,2022-02-03,6,0,2,0,0,8
3040,2022-02-04,2,0,1,0,0,3
3041,2022-02-05,13,0,3,2,0,18
3042,2022-02-06,2,0,0,0,0,2
3043,2022-02-07,18,0,3,12,0,33
3044,2022-02-08,12,0,5,19,0,36
3045,2022-02-09,13,0,2,4,0,19
3046,2022-02-10,17,0,1,12,0,30
3047,2022-02-11,13,0,4,4,0,21
3048,2022-02-12,7,0,0,2,0,9
3049,2022-02-13,3,0,0,0,0,3
3050,2022-02-14,19,0,1,6,0,26
3051,2022-02-15,24,0,1,4,0,29
3052,2022-02-16,10,0,0,4,0,14
3053,2022-02-17,12,0,0,4,0,16
3054,2022-02-18,22,0,1,7,0,30
3055,2022-02-19,7,0,1,0,0,8
3056,2022-02-20,3,0,0,0,0,3
3057,2022-02-21,24,0,3,0,0,27
3058,2022-02-22,11,0,5,7,0,23
3059,2022-02-23,16,0,3,2,0,21
3060,2022-02-24,20,0,2,2,0,24
3061,2022-02-25,13,0,1,3,0,17
3062,2022-02-26,5,0,1,1,0,7
3063,2022-02-27,4,0,0,1,0,5
3064,2022-02-28,8,0,1,5,0,14
3065,2022-03-01,14,0,1,6,0,21
3066,2022-03-02,12,0,5,4,0,21
3067,2022-03-03,15,0,6,11,0,32
3068,2022-03-04,13,0,4,9,0,26
3069,2022-03-05,13,0,1,4,0,18
3070,2022-03-06,5,0,0,0,0,5
3071,2022-03-07,14,0,3,7,0,24
3072,2022-03-08,16,0,0,4,0,20
3073,2022-03-09,13,0,0,4,0,17
3074,2022-03-10,11,0,2,4,0,17
3075,2022-03-11,15,0,3,4,0,22
3076,2022-03-12,8,0,0,0,0,8
3077,2022-03-13,5,0,1,0,0,6
3078,2022-03-14,7,0,0,7,0,14
3079,2022-03-15,15,0,3,5,0,23
3080,2022-03-16,16,0,3,2,0,21
3081,2022-03-17,9,0,2,9,0,20
3082,2022-03-18,24,0,1,3,0,28
3083,2022-03-19,7,0,0,3,0,10
3084,2022-03-20,3,0,1,1,0,5
3085,2022-03-21,7,0,1,1,0,9
3086,2022-03-22,16,0,0,11,0,27
3087,2022-03-23,6,0,0,2,0,8
3088,2022-03-24,18,0,0,5,0,23
3089,2022-03-25,8,0,1,3,0,12
3090,2022-03-26,9,0,3,2,0,14
3091,2022-03-27,1,0,1,0,0,2
3092,2022-03-28,11,0,1,6,0,18
3093,2022-03-29,11,0,0,10,0,21
3094,2022-03-30,22,0,0,10,0,32
3095,2022-03-31,4,0,2,9,0,15
3096,2022-04-01,16,0,22,2,0,40
3097,2022-04-02,10,0,1,0,0,11
3098,2022-04-03,3,0,0,1,0,4
3099,2022-04-04,30,0,4,14,0,48
3100,2022-04-05,16,0,3,4,0,23
3101,2022-04-06,5,0,2,2,0,9
3102,2022-04-07,15,0,2,3,0,20
3103,2022-04-08,10,0,0,6,0,16
3104,2022-04-09,4,0,0,0,0,4
3105,2022-04-10,7,0,1,0,0,8
3106,2022-04-11,33,0,2,7,0,42
3107,2022-04-12,14,0,0,8,0,22
3108,2022-04-13,19,0,3,6,0,28
3109,2022-04-14,9,0,1,11,0,21
3110,2022-04-15,11,0,0,10,0,21
3111,2022-04-16,6,0,1,3,0,10
3112,2022-04-17,2,0,2,1,0,5
3113,2022-04-18,14,0,0,5,0,19
3114,2022-04-19,14,0,2,5,0,21
3115,2022-04-20,7,0,1,2,0,10
3116,2022-04-21,10,0,3,4,0,17
3117,2022-04-22,22,0,4,14,0,40
3118,2022-04-23,11,0,1,11,0,23
3119,2022-04-24,2,0,1,0,0,3
3120,2022-04-25,11,0,0,3,0,14
3121,2022-04-26,18,0,0,5,0,23
3122,2022-04-27,18,0,0,4,0,22
3123,2022-04-28,11,0,2,3,0,16
3124,2022-04-29,16,0,8,4,0,28
3125,2022-04-30,5,0,0,0,0,5
3126,2022-05-01,4,0,0,0,0,4
3127,2022-05-02,39,0,1,9,0,49
3128,2022-05-03,17,0,1,3,0,21
3129,2022-05-04,11,0,2,7,0,20
3130,2022-05-05,16,0,5,1,0,22
3131,2022-05-06,15,0,2,6,0,23
3132,2022-05-07,4,0,2,0,0,6
3133,2022-05-08,4,0,0,1,0,5
3134,2022-05-09,16,0,3,10,0,29
3135,2022-05-10,5,0,5,5,0,15
3136,2022-05-11,22,0,1,5,0,28
3137,2022-05-12,16,0,8,2,0,26
3138,2022-05-13,23,0,3,5,0,31
3139,2022-05-14,5,0,2,0,0,7
3140,2022-05-15,3,0,1,0,0,4
3141,2022-05-16,12,0,2,10,0,24
3142,2022-05-17,8,0,0,5,0,13
3143,2022-05-18,14,0,6,4,0,24
3144,2022-05-19,25,0,1,2,0,28
3145,2022-05-20,12,0,1,4,0,17
3146,2022-05-21,12,0,1,1,0,14
3147,2022-05-22,3,0,1,0,0,4
3148,2022-05-23,30,0,3,11,0,44
3149,2022-05-24,12,0,4,2,0,18
3150,2022-05-25,18,0,0,8,0,26
3151,2022-05-26,14,0,2,7,0,23
3152,2022-05-27,10,0,0,1,0,11
3153,2022-05-28,5,0,3,1,0,9
3154,2022-05-29,3,0,1,1,0,5
3155,2022-05-30,5,0,0,7,0,12
3156,2022-05-31,21,0,2,3,0,26
3157,2022-06-01,36,0,0,4,0,40
3158,2022-06-02,7,0,1,6,0,14
3159,2022-06-03,8,0,1,2,0,11
3160,2022-06-04,9,0,2,0,0,11
3161,2022-06-05,4,0,0,0,0,4
3162,2022-06-06,5,0,2,2,0,9
3163,2022-06-07,13,0,1,12,0,26
3164,2022-06-08,11,0,2,7,0,20
3165,2022-06-09,13,0,0,2,0,15
3166,2022-06-10,16,0,2,3,0,21
3167,2022-06-11,7,0,0,6,0,13
3168,2022-06-12,6,0,1,0,0,7
3169,2022-06-13,10,0,0,5,0,15
3170,2022-06-14,13,0,0,4,0,17
3171,2022-06-15,25,0,4,7,0,36
3172,2022-06-16,34,0,0,3,0,37
3173,2022-06-17,7,0,2,4,0,13
3174,2022-06-18,3,0,0,1,0,4
3175,2022-06-19,1,0,3,0,0,4
3176,2022-06-20,22,0,3,3,0,28
3177,2022-06-21,11,0,6,3,0,20
3178,2022-06-22,25,0,3,5,0,33
3179,2022-06-23,20,0,4,9,0,33
3180,2022-06-24,14,0,1,7,0,22
3181,2022-06-25,13,0,0,3,0,16
3182,2022-06-26,1,0,0,0,0,1
3183,2022-06-27,19,0,2,7,0,28
3184,2022-06-28,12,0,1,6,0,19
3185,2022-06-29,20,0,2,5,0,27
3186,2022-06-30,15,0,0,8,0,23
3187,2022-07-01,10,0,2,17,0,29
3188,2022-07-03,2,0,0,0,0,2
3189,2022-07-04,3,0,1,0,0,4
3190,2022-07-05,6,0,1,6,0,13
3191,2022-07-06,26,0,4,15,0,45
3192,2022-07-07,16,0,10,10,0,36
3193,2022-07-08,25,0,0,5,0,30
3194,2022-07-09,7,0,0,1,0,8
3195,2022-07-10,4,0,0,0,0,4
3196,2022-07-11,24,0,1,1,0,26
3197,2022-07-12,22,0,10,14,0,46
3198,2022-07-13,11,0,7,2,0,20
3199,2022-07-14,26,0,2,3,0,31
3200,2022-07-15,14,0,0,2,0,16
3201,2022-07-16,8,0,1,1,0,10
3202,2022-07-17,11,0,0,0,0,11
3203,2022-07-18,24,0,3,7,0,34
3204,2022-07-19,15,0,1,6,0,22
3205,2022-07-20,15,0,3,15,0,33
3206,2022-07-21,18,0,7,2,0,27
3207,2022-07-22,8,0,0,42,0,50
3208,2022-07-23,15,0,3,10,0,28
3209,2022-07-24,1,0,0,11,0,12
3210,2022-07-25,19,0,2,13,0,34
3211,2022-07-26,8,0,4,5,0,17
3212,2022-07-27,26,0,11,7,0,44
3213,2022-07-28,13,0,0,3,0,16
3214,2022-07-29,11,0,0,8,0,19
3215,2022-07-30,23,0,5,1,0,29
3216,2022-08-01,32,0,0,5,0,37
3217,2022-08-02,12,0,0,3,0,15
3218,2022-08-03,19,0,0,12,0,31
3219,2022-08-04,13,0,0,10,0,23
3220,2022-08-05,17,0,0,7,0,24
3221,2022-08-06,10,0,1,0,0,11
3222,2022-08-07,3,0,2,0,0,5
3223,2022-08-08,11,0,1,6,0,18
3224,2022-08-09,13,0,4,2,0,19
3225,2022-08-10,9,0,1,7,0,17
3226,2022-08-11,21,0,3,3,0,27
3227,2022-08-12,15,0,1,3,0,19
3228,2022-08-13,7,0,2,1,0,10
3229,2022-08-14,2,0,1,0,0,3
3230,2022-08-15,18,0,1,4,0,23
3231,2022-08-16,25,0,5,5,0,35
3232,2022-08-17,18,0,5,3,0,26
3233,2022-08-18,15,0,2,5,0,22
3234,2022-08-19,26,0,1,6,0,33
3235,2022-08-20,3,0,0,1,0,4
3236,2022-08-21,5,0,0,0,0,5
3237,2022-08-22,18,0,0,3,0,21
3238,2022-08-23,16,0,1,10,0,27
3239,2022-08-24,13,0,3,7,0,23
3240,2022-08-25,11,0,4,5,0,20
3241,2022-08-26,14,0,1,13,0,28
3242,2022-08-27,9,0,1,2,0,12
3243,2022-08-28,2,0,1,0,0,3
3244,2022-08-29,28,0,3,5,0,36
3245,2022-08-30,12,0,1,10,0,23
3246,2022-08-31,8,0,0,11,0,19
3247,2022-09-01,33,0,1,6,0,40
3248,2022-09-02,10,0,1,6,0,17
3249,2022-09-03,12,0,0,0,0,12
3250,2022-09-04,4,0,1,0,0,5
3251,2022-09-05,7,0,0,0,0,7
3252,2022-09-06,20,0,2,4,0,26
3253,2022-09-07,20,0,1,8,0,29
3254,2022-09-08,15,0,4,7,0,26
3255,2022-09-09,14,0,1,1,0,16
3256,2022-09-10,12,0,1,1,0,14
3257,2022-09-11,2,0,1,0,0,3
3258,2022-09-12,17,0,0,4,0,21
3259,2022-09-13,5,0,0,7,0,12
3260,2022-09-14,3,0,0,2,0,5
3261,2022-09-15,0,0,0,1,0,1
3262,2022-09-16,2,0,0,5,0,7
3263,2022-09-17,6,0,0,1,0,7
3264,2022-09-18,3,0,1,0,0,4
3265,2022-09-19,5,0,1,3,0,9
3266,2022-09-20,5,0,2,3,0,10
3267,2022-09-21,5,0,0,9,0,14
3268,2022-09-22,11,0,0,7,0,18
3269,2022-09-23,8,0,1,8,0,17
3270,2022-09-24,3,0,0,4,0,7
3271,2022-09-25,4,0,0,2,0,6
3272,2022-09-26,11,0,1,2,0,14
3273,2022-09-27,10,0,0,4,0,14
3274,2022-09-28,7,0,0,6,0,13
3275,2022-09-29,13,0,0,3,0,16
3276,2022-09-30,9,0,1,3,0,13
3277,2022-10-01,6,0,0,2,0,8
3278,2022-10-02,7,0,4,1,0,12
3279,2022-10-03,10,0,1,0,0,11
3280,2022-10-04,4,0,7,3,0,14
3281,2022-10-05,7,0,0,3,0,10
3282,2022-10-06,16,0,0,3,0,19
3283,2022-10-07,8,0,3,4,0,15
3284,2022-10-08,11,0,1,2,0,14
3285,2022-10-09,2,0,1,1,0,4
3286,2022-10-10,29,0,0,3,0,32
3287,2022-10-11,7,0,2,10,0,19
3288,2022-10-12,5,0,1,4,0,10
3289,2022-10-13,20,0,2,3,0,25
3290,2022-10-14,8,0,1,2,0,11
3291,2022-10-15,11,0,2,0,0,13
3292,2022-10-16,3,0,0,0,0,3
3293,2022-10-17,13,0,1,4,0,18
3294,2022-10-18,18,0,0,9,0,27
3295,2022-10-19,14,0,1,4,0,19
3296,2022-10-20,10,0,1,3,0,14
3297,2022-10-21,6,0,6,5,0,17
3298,2022-10-22,13,0,2,10,0,25
3299,2022-10-23,2,0,1,1,0,4
3300,2022-10-24,6,0,0,5,0,11
3301,2022-10-25,14,0,3,11,0,28
3302,2022-10-26,23,0,3,7,0,33
3303,2022-10-27,9,0,1,10,0,20
3304,2022-10-28,25,0,1,5,0,31
3305,2022-10-29,7,0,1,0,0,8
3306,2022-10-30,10,0,1,0,0,11
3307,2022-10-31,9,0,0,1,0,10
3308,2022-11-01,6,0,1,12,0,19
3309,2022-11-02,6,0,10,5,0,21
3310,2022-11-03,7,0,2,7,0,16
3311,2022-11-04,11,0,2,3,0,16
3312,2022-11-05,9,0,0,0,0,9
3313,2022-11-06,4,0,0,1,0,5
3314,2022-11-07,19,0,0,2,0,21
3315,2022-11-08,9,0,1,5,0,15
3316,2022-11-09,12,0,1,4,0,17
3317,2022-11-10,11,0,2,10,0,23
3318,2022-11-11,1,0,2,0,0,3
3319,2022-11-12,8,0,0,1,0,9
3320,2022-11-13,3,0,0,0,0,3
3321,2022-11-14,10,0,0,10,0,20
3322,2022-11-15,6,0,1,5,0,12
3323,2022-11-16,17,0,1,0,0,18
3324,2022-11-17,13,0,1,7,0,21
3325,2022-11-18,11,0,1,7,0,19
3326,2022-11-19,3,0,0,0,0,3
3327,2022-11-20,5,0,0,0,0,5
3328,2022-11-21,20,0,1,1,0,22
3329,2022-11-22,9,0,0,11,0,20
3330,2022-11-23,19,0,0,4,0,23
3331,2022-11-24,4,0,0,0,0,4
3332,2022-11-25,8,0,2,0,0,10
3333,2022-11-26,10,0,2,1,0,13
3334,2022-11-27,3,0,0,1,0,4
3335,2022-11-28,12,0,0,8,0,20
3336,2022-11-29,18,0,0,8,0,26
3337,2022-11-30,20,0,2,2,0,24
3338,2022-12-01,8,0,5,4,0,17
3339,2022-12-02,7,0,0,9,0,16
3340,2022-12-03,4,0,1,3,0,8
3341,2022-12-04,3,0,1,0,0,4
3342,2022-12-05,6,0,2,1,0,9
3343,2022-12-06,28,0,4,2,0,34
3344,2022-12-07,9,0,0,1,0,10
3345,2022-12-08,22,0,5,3,0,30
3346,2022-12-09,8,0,0,2,0,10
3347,2022-12-10,7,0,0,1,0,8
3348,2022-12-11,5,0,3,0,0,8
3349,2022-12-12,4,0,0,3,0,7
3350,2022-12-13,9,0,3,11,0,23
3351,2022-12-14,8,0,1,5,0,14
3352,2022-12-15,8,0,1,2,0,11
3353,2022-12-16,12,0,3,3,0,18
3354,2022-12-17,4,0,0,1,0,5
3355,2022-12-18,2,0,1,0,0,3
3356,2022-12-19,3,0,0,6,0,9
3357,2022-12-20,18,0,1,1,0,20
3358,2022-12-21,24,0,0,4,0,28
3359,2022-12-22,23,0,4,11,0,38
3360,2022-12-23,12,0,0,0,0,12
3361,2022-12-24,5,0,0,0,0,5
3362,2022-12-25,1,0,0,1,0,2
3363,2022-12-26,4,0,1,1,0,6
3364,2022-12-27,32,0,1,3,0,36
3365,2022-12-28,10,0,0,5,0,15
3366,2022-12-29,9,0,0,2,0,11
3367,2022-12-30,9,0,0,3,0,12
3368,2022-12-31,11,0,1,1,0,13
3369,2023-01-01,0,0,2,0,0,2
3370,2023-01-02,8,0,1,1,0,10
3371,2023-01-03,19,0,1,6,0,26
3372,2023-01-04,9,0,2,8,0,19
3373,2023-01-05,12,0,0,9,0,21
3374,2023-01-06,19,0,1,4,0,24
3375,2023-01-07,5,0,0,2,0,7
3376,2023-01-08,5,0,0,1,0,6
3377,2023-01-09,12,0,0,10,0,22
3378,2023-01-10,14,0,1,3,0,18
3379,2023-01-11,26,0,2,5,0,33
3380,2023-01-12,19,0,0,3,0,22
3381,2023-01-13,20,0,0,8,0,28
3382,2023-01-14,7,0,1,0,0,8
3383,2023-01-15,2,0,0,0,0,2
3384,2023-01-16,2,0,0,1,0,3
3385,2023-01-17,14,0,1,6,0,21
3386,2023-01-18,23,0,3,7,0,33
3387,2023-01-19,12,0,0,1,0,13
3388,2023-01-20,12,0,1,5,0,18
3389,2023-01-21,7,0,0,1,0,8
3390,2023-01-22,6,0,0,0,0,6
3391,2023-01-23,12,0,1,4,0,17
3392,2023-01-24,13,0,0,3,0,16
3393,2023-01-25,10,0,2,2,0,14
3394,2023-01-26,8,0,1,5,0,14
3395,2023-01-27,11,0,1,5,0,17
3396,2023-01-28,10,0,0,1,0,11
3397,2023-01-29,5,0,1,2,0,8
3398,2023-01-30,13,0,0,10,0,23
3399,2023-01-31,5,0,6,1,0,12
3400,2023-02-01,1,0,1,0,0,2
3401,2023-02-02,14,0,0,0,0,14
3402,2023-02-03,13,0,3,4,0,20
3403,2023-02-04,8,0,0,1,0,9
3404,2023-02-05,9,0,1,0,0,10
3405,2023-02-06,21,0,0,9,0,30
3406,2023-02-07,18,0,0,3,0,21
3407,2023-02-08,19,0,0,6,0,25
3408,2023-02-09,16,0,0,6,0,22
3409,2023-02-10,9,0,2,2,0,13
3410,2023-02-11,14,0,0,2,0,16
3411,2023-02-12,6,0,0,0,0,6
3412,2023-02-13,4,0,0,8,0,12
3413,2023-02-14,7,0,3,2,0,12
3414,2023-02-15,13,0,0,10,0,23
3415,2023-02-16,6,0,0,5,0,11
3416,2023-02-17,7,0,3,6,0,16
3417,2023-02-18,27,0,0,1,0,28
3418,2023-02-19,14,0,2,0,0,16
3419,2023-02-20,13,0,1,3,0,17
3420,2023-02-21,15,0,0,7,0,22
3421,2023-02-22,7,0,2,4,0,13
3422,2023-02-23,7,0,1,1,0,9
3423,2023-02-24,8,0,5,3,0,16
3424,2023-02-25,8,0,1,0,0,9
3425,2023-02-26,3,0,0,0,0,3
3426,2023-02-27,24,0,2,6,0,32
3427,2023-02-28,8,0,1,5,0,14
3428,2023-03-01,6,0,0,5,0,11
3429,2023-03-02,21,0,2,2,0,25
3430,2023-03-03,9,0,0,4,0,13
3431,2023-03-04,9,0,1,2,0,12
3432,2023-03-05,5,0,0,1,0,6
3433,2023-03-06,10,0,1,4,0,15
3434,2023-03-07,17,0,10,3,0,30
3435,2023-03-08,16,0,0,14,0,30
3436,2023-03-09,3,0,1,12,0,16
3437,2023-03-10,9,0,1,12,0,22
3438,2023-03-11,6,0,1,3,0,10
3439,2023-03-12,5,0,0,1,0,6
3440,2023-03-13,23,0,5,5,0,33
3441,2023-03-14,8,0,2,9,0,19
3442,2023-03-15,15,0,3,1,0,19
3443,2023-03-16,17,0,3,5,0,25
3444,2023-03-17,12,0,3,4,0,19
3445,2023-03-18,8,0,1,0,0,9
3446,2023-03-19,0,0,0,1,0,1
3447,2023-03-20,12,0,0,4,0,16
3448,2023-03-21,19,0,2,8,0,29
3449,2023-03-22,24,0,0,3,0,27
3450,2023-03-23,11,0,4,5,0,20
3451,2023-03-24,10,0,2,7,0,19
3452,2023-03-25,8,0,0,0,0,8
3453,2023-03-26,13,0,1,0,0,14
3454,2023-03-27,6,0,2,3,0,11
3455,2023-03-28,13,0,0,4,0,17
3456,2023-03-29,6,0,0,8,0,14
3457,2023-03-30,7,0,1,6,0,14
3458,2023-03-31,15,0,0,9,0,24
3459,2023-04-01,3,0,0,2,0,5
3460,2023-04-02,5,0,0,0,0,5
3461,2023-04-03,7,0,2,6,0,15
3462,2023-04-04,13,0,2,9,0,24
3463,2023-04-05,16,0,1,2,0,19
3464,2023-04-06,9,0,0,9,0,18
3465,2023-04-07,9,0,0,2,0,11
3466,2023-04-08,7,0,0,6,0,13
3467,2023-04-09,14,0,0,0,0,14
3468,2023-04-10,19,0,0,3,0,22
3469,2023-04-11,14,0,0,3,0,17
3470,2023-04-12,17,0,1,6,0,24
3471,2023-04-13,15,0,1,3,0,19
3472,2023-04-14,10,0,0,6,0,16
3473,2023-04-15,10,0,2,0,0,12
3474,2023-04-16,5,0,4,1,0,10
3475,2023-04-17,6,0,3,2,0,11
3476,2023-04-18,13,0,0,4,0,17
3477,2023-04-19,8,0,2,2,0,12
3478,2023-04-20,13,0,3,4,0,20
3479,2023-04-21,11,0,0,5,0,16
3480,2023-04-22,16,0,0,0,0,16
3481,2023-04-23,5,0,3,0,0,8
3482,2023-04-24,14,0,6,6,0,26
3483,2023-04-25,18,0,0,5,0,23
3484,2023-04-26,14,0,0,12,0,26
3485,2023-04-27,13,0,4,7,0,24
3486,2023-04-28,13,0,4,2,0,19
3487,2023-04-29,8,0,0,3,0,11
3488,2023-04-30,3,0,3,1,0,7
3489,2023-05-01,10,0,1,8,0,19
3490,2023-05-02,7,0,1,6,0,14
3491,2023-05-03,6,0,19,7,0,32
3492,2023-05-04,10,0,0,5,0,15
3493,2023-05-05,15,0,7,10,0,32
3494,2023-05-06,8,0,2,0,0,10
3495,2023-05-07,4,0,1,0,0,5
3496,2023-05-08,13,0,0,10,0,23
3497,2023-05-09,9,0,2,4,0,15
3498,2023-05-10,18,0,2,4,0,24
3499,2023-05-11,7,0,1,3,0,11
3500,2023-05-12,10,0,1,8,0,19
3501,2023-05-13,6,0,1,0,0,7
3502,2023-05-14,10,0,0,0,0,10
3503,2023-05-15,18,0,1,5,0,24
3504,2023-05-16,12,0,3,8,0,23
3505,2023-05-17,19,0,1,3,0,23
3506,2023-05-18,16,0,1,5,0,22
3507,2023-05-19,4,0,4,1,0,9
3508,2023-05-20,2,0,1,0,0,3
3509,2023-05-21,6,0,0,0,0,6
3510,2023-05-22,13,0,1,10,0,24
3511,2023-05-23,12,0,2,4,0,18
3512,2023-05-24,10,0,4,4,0,18
3513,2023-05-25,12,0,1,5,0,18
3514,2023-05-26,7,0,0,9,0,16
3515,2023-05-27,8,0,2,0,0,10
3516,2023-05-28,4,0,0,0,0,4
3517,2023-05-29,7,0,3,0,0,10
3518,2023-05-30,11,0,2,4,0,17
3519,2023-05-31,11,0,1,5,0,17
3520,2023-06-01,16,0,0,5,0,21
3521,2023-06-02,14,0,1,5,0,20
3522,2023-06-03,12,0,3,1,0,16
3523,2023-06-04,6,0,0,0,0,6
3524,2023-06-05,17,0,2,14,0,33
3525,2023-06-06,11,0,0,3,0,14
3526,2023-06-07,14,0,1,1,0,16
3527,2023-06-08,5,0,1,3,0,9
3528,2023-06-09,20,0,2,4,0,26
3529,2023-06-10,3,0,3,1,0,7
3530,2023-06-11,4,0,0,0,0,4
3531,2023-06-12,12,0,0,7,0,19
3532,2023-06-13,10,0,3,7,0,20
3533,2023-06-14,11,0,0,2,0,13
3534,2023-06-15,5,0,2,1,0,8
3535,2023-06-16,11,0,0,5,0,16
3536,2023-06-17,11,0,0,1,0,12
3537,2023-06-18,8,0,0,0,0,8
3538,2023-06-19,11,0,0,0,0,11
3539,2023-06-20,9,0,2,3,0,14
3540,2023-06-21,10,0,3,6,0,19
3541,2023-06-22,21,0,0,3,0,24
3542,2023-06-23,8,0,1,4,0,13
3543,2023-06-24,9,0,0,0,0,9
3544,2023-06-25,7,0,1,1,0,9
3545,2023-06-26,12,0,9,1,0,22
3546,2023-06-27,7,0,0,4,0,11
3547,2023-06-28,5,0,2,0,0,7
3548,2023-06-29,4,0,3,3,0,10
3549,2023-06-30,6,0,2,7,0,15
3550,2023-07-01,9,0,1,2,0,12
3551,2023-07-02,2,0,0,0,0,2
3552,2023-07-03,13,0,1,2,0,16
3553,2023-07-04,6,0,0,0,0,6
3554,2023-07-05,8,0,6,4,0,18
3555,2023-07-06,5,0,1,3,0,9
3556,2023-07-07,10,0,2,5,0,17
3557,2023-07-08,5,0,0,2,0,7
3558,2023-07-09,8,0,0,1,0,9
3559,2023-07-10,10,0,2,1,0,13
3560,2023-07-11,14,0,0,6,0,20
3561,2023-07-12,4,0,1,7,0,12
3562,2023-07-13,6,0,1,1,0,8
3563,2023-07-14,7,0,0,9,0,16
3564,2023-07-15,4,0,0,1,0,5
3565,2023-07-16,1,0,4,0,0,5
3566,2023-07-17,3,0,0,2,0,5
3567,2023-07-18,4,0,0,3,0,7
3568,2023-07-19,9,0,1,4,0,14
3569,2023-07-20,5,0,0,7,0,12
3570,2023-07-21,8,0,0,3,0,11
3571,2023-07-22,7,0,1,2,0,10
3572,2023-07-23,6,0,1,3,0,10
3573,2023-07-24,10,0,5,5,0,20
3574,2023-07-25,11,0,1,6,0,18
3575,2023-07-26,12,0,1,3,0,16
3576,2023-07-27,5,0,0,5,0,10
3577,2023-07-28,8,0,4,0,0,12
3578,2023-07-29,3,0,1,0,0,4
3579,2023-07-30,6,0,1,0,0,7
3580,2023-07-31,3,0,3,5,0,11
3581,2023-08-01,11,0,1,0,0,12
3582,2023-08-02,7,0,1,1,0,9
3583,2023-08-03,2,0,4,2,0,8
3584,2023-08-04,10,0,2,3,0,15
3585,2023-08-05,2,0,3,1,0,6
3586,2023-08-06,5,0,3,0,0,8
3587,2023-08-07,13,0,4,3,0,20
3588,2023-08-08,14,0,1,1,0,16
3589,2023-08-09,12,0,1,3,0,16
3590,2023-08-10,13,0,1,5,0,19
3591,2023-08-11,6,0,2,2,0,10
3592,2023-08-12,5,0,1,1,0,7
3593,2023-08-13,2,0,0,0,0,2
3594,2023-08-14,10,0,0,8,0,18
3595,2023-08-15,4,0,1,2,0,7
3596,2023-08-16,5,0,0,0,0,5
3597,2023-08-17,3,0,1,4,0,8
3598,2023-08-18,7,0,3,2,0,12
3599,2023-08-19,3,0,3,0,0,6
3600,2023-08-20,5,0,0,2,0,7
3601,2023-08-21,9,0,1,2,0,12
3602,2023-08-22,10,0,1,5,0,16
3603,2023-08-23,4,0,4,6,0,14
3604,2023-08-24,5,0,0,1,0,6
3605,2023-08-25,10,0,0,8,0,18
3606,2023-08-26,7,0,2,2,0,11
3607,2023-08-27,4,0,1,0,0,5
3608,2023-08-28,9,0,4,4,0,17
3609,2023-08-29,11,0,1,2,0,14
3610,2023-08-30,8,0,3,2,0,13
3611,2023-08-31,5,0,1,2,0,8
3612,2023-09-01,5,0,0,5,0,10
3613,2023-09-02,6,0,1,2,0,9
3614,2023-09-03,11,0,0,2,0,13
3615,2023-09-04,4,0,0,1,0,5
3616,2023-09-05,12,0,5,4,0,21
3617,2023-09-06,7,0,1,1,0,9
3618,2023-09-07,7,0,1,3,0,11
3619,2023-09-08,7,0,0,1,0,8
3620,2023-09-09,3,0,1,1,0,5
3621,2023-09-10,5,0,2,2,0,9
3622,2023-09-11,8,0,0,4,0,12
3623,2023-09-12,3,0,0,12,0,15
3624,2023-09-13,10,0,1,0,0,11
3625,2023-09-14,12,0,4,4,0,20
3626,2023-09-15,8,0,0,4,0,12
3627,2023-09-16,9,0,0,0,0,9
3628,2023-09-17,4,0,0,0,0,4
3629,2023-09-18,5,0,0,6,0,11
3630,2023-09-19,10,0,3,6,0,19
3631,2023-09-20,14,0,1,3,0,18
3632,2023-09-21,5,0,3,2,0,10
3633,2023-09-22,6,0,0,11,0,17
3634,2023-09-23,3,0,0,0,0,3
3635,2023-09-24,3,0,0,1,0,4
3636,2023-09-25,11,0,1,3,0,15
3637,2023-09-26,12,0,0,6,0,18
3638,2023-09-27,11,0,0,3,0,14
3639,2023-09-28,7,0,1,10,0,18
3640,2023-09-29,6,0,1,0,0,7
3641,2023-09-30,5,0,1,6,0,12
3642,2023-10-01,20,0,0,0,0,20
3643,2023-10-02,6,0,1,4,0,11
3644,2023-10-03,15,0,2,6,0,23
3645,2023-10-04,8,0,0,2,0,10
3646,2023-10-05,7,0,3,4,0,14
3647,2023-10-06,8,0,1,2,0,11
3648,2023-10-07,10,0,4,1,0,15
3649,2023-10-08,3,0,0,0,0,3
3650,2023-10-09,5,0,1,5,0,11
3651,2023-10-10,8,0,2,4,0,14
3652,2023-10-11,14,0,0,6,0,20
3653,2023-10-12,8,0,4,1,0,13
3654,2023-10-13,8,0,7,2,0,17
3655,2023-10-14,8,0,2,1,0,11
3656,2023-10-15,6,0,1,0,0,7
3657,2023-10-16,2,0,1,1,0,4
3658,2023-10-17,10,0,0,3,0,13
3659,2023-10-18,8,0,3,1,0,12
3660,2023-10-19,6,0,1,2,0,9
3661,2023-10-20,6,0,0,5,0,11
3662,2023-10-21,4,0,0,3,0,7
3663,2023-10-22,3,0,1,0,0,4
3664,2023-10-23,23,0,0,4,0,27
3665,2023-10-24,9,0,0,6,0,15
3666,2023-10-25,9,0,2,1,0,12
3667,2023-10-26,20,0,1,2,0,23
3668,2023-10-27,14,0,1,3,0,18
3669,2023-10-28,9,0,0,1,0,10
3670,2023-10-29,2,0,1,2,0,5
3671,2023-10-30,16,0,0,3,0,19
3672,2023-10-31,12,0,3,2,0,17
3673,2023-11-01,8,0,0,1,0,9
3674,2023-11-02,18,0,1,4,0,23
3675,2023-11-03,7,0,0,3,0,10
3676,2023-11-04,10,0,1,0,0,11
3677,2023-11-05,6,0,0,0,0,6
3678,2023-11-06,4,0,0,4,0,8
3679,2023-11-07,15,0,2,11,0,28
3680,2023-11-08,10,0,3,4,0,17
3681,2023-11-09,3,0,2,4,0,9
3682,2023-11-10,5,0,0,0,0,5
3683,2023-11-11,8,0,0,1,0,9
3684,2023-11-12,1,0,0,2,0,3
3685,2023-11-13,9,0,1,6,0,16
3686,2023-11-14,7,0,0,9,0,16
3687,2023-11-15,11,0,0,0,0,11
3688,2023-11-16,8,0,3,3,0,14
3689,2023-11-17,9,0,1,3,0,13
3690,2023-11-18,5,0,0,2,0,7
3691,2023-11-19,4,0,3,2,0,9
3692,2023-11-20,14,0,1,4,0,19
3693,2023-11-21,7,0,3,6,0,16
3694,2023-11-22,9,0,0,5,0,14
3695,2023-11-23,7,0,0,0,0,7
3696,2023-11-25,17,0,3,1,0,21
3697,2023-11-26,3,0,0,1,0,4
3698,2023-11-27,11,0,1,9,0,21
3699,2023-11-28,16,0,1,1,0,18
3700,2023-11-29,11,0,1,3,0,15
3701,2023-11-30,10,0,2,3,0,15
3702,2023-12-01,8,0,2,15,0,25
3703,2023-12-02,2,0,0,1,0,3
3704,2023-12-03,5,0,1,0,0,6
3705,2023-12-04,8,0,0,3,0,11
3706,2023-12-05,7,0,0,0,0,7
3707,2023-12-06,9,0,1,12,0,22
3708,2023-12-07,13,0,0,3,0,16
3709,2023-12-08,15,0,3,7,0,25
3710,2023-12-09,1,0,2,2,0,5
3711,2023-12-10,1,0,0,0,0,1
3712,2023-12-11,7,0,5,3,0,15
3713,2023-12-12,6,0,4,1,0,11
3714,2023-12-13,5,0,2,2,0,9
3715,2023-12-14,12,0,0,7,0,19
3716,2023-12-15,24,0,1,8,0,33
3717,2023-12-16,14,0,5,0,0,19
3718,2023-12-17,6,0,3,1,0,10
3719,2023-12-18,8,0,1,4,0,13
3720,2023-12-19,11,0,5,6,0,22
3721,2023-12-20,10,0,1,4,0,15
3722,2023-12-21,16,0,0,7,0,23
3723,2023-12-22,6,0,0,3,0,9
3724,2023-12-23,12,0,1,1,0,14
3725,2023-12-24,3,0,0,1,0,4
3726,2023-12-25,4,0,1,0,0,5
3727,2023-12-26,6,0,1,0,0,7
3728,2023-12-27,11,0,3,4,0,18
3729,2023-12-28,7,0,1,2,0,10
3730,2023-12-29,15,0,2,0,0,17
3731,2023-12-30,4,0,1,2,0,7
3732,2023-12-31,0,0,0,1,0,1
3733,2024-01-01,9,0,2,0,0,11
3734,2024-01-02,6,0,1,2,0,9
3735,2024-01-03,15,0,1,4,0,20
3736,2024-01-04,6,0,1,2,0,9
3737,2024-01-05,22,0,6,5,0,33
3738,2024-01-06,4,0,0,1,0,5
3739,2024-01-07,2,0,5,0,0,7
3740,2024-01-08,11,0,0,5,0,16
3741,2024-01-09,2,0,2,15,0,19
3742,2024-01-10,11,0,1,4,0,16
3743,2024-01-11,7,0,1,7,0,15
3744,2024-01-12,6,0,0,9,0,15
3745,2024-01-13,9,0,0,2,0,11
3746,2024-01-14,8,0,1,1,0,10
3747,2024-01-15,1,0,1,0,0,2
3748,2024-01-16,17,0,2,4,0,23
3749,2024-01-17,3,0,3,7,0,13
3750,2024-01-18,6,0,2,1,0,9
3751,2024-01-19,22,0,2,3,0,27
3752,2024-01-20,7,0,0,0,0,7
3753,2024-01-21,8,0,0,2,0,10
3754,2024-01-22,16,0,1,3,0,20
3755,2024-01-23,8,0,1,7,0,16
3756,2024-01-24,10,0,3,4,0,17
3757,2024-01-25,12,0,2,0,0,14
3758,2024-01-26,9,0,0,7,0,16
3759,2024-01-27,9,0,0,0,0,9
3760,2024-01-28,2,0,0,4,0,6
3761,2024-01-29,10,0,4,1,0,15
3762,2024-01-30,10,0,1,8,0,19
3763,2024-01-31,13,0,3,1,0,17
3764,2024-02-01,7,0,1,13,0,21
3765,2024-02-02,15,0,2,6,0,23
3766,2024-02-03,6,0,1,0,0,7
3767,2024-02-04,10,0,1,1,0,12
3768,2024-02-05,23,0,0,9,0,32
3769,2024-02-06,18,0,1,3,0,22
3770,2024-02-07,12,0,5,2,0,19
3771,2024-02-08,9,0,1,21,0,31
3772,2024-02-09,6,0,1,5,0,12
3773,2024-02-10,7,0,1,0,0,8
3774,2024-02-11,1,0,0,0,0,1
3775,2024-02-12,12,0,1,7,0,20
3776,2024-02-13,13,0,3,10,0,26
3777,2024-02-14,15,0,1,5,0,21
3778,2024-02-15,27,0,1,19,0,47
3779,2024-02-16,9,0,0,3,0,12
3780,2024-02-17,5,0,0,2,0,7
3781,2024-02-18,4,0,9,0,0,13
3782,2024-02-19,4,0,1,0,0,5
3783,2024-02-20,12,0,2,3,0,17
3784,2024-02-21,9,0,0,7,0,16
3785,2024-02-22,14,0,1,3,0,18
3786,2024-02-23,10,0,0,8,0,18
3787,2024-02-24,7,0,1,0,0,8
3788,2024-02-25,5,0,0,2,0,7
3789,2024-02-26,11,0,0,4,0,15
3790,2024-02-27,12,0,0,4,0,16
3791,2024-02-28,8,0,0,7,0,15
3792,2024-02-29,12,0,1,13,0,26
3793,2024-03-01,15,0,1,5,0,21
3794,2024-03-02,4,0,4,1,0,9
3795,2024-03-03,12,0,1,1,0,14
3796,2024-03-04,17,0,1,4,0,22
3797,2024-03-05,16,0,3,8,0,27
3798,2024-03-06,4,0,1,4,0,9
3799,2024-03-07,21,0,5,1,0,27
3800,2024-03-08,12,0,0,2,0,14
3801,2024-03-09,4,0,0,0,0,4
3802,2024-03-10,5,0,0,0,0,5
3803,2024-03-11,11,0,1,6,0,18
3804,2024-03-12,15,0,3,5,0,23
3805,2024-03-13,11,0,2,4,0,17
3806,2024-03-14,11,0,2,5,0,18
3807,2024-03-15,11,0,0,3,0,14
3808,2024-03-16,6,0,0,2,0,8
3809,2024-03-17,6,0,0,1,0,7
3810,2024-03-18,5,0,0,10,0,15
3811,2024-03-19,18,0,2,3,0,23
3812,2024-03-20,27,0,15,4,0,46
3813,2024-03-21,5,0,0,1,0,6
3814,2024-03-22,12,0,0,8,0,20
3815,2024-03-23,5,0,2,1,0,8
3816,2024-03-24,6,0,2,1,0,9
3817,2024-03-25,11,0,0,10,0,21
3818,2024-03-26,7,0,0,5,0,12
3819,2024-03-27,17,0,3,6,0,26
3820,2024-03-28,12,0,1,4,0,17
3821,2024-03-29,10,0,1,3,0,14
3822,2024-03-30,6,0,0,2,0,8
3823,2024-03-31,5,0,1,0,0,6
3824,2024-04-01,10,0,0,5,0,15
3825,2024-04-02,12,0,1,0,0,13
3826,2024-04-03,21,0,1,3,0,25
3827,2024-04-04,17,0,0,3,0,20
3828,2024-04-05,14,0,1,8,0,23
3829,2024-04-06,2,0,0,2,0,4
3830,2024-04-07,3,0,0,1,0,4
3831,2024-04-08,4,0,0,1,0,5
3832,2024-04-09,21,0,1,4,0,26
3833,2024-04-10,15,0,3,2,0,20
3834,2024-04-11,10,0,1,4,0,15
3835,2024-04-12,22,0,0,4,0,26
3836,2024-04-13,5,0,0,1,0,6
3837,2024-04-14,6,0,1,1,0,8
3838,2024-04-15,14,0,1,2,0,17
3839,2024-04-16,11,0,4,4,0,19
3840,2024-04-17,7,0,1,4,0,12
3841,2024-04-18,20,0,5,3,0,28
3842,2024-04-19,18,0,0,3,0,21
3843,2024-04-20,10,0,0,0,0,10
3844,2024-04-21,8,0,1,0,0,9
3845,2024-04-22,17,0,4,1,0,22
3846,2024-04-23,21,0,0,7,0,28
3847,2024-04-24,10,0,3,2,0,15
3848,2024-04-25,13,0,3,5,0,21
3849,2024-04-26,4,0,4,1,0,9
3850,2024-04-27,7,0,1,2,0,10
3851,2024-04-28,9,0,0,1,0,10
3852,2024-04-29,28,0,1,10,0,39
3853,2024-04-30,19,0,0,13,0,32
3854,2024-05-01,13,0,3,3,0,19
3855,2024-05-02,18,0,0,7,0,25
3856,2024-05-03,9,0,2,6,0,17
3857,2024-05-04,6,0,4,2,0,12
3858,2024-05-05,9,0,4,4,0,17
3859,2024-05-06,10,0,2,3,0,15
3860,2024-05-07,7,0,2,8,0,17
3861,2024-05-08,10,0,1,2,0,13
3862,2024-05-09,11,0,0,6,0,17
3863,2024-05-10,8,0,2,12,0,22
3864,2024-05-11,6,0,0,0,0,6
3865,2024-05-12,18,0,0,1,0,19
3866,2024-05-13,12,0,2,11,0,25
3867,2024-05-14,17,0,2,5,0,24
3868,2024-05-15,14,0,0,3,0,17
3869,2024-05-16,2,0,0,0,0,2
