,DateTime,Stray_Abandoned,Euthanasia_Req,Public_Assist,Owner_Surrender,Other,TotalIntakes
0,10/1/13,30,1,2,9,0,42
1,10/2/13,20,0,4,4,0,28
2,10/3/13,19,0,4,3,0,26
3,10/4/13,24,0,0,6,0,30
4,10/5/13,27,0,4,8,0,39
5,10/6/13,15,1,3,6,0,25
6,10/7/13,13,0,2,3,0,18
7,10/8/13,32,0,3,7,0,42
8,10/9/13,27,0,1,1,0,29
9,10/10/13,23,1,2,4,0,30
10,10/11/13,29,0,2,2,0,33
11,10/12/13,26,0,3,7,0,36
12,10/13/13,23,0,0,3,0,26
13,10/14/13,30,1,1,4,0,36
14,10/15/13,33,2,2,16,0,53
15,10/16/13,38,0,2,4,0,44
16,10/17/13,22,0,1,3,0,26
17,10/18/13,14,0,3,6,0,23
18,10/19/13,21,1,1,4,0,27
19,10/20/13,19,0,2,5,0,26
20,10/21/13,29,0,0,4,0,33
21,10/22/13,20,0,2,5,0,27
22,10/23/13,21,0,2,6,0,29
23,10/24/13,17,1,2,9,0,29
24,10/25/13,21,0,1,6,0,28
25,10/26/13,23,0,5,6,0,34
26,10/27/13,26,0,0,5,0,31
27,10/28/13,23,1,0,7,0,31
28,10/29/13,19,0,7,7,0,33
29,10/30/13,19,0,3,7,0,29
30,10/31/13,13,0,2,7,0,22
31,11/1/13,21,0,4,15,0,40
32,11/2/13,23,0,2,3,0,28
33,11/3/13,16,0,1,5,0,22
34,11/4/13,14,0,0,15,0,29
35,11/5/13,24,0,2,4,0,30
36,11/6/13,23,0,2,5,0,30
37,11/7/13,25,0,3,2,0,30
38,11/8/13,25,0,4,7,0,36
39,11/9/13,27,0,1,5,0,33
40,11/10/13,20,0,1,1,0,22
41,11/11/13,10,0,0,5,0,15
42,11/12/13,28,0,3,6,0,37
43,11/13/13,12,0,2,3,0,17
44,11/14/13,20,1,2,6,0,29
45,11/15/13,21,0,0,7,0,28
46,11/16/13,18,0,4,4,0,26
47,11/17/13,21,0,2,11,0,34
48,11/18/13,18,0,0,3,0,21
49,11/19/13,17,0,1,6,0,24
50,11/20/13,18,0,0,3,0,21
51,11/21/13,18,0,1,2,0,21
52,11/22/13,17,0,4,3,0,24
53,11/23/13,18,0,0,6,0,24
54,11/24/13,19,0,1,4,0,24
55,11/25/13,37,0,0,6,0,43
56,11/26/13,19,0,5,10,0,34
57,11/27/13,31,0,1,6,0,38
58,11/28/13,6,0,0,1,0,7
59,11/29/13,24,0,1,1,0,26
60,11/30/13,21,0,1,2,0,24
61,12/1/13,7,0,2,2,0,11
62,12/2/13,30,0,0,6,0,36
63,12/3/13,23,0,0,2,0,25
64,12/4/13,20,1,23,3,0,47
65,12/5/13,17,0,7,4,0,28
66,12/6/13,17,0,3,7,0,27
67,12/7/13,17,0,1,4,0,22
68,12/8/13,13,0,0,12,0,25
69,12/9/13,24,0,2,6,0,32
70,12/10/13,14,0,0,5,0,19
71,12/11/13,15,1,1,6,0,23
72,12/12/13,25,0,6,3,0,34
73,12/13/13,10,1,1,5,0,17
74,12/14/13,29,0,2,6,0,37
75,12/15/13,18,0,3,3,0,24
76,12/16/13,15,1,0,13,0,29
77,12/17/13,33,0,0,6,0,39
78,12/18/13,13,0,0,5,0,18
79,12/19/13,18,0,2,3,0,23
80,12/20/13,19,0,4,6,0,29
81,12/21/13,28,2,2,4,0,36
82,12/22/13,9,0,3,13,0,25
83,12/23/13,17,1,1,12,0,31
84,12/24/13,12,1,7,4,0,24
85,12/25/13,4,0,2,0,0,6
86,12/26/13,32,1,4,1,0,38
87,12/27/13,19,0,1,2,0,22
88,12/28/13,21,0,0,5,0,26
89,12/29/13,26,0,3,5,0,34
90,12/30/13,21,0,1,8,0,30
91,12/31/13,27,0,2,6,0,35
92,1/1/14,32,0,2,5,0,39
93,1/2/14,32,0,0,2,0,34
94,1/3/14,26,0,0,3,0,29
95,1/4/14,29,0,2,7,0,38
96,1/5/14,15,0,1,4,0,20
97,1/6/14,12,1,0,9,0,22
98,1/7/14,21,0,2,5,0,28
99,1/8/14,18,0,3,10,0,31
100,1/9/14,29,1,0,6,0,36
101,1/10/14,17,0,1,3,0,21
102,1/11/14,34,0,0,3,0,37
103,1/12/14,18,0,0,5,0,23
104,1/13/14,27,0,0,9,0,36
105,1/14/14,28,0,0,7,0,35
106,1/15/14,17,0,2,11,0,30
107,1/16/14,14,0,3,5,0,22
108,1/17/14,21,0,5,0,0,26
109,1/18/14,21,0,4,13,0,38
110,1/19/14,16,0,2,4,0,22
111,1/20/14,19,0,3,4,0,26
112,1/21/14,27,0,1,5,0,33
113,1/22/14,12,0,4,5,0,21
114,1/23/14,17,1,2,1,0,21
115,1/24/14,8,1,4,9,0,22
116,1/25/14,21,1,4,8,0,34
117,1/26/14,9,1,2,5,0,17
118,1/27/14,22,0,6,12,0,40
119,1/28/14,10,0,2,6,0,18
120,1/29/14,15,0,1,2,0,18
121,1/30/14,25,0,1,5,0,31
122,1/31/14,20,0,5,4,0,29
123,2/1/14,14,0,0,6,0,20
124,2/2/14,22,0,0,8,0,30
125,2/3/14,11,2,0,3,0,16
126,2/4/14,18,0,4,3,0,25
127,2/5/14,28,0,2,9,0,39
128,2/6/14,25,0,2,6,0,33
129,2/7/14,10,0,2,2,0,14
130,2/8/14,22,0,1,7,0,30
131,2/9/14,19,0,0,9,0,28
132,2/10/14,24,0,3,5,0,32
133,2/11/14,13,0,0,5,0,18
134,2/12/14,30,0,2,3,0,35
135,2/13/14,16,0,4,7,0,27
136,2/14/14,18,0,2,2,0,22
137,2/15/14,14,0,3,6,0,23
138,2/16/14,13,0,3,5,0,21
139,2/17/14,19,0,2,6,0,27
140,2/18/14,19,0,5,3,0,27
141,2/19/14,23,0,52,7,0,82
142,2/20/14,18,0,3,9,0,30
143,2/21/14,18,0,1,7,0,26
144,2/22/14,22,2,0,13,0,37
145,2/23/14,15,0,3,9,0,27
146,2/24/14,23,0,3,4,0,30
147,2/25/14,18,0,1,6,0,25
148,2/26/14,18,1,2,7,0,28
149,2/27/14,24,1,5,10,0,40
150,2/28/14,17,0,3,6,0,26
151,3/1/14,17,0,0,5,0,22
152,3/2/14,14,0,2,3,0,19
153,3/3/14,15,0,0,4,0,19
154,3/4/14,25,0,0,3,0,28
155,3/5/14,24,1,2,8,0,35
156,3/6/14,18,0,4,4,0,26
157,3/7/14,22,0,4,5,0,31
158,3/8/14,20,0,1,3,0,24
159,3/9/14,16,0,2,4,0,22
160,3/10/14,23,0,3,7,0,33
161,3/11/14,17,0,1,9,0,27
162,3/12/14,33,0,2,4,0,39
163,3/13/14,34,1,2,4,0,41
164,3/14/14,19,0,5,11,0,35
165,3/15/14,29,0,1,8,0,38
166,3/16/14,32,0,2,5,0,39
167,3/17/14,16,1,4,6,0,27
168,3/18/14,15,2,4,8,0,29
169,3/19/14,27,0,4,3,0,34
170,3/20/14,14,1,3,6,0,24
171,3/21/14,24,0,4,5,0,33
172,3/22/14,19,0,2,6,0,27
173,3/23/14,17,0,1,7,0,25
174,3/24/14,9,0,2,4,0,15
175,3/25/14,24,0,1,8,0,33
176,3/26/14,38,0,1,3,0,42
177,3/27/14,9,0,7,3,0,19
178,3/28/14,14,0,2,5,0,21
179,3/29/14,19,0,1,10,0,30
180,3/30/14,26,0,1,2,0,29
181,3/31/14,21,0,2,6,0,29
182,4/1/14,26,0,2,1,0,29
183,4/2/14,25,0,3,13,0,41
184,4/3/14,15,0,2,5,0,22
185,4/4/14,18,0,3,6,0,27
186,4/5/14,27,0,7,8,0,42
187,4/6/14,25,0,1,7,0,33
188,4/7/14,21,0,1,6,0,28
189,4/8/14,30,1,3,0,0,34
190,4/9/14,15,0,3,2,0,20
191,4/10/14,9,0,1,5,0,15
192,4/11/14,23,0,2,8,0,33
193,4/12/14,19,0,7,7,0,33
194,4/13/14,15,0,1,3,0,19
195,4/14/14,37,0,3,3,0,43
196,4/15/14,26,0,2,5,0,33
197,4/16/14,19,0,5,4,0,28
198,4/17/14,16,1,2,10,0,29
199,4/18/14,21,0,5,6,0,32
200,4/19/14,20,0,2,6,0,28
201,4/20/14,16,0,1,0,0,17
202,4/21/14,28,1,2,4,0,35
203,4/22/14,12,0,3,3,0,18
204,4/23/14,19,0,8,5,0,32
205,4/24/14,12,0,1,1,0,14
206,4/25/14,18,0,5,5,0,28
207,4/26/14,20,0,2,8,0,30
208,4/27/14,29,1,0,4,0,34
209,4/28/14,20,0,3,4,0,27
210,4/29/14,15,0,2,5,0,22
211,4/30/14,24,0,3,5,0,32
212,5/1/14,15,1,8,3,0,27
213,5/2/14,7,0,1,7,0,15
214,5/3/14,14,1,1,7,0,23
215,5/4/14,15,0,2,5,0,22
216,5/5/14,20,0,5,7,0,32
217,5/6/14,24,0,6,9,0,39
218,5/7/14,21,0,4,6,0,31
219,5/8/14,18,1,2,4,0,25
220,5/9/14,23,0,2,3,0,28
221,5/10/14,29,0,5,5,0,39
222,5/11/14,14,0,1,2,0,17
223,5/12/14,30,0,4,10,0,44
224,5/13/14,30,0,1,5,0,36
225,5/14/14,34,0,0,8,0,42
226,5/15/14,19,0,3,2,0,24
227,5/16/14,23,0,6,2,0,31
228,5/17/14,35,0,4,7,0,46
229,5/18/14,13,0,2,1,0,16
230,5/19/14,19,0,8,4,0,31
231,5/20/14,19,0,2,6,0,27
232,5/21/14,25,0,1,6,0,32
233,5/22/14,12,0,1,3,0,16
234,5/23/14,27,0,2,5,0,34
235,5/24/14,25,0,5,5,0,35
236,5/25/14,33,0,2,3,0,38
237,5/26/14,16,0,0,0,0,16
238,5/27/14,23,0,9,5,0,37
239,5/28/14,31,0,2,9,0,42
240,5/29/14,31,0,3,6,0,40
241,5/30/14,35,0,5,8,0,48
242,5/31/14,27,0,4,2,0,33
243,6/1/14,17,0,1,9,0,27
244,6/2/14,26,0,5,6,0,37
245,6/3/14,22,0,2,8,0,32
246,6/4/14,21,0,3,3,0,27
247,6/5/14,18,0,2,2,0,22
248,6/6/14,12,0,1,3,0,16
249,6/7/14,20,0,2,6,0,28
250,6/8/14,13,0,1,5,0,19
251,6/9/14,24,0,0,5,0,29
252,6/10/14,19,0,2,7,0,28
253,6/11/14,23,0,4,2,0,29
254,6/12/14,9,0,2,5,0,16
255,6/13/14,34,0,3,6,0,43
256,6/14/14,31,0,1,10,0,42
257,6/15/14,16,0,2,4,0,22
258,6/16/14,16,0,1,5,0,22
259,6/17/14,29,0,5,5,0,39
260,6/18/14,31,0,4,4,0,39
261,6/19/14,23,1,2,7,0,33
262,6/20/14,14,0,6,3,0,23
263,6/21/14,15,0,5,11,0,31
264,6/22/14,17,0,1,5,0,23
265,6/23/14,13,0,4,5,0,22
266,6/24/14,29,0,2,2,0,33
267,6/25/14,26,0,3,7,0,36
268,6/26/14,19,0,3,12,0,34
269,6/27/14,21,2,4,5,0,32
270,6/28/14,20,0,0,3,0,23
271,6/29/14,24,1,7,7,0,39
272,6/30/14,23,1,1,7,0,32
273,7/1/14,21,1,1,3,0,26
274,7/2/14,18,0,2,3,0,23
275,7/3/14,31,0,2,5,0,38
276,7/4/14,19,0,0,2,0,21
277,7/5/14,35,0,0,9,0,44
278,7/6/14,31,0,1,2,0,34
279,7/7/14,22,0,4,4,0,30
280,7/8/14,13,0,0,3,0,16
281,7/9/14,26,0,11,5,0,42
282,7/10/14,27,0,5,3,0,35
283,7/11/14,29,0,1,2,0,32
284,7/12/14,23,0,0,5,0,28
285,7/13/14,14,0,0,11,0,25
286,7/14/14,14,0,5,3,0,22
287,7/15/14,33,0,1,6,0,40
288,7/16/14,18,0,2,5,0,25
289,7/17/14,17,0,1,4,0,22
290,7/18/14,20,1,2,7,0,30
291,7/19/14,26,0,8,5,0,39
292,7/20/14,16,0,5,4,0,25
293,7/21/14,23,1,4,15,0,43
294,7/22/14,18,0,3,4,0,25
295,7/23/14,24,1,4,7,0,36
296,7/24/14,20,0,9,5,0,34
297,7/25/14,29,1,5,1,0,36
298,7/26/14,17,0,1,3,0,21
299,7/27/14,21,0,0,5,0,26
300,7/28/14,13,0,4,10,0,27
301,7/29/14,14,1,2,11,0,28
302,7/30/14,30,2,1,1,0,34
303,7/31/14,12,0,3,4,0,19
304,8/1/14,15,1,5,6,0,27
305,8/2/14,25,1,0,4,0,30
306,8/3/14,24,0,3,3,0,30
307,8/4/14,24,1,1,8,0,34
308,8/5/14,14,1,1,5,0,21
309,8/6/14,25,0,2,0,0,27
310,8/7/14,25,0,1,7,0,33
311,8/8/14,16,1,3,6,0,26
312,8/9/14,22,0,2,13,0,37
313,8/10/14,18,0,1,6,0,25
314,8/11/14,17,0,4,3,0,24
315,8/12/14,29,1,0,9,0,39
316,8/13/14,15,0,5,4,0,24
317,8/14/14,23,0,3,6,0,32
318,8/15/14,22,0,2,11,0,35
319,8/16/14,17,0,2,3,0,22
320,8/17/14,13,0,1,5,0,19
321,8/18/14,16,0,4,6,0,26
322,8/19/14,20,0,3,4,0,27
323,8/20/14,13,0,5,3,0,21
324,8/21/14,25,0,3,5,0,33
325,8/22/14,10,0,0,1,0,11
326,8/23/14,17,0,3,4,0,24
327,8/24/14,19,0,0,13,0,32
328,8/25/14,24,1,1,4,0,30
329,8/26/14,11,0,3,7,0,21
330,8/27/14,19,0,0,7,0,26
331,8/28/14,21,0,2,2,0,25
332,8/29/14,22,0,3,4,0,29
333,8/30/14,27,0,1,3,0,31
334,8/31/14,11,0,4,5,0,20
335,9/1/14,19,0,3,6,0,28
336,9/2/14,19,0,5,20,0,44
337,9/3/14,26,0,2,5,0,33
338,9/4/14,32,0,1,7,0,40
339,9/5/14,14,1,8,3,0,26
340,9/6/14,23,0,4,1,0,28
341,9/7/14,22,0,4,7,0,33
342,9/8/14,13,0,1,9,0,23
343,9/9/14,15,0,3,4,0,22
344,9/10/14,20,0,1,19,0,40
345,9/11/14,11,0,2,6,0,19
346,9/12/14,21,0,2,4,0,27
347,9/13/14,21,0,4,2,0,27
348,9/14/14,21,1,1,7,0,30
349,9/15/14,28,1,2,7,0,38
350,9/16/14,20,1,1,12,0,34
351,9/17/14,18,0,1,10,0,29
352,9/18/14,32,0,2,3,0,37
353,9/19/14,33,1,4,12,0,50
354,9/20/14,34,0,1,3,0,38
355,9/21/14,20,0,0,3,0,23
356,9/22/14,35,0,2,3,0,40
357,9/23/14,17,0,2,8,0,27
358,9/24/14,15,1,5,3,0,24
359,9/25/14,19,0,1,6,0,26
360,9/26/14,19,0,0,4,0,23
361,9/27/14,17,0,2,3,0,22
362,9/28/14,11,0,1,13,0,25
363,9/29/14,25,0,2,1,0,28
364,9/30/14,20,0,2,11,0,33
365,10/1/14,30,0,1,2,0,33
366,10/2/14,23,0,4,5,0,32
367,10/3/14,21,0,1,6,0,28
368,10/4/14,26,1,3,4,0,34
369,10/5/14,11,1,6,2,0,20
370,10/6/14,18,0,1,4,0,23
371,10/7/14,22,0,5,4,0,31
372,10/8/14,21,0,1,2,0,24
373,10/9/14,24,1,3,7,0,35
374,10/10/14,21,2,1,2,0,26
375,10/11/14,15,2,4,3,0,24
376,10/12/14,13,1,3,1,0,18
377,10/13/14,21,0,4,3,0,28
378,10/14/14,25,0,3,6,0,34
379,10/15/14,19,0,2,4,0,25
380,10/16/14,25,0,1,5,0,31
381,10/17/14,16,0,1,4,0,21
382,10/18/14,19,1,4,4,0,28
383,10/19/14,16,0,2,7,0,25
384,10/20/14,9,0,2,6,0,17
385,10/21/14,27,2,1,8,0,38
386,10/22/14,20,0,3,6,0,29
387,10/23/14,17,1,3,9,0,30
388,10/24/14,21,0,2,4,0,27
389,10/25/14,20,0,4,9,0,33
390,10/26/14,9,0,0,12,0,21
391,10/27/14,19,0,1,11,0,31
392,10/28/14,28,0,2,4,0,34
393,10/29/14,24,0,2,5,0,31
394,10/30/14,14,0,4,3,0,21
395,10/31/14,18,0,1,2,0,21
396,11/1/14,16,0,2,5,0,23
397,11/2/14,17,0,3,5,0,25
398,11/3/14,25,2,2,10,0,39
399,11/4/14,19,0,2,3,0,24
400,11/5/14,14,0,2,5,0,21
401,11/6/14,15,0,6,5,0,26
402,11/7/14,28,0,0,3,0,31
403,11/8/14,37,0,1,13,0,51
404,11/9/14,16,0,0,2,0,18
405,11/10/14,25,1,6,4,0,36
406,11/11/14,22,0,2,7,0,31
407,11/12/14,15,0,4,4,0,23
408,11/13/14,16,0,6,5,0,27
409,11/14/14,30,0,0,3,0,33
410,11/15/14,17,0,3,2,0,22
411,11/16/14,12,0,2,3,0,17
412,11/17/14,19,0,2,5,0,26
413,11/18/14,16,1,0,8,0,25
414,11/19/14,19,2,0,13,0,34
415,11/20/14,25,1,1,8,0,35
416,11/21/14,33,0,0,7,0,40
417,11/22/14,29,0,2,4,0,35
418,11/23/14,33,0,3,4,0,40
419,11/24/14,15,0,2,3,0,20
420,11/25/14,18,0,1,2,0,21
421,11/26/14,21,0,3,3,0,27
422,11/27/14,5,0,1,1,0,7
423,11/28/14,24,1,3,4,0,32
424,11/29/14,22,0,0,11,0,33
425,11/30/14,15,1,1,8,0,25
426,12/1/14,23,0,5,8,0,36
427,12/2/14,24,1,1,3,0,29
428,12/3/14,23,0,3,7,0,33
429,12/4/14,19,0,3,4,0,26
430,12/5/14,28,0,1,13,0,42
431,12/6/14,19,0,0,6,0,25
432,12/7/14,28,1,2,10,0,41
433,12/8/14,21,1,2,10,0,34
434,12/9/14,18,0,3,2,0,23
435,12/10/14,19,0,2,15,0,36
436,12/11/14,16,0,0,5,0,21
437,12/12/14,29,0,4,3,0,36
438,12/13/14,17,1,2,15,0,35
439,12/14/14,30,1,1,2,0,34
440,12/15/14,29,0,3,5,0,37
441,12/16/14,23,0,2,3,0,28
442,12/17/14,12,0,10,5,0,27
443,12/18/14,25,2,3,5,0,35
444,12/19/14,20,0,3,6,0,29
445,12/20/14,15,0,0,6,0,21
446,12/21/14,15,0,0,5,0,20
447,12/22/14,22,1,1,3,0,27
448,12/23/14,15,0,1,9,0,25
449,12/24/14,13,0,1,5,0,19
450,12/25/14,15,0,1,0,0,16
451,12/26/14,11,0,0,5,0,16
452,12/27/14,20,0,2,3,0,25
453,12/28/14,19,1,2,9,0,31
454,12/29/14,29,0,1,7,0,37
455,12/30/14,18,1,1,7,0,27
456,12/31/14,18,1,1,1,0,21
457,1/1/15,17,0,0,6,0,23
458,1/2/15,22,0,1,2,0,25
459,1/3/15,16,0,0,10,0,26
460,1/4/15,15,0,1,6,0,22
461,1/5/15,35,0,1,3,0,39
462,1/6/15,28,0,0,6,0,34
463,1/7/15,29,0,2,6,0,37
464,1/8/15,14,0,0,5,0,19
465,1/9/15,12,1,1,2,0,16
466,1/10/15,19,0,2,5,0,26
467,1/11/15,27,0,0,5,0,32
468,1/12/15,14,0,3,7,0,24
469,1/13/15,23,0,1,2,0,26
470,1/14/15,18,0,1,13,0,32
471,1/15/15,13,0,3,9,0,25
472,1/16/15,15,0,5,3,0,23
473,1/17/15,20,0,1,4,0,25
474,1/18/15,23,0,1,10,0,34
475,1/19/15,15,1,2,8,0,26
476,1/20/15,18,1,5,6,0,30
477,1/21/15,16,0,1,10,0,27
478,1/22/15,14,0,2,6,0,22
479,1/23/15,17,0,2,3,0,22
480,1/24/15,27,0,2,2,0,31
481,1/25/15,18,1,1,14,0,34
482,1/26/15,28,0,0,10,0,38
483,1/27/15,22,0,2,8,0,32
484,1/28/15,25,0,5,4,0,34
485,1/29/15,16,0,4,5,0,25
486,1/30/15,24,0,2,9,0,35
487,1/31/15,16,0,2,4,0,22
488,2/1/15,21,0,1,12,0,34
489,2/2/15,15,0,1,4,0,20
490,2/3/15,19,0,0,4,0,23
491,2/4/15,25,0,5,4,0,34
492,2/5/15,13,1,0,7,0,21
493,2/6/15,19,0,3,5,0,27
494,2/7/15,21,1,1,11,0,34
495,2/8/15,16,1,4,3,0,24
496,2/9/15,18,0,1,4,0,23
497,2/10/15,18,0,1,5,0,24
498,2/11/15,22,1,5,8,0,36
499,2/12/15,28,0,4,2,0,34
500,2/13/15,22,0,3,11,0,36
501,2/14/15,16,0,8,5,0,29
502,2/15/15,24,1,0,4,0,29
503,2/16/15,24,0,2,6,0,32
504,2/17/15,14,0,1,8,0,23
505,2/18/15,20,0,2,9,0,31
506,2/19/15,35,0,0,5,0,40
507,2/20/15,22,1,2,7,0,32
508,2/21/15,17,1,3,9,0,30
509,2/22/15,19,0,1,5,0,25
510,2/23/15,20,1,1,6,0,28
511,2/24/15,18,0,3,2,0,23
512,2/25/15,31,0,9,5,0,45
513,2/26/15,20,0,3,8,0,31
514,2/27/15,13,0,1,10,0,24
515,2/28/15,13,0,3,5,0,21
516,3/1/15,7,0,1,2,0,10
517,3/2/15,21,0,3,7,0,31
518,3/3/15,7,0,1,4,0,12
519,3/4/15,18,0,6,10,0,34
520,3/5/15,12,0,2,4,0,18
521,3/6/15,35,0,3,6,0,44
522,3/7/15,27,0,3,4,0,34
523,3/8/15,8,0,2,5,0,15
524,3/9/15,8,0,1,3,0,12
525,3/10/15,28,0,3,4,0,35
526,3/11/15,25,0,2,6,0,33
527,3/12/15,22,0,5,3,0,30
528,3/13/15,24,2,4,9,0,39
529,3/14/15,13,0,1,4,0,18
530,3/15/15,18,0,12,5,0,35
531,3/16/15,14,1,7,4,0,26
532,3/17/15,24,0,3,9,0,36
533,3/18/15,29,0,3,3,0,35
534,3/19/15,26,0,3,4,0,33
535,3/20/15,21,0,3,3,0,27
536,3/21/15,13,0,2,8,0,23
537,3/22/15,21,0,1,5,0,27
538,3/23/15,20,0,1,6,0,27
539,3/24/15,31,0,1,6,0,38
540,3/25/15,29,0,1,2,0,32
541,3/26/15,22,0,2,4,0,28
542,3/27/15,15,0,3,3,0,21
543,3/28/15,18,0,4,3,0,25
544,3/29/15,24,0,1,7,0,32
545,3/30/15,18,1,7,4,0,30
546,3/31/15,14,0,1,2,0,17
547,4/1/15,14,1,3,3,0,21
548,4/2/15,15,1,3,34,0,53
549,4/3/15,16,0,7,10,0,33
550,4/4/15,26,1,2,3,0,32
551,4/5/15,12,0,1,7,0,20
552,4/6/15,18,0,1,4,0,23
553,4/7/15,17,0,3,6,0,26
554,4/8/15,20,0,7,4,0,31
555,4/9/15,21,0,1,3,0,25
556,4/10/15,27,0,1,6,0,34
557,4/11/15,23,0,1,5,0,29
558,4/12/15,16,0,7,8,0,31
559,4/13/15,23,0,4,4,0,31
560,4/14/15,15,0,4,6,0,25
561,4/15/15,15,1,1,4,0,21
562,4/16/15,20,0,4,7,0,31
563,4/17/15,19,0,6,12,0,37
564,4/18/15,21,0,3,5,0,29
565,4/19/15,12,0,5,6,0,23
566,4/20/15,28,3,1,5,0,37
567,4/21/15,22,0,3,5,0,30
568,4/22/15,27,0,1,5,0,33
569,4/23/15,14,0,1,9,0,24
570,4/24/15,28,0,5,15,0,48
571,4/25/15,18,0,1,3,0,22
572,4/26/15,19,0,3,5,0,27
573,4/27/15,20,0,1,4,0,25
574,4/28/15,28,0,7,2,0,37
575,4/29/15,23,0,5,8,0,36
576,4/30/15,16,0,2,7,0,25
577,5/1/15,24,0,2,4,0,30
578,5/2/15,21,0,7,0,0,28
579,5/3/15,10,0,3,7,0,20
580,5/4/15,24,0,1,10,0,35
581,5/5/15,14,0,2,5,0,21
582,5/6/15,30,0,2,2,0,34
583,5/7/15,21,0,3,5,0,29
584,5/8/15,18,0,1,4,0,23
585,5/9/15,23,0,3,6,0,32
586,5/10/15,18,0,1,5,0,24
587,5/11/15,27,0,0,4,0,31
588,5/12/15,25,0,2,6,0,33
589,5/13/15,18,0,2,5,0,25
590,5/14/15,31,1,4,7,0,43
591,5/15/15,26,0,3,4,0,33
592,5/16/15,27,0,3,11,0,41
593,5/17/15,28,0,2,6,0,36
594,5/18/15,32,0,1,6,0,39
595,5/19/15,21,0,2,12,0,35
596,5/20/15,20,0,4,6,0,30
597,5/21/15,26,0,1,1,0,28
598,5/22/15,29,0,0,5,0,34
599,5/23/15,27,0,4,5,0,36
600,5/24/15,31,0,4,3,0,38
601,5/25/15,23,0,3,3,0,29
602,5/26/15,14,0,3,0,0,17
603,5/27/15,32,0,5,9,0,46
604,5/28/15,38,0,2,4,0,44
605,5/29/15,20,0,10,7,0,37
606,5/30/15,24,0,2,3,0,29
607,5/31/15,17,0,2,9,0,28
608,6/1/15,28,1,6,7,0,42
609,6/2/15,28,0,7,5,0,40
610,6/3/15,35,0,1,10,0,46
611,6/4/15,15,0,3,14,0,32
612,6/5/15,34,0,2,6,0,42
613,6/6/15,25,0,2,6,0,33
614,6/7/15,26,1,1,5,0,33
615,6/8/15,19,0,1,8,0,28
616,6/9/15,16,0,3,6,0,25
617,6/10/15,8,0,3,6,0,17
618,6/11/15,20,0,5,3,0,28
619,6/12/15,20,1,8,0,0,29
620,6/13/15,19,0,8,9,0,36
621,6/14/15,26,0,3,3,0,32
622,6/15/15,16,0,6,9,0,31
623,6/16/15,21,0,5,2,0,28
624,6/17/15,19,0,4,4,0,27
625,6/18/15,28,0,5,3,0,36
626,6/19/15,28,0,2,11,0,41
627,6/20/15,28,0,1,4,0,33
628,6/21/15,32,0,1,5,0,38
629,6/22/15,24,0,7,10,0,41
630,6/23/15,26,0,2,6,0,34
631,6/24/15,14,0,3,3,0,20
632,6/25/15,21,0,3,2,0,26
633,6/26/15,24,1,10,5,0,40
634,6/27/15,27,0,0,9,0,36
635,6/28/15,32,0,2,8,0,42
636,6/29/15,31,1,1,4,0,37
637,6/30/15,25,0,2,14,0,41
638,7/1/15,15,0,1,2,0,18
639,7/2/15,23,1,0,3,0,27
640,7/3/15,13,0,0,4,0,17
641,7/4/15,29,0,2,0,0,31
642,7/5/15,24,0,5,2,0,31
643,7/6/15,30,0,3,2,0,35
644,7/7/15,20,0,3,8,0,31
645,7/8/15,23,0,2,5,0,30
646,7/9/15,19,2,5,5,0,31
647,7/10/15,14,0,6,5,0,25
648,7/11/15,36,0,3,1,0,40
649,7/12/15,23,0,1,2,0,26
650,7/13/15,20,0,2,3,0,25
651,7/14/15,16,0,1,4,0,21
652,7/15/15,21,1,4,3,0,29
653,7/16/15,4,0,3,7,0,14
654,7/17/15,21,0,2,5,0,28
655,7/18/15,19,0,2,3,0,24
656,7/19/15,15,0,3,2,0,20
657,7/20/15,24,0,6,5,0,35
658,7/21/15,14,1,2,5,0,22
659,7/22/15,11,0,1,3,0,15
660,7/23/15,14,0,2,11,0,27
661,7/24/15,11,0,4,3,0,18
662,7/25/15,13,0,0,2,0,15
663,7/26/15,13,0,3,4,0,20
664,7/27/15,29,1,1,5,0,36
665,7/28/15,18,1,3,4,0,26
666,7/29/15,28,1,5,2,0,36
667,7/30/15,12,0,6,5,0,23
668,7/31/15,14,0,2,3,0,19
669,8/1/15,29,0,2,6,0,37
670,8/2/15,12,1,0,3,0,16
671,8/3/15,19,1,1,5,0,26
672,8/4/15,31,1,0,4,0,36
673,8/5/15,23,0,3,9,0,35
674,8/6/15,16,0,3,3,0,22
675,8/7/15,12,0,0,6,0,18
676,8/8/15,18,1,3,5,0,27
677,8/9/15,15,0,1,4,0,20
678,8/10/15,18,0,1,7,0,26
679,8/11/15,17,1,1,3,0,22
680,8/12/15,15,1,4,4,0,24
681,8/13/15,15,1,3,8,0,27
682,8/14/15,19,0,6,3,0,28
683,8/15/15,22,0,3,4,0,29
684,8/16/15,28,0,0,4,0,32
685,8/17/15,17,0,0,6,0,23
686,8/18/15,9,0,4,4,0,17
687,8/19/15,20,0,3,4,0,27
688,8/20/15,25,0,2,5,0,32
689,8/21/15,14,0,2,3,0,19
690,8/22/15,36,0,1,7,0,44
691,8/23/15,22,0,2,6,0,30
692,8/24/15,21,0,0,4,0,25
693,8/25/15,22,0,2,6,0,30
694,8/26/15,19,0,1,5,0,25
695,8/27/15,21,0,5,4,0,30
696,8/28/15,12,0,3,2,0,17
697,8/29/15,19,0,4,2,0,25
698,8/30/15,17,0,6,3,0,26
699,8/31/15,13,0,3,5,0,21
700,9/1/15,12,0,4,9,0,25
701,9/2/15,24,0,1,1,0,26
702,9/3/15,13,0,3,7,0,23
703,9/4/15,25,0,1,4,0,30
704,9/5/15,19,0,1,4,0,24
705,9/6/15,22,0,1,7,0,30
706,9/7/15,25,0,2,6,0,33
707,9/8/15,15,0,11,5,0,31
708,9/9/15,22,1,2,3,0,28
709,9/10/15,13,0,0,7,0,20
710,9/11/15,21,0,4,8,0,33
711,9/12/15,40,0,0,8,0,48
712,9/13/15,21,0,1,4,0,26
713,9/14/15,24,0,1,4,0,29
714,9/15/15,13,0,3,7,0,23
715,9/16/15,26,0,2,6,0,34
716,9/17/15,12,0,2,4,0,18
717,9/18/15,18,0,3,2,0,23
718,9/19/15,21,0,2,9,0,32
719,9/20/15,8,0,0,8,0,16
720,9/21/15,16,0,3,7,0,26
721,9/22/15,10,1,3,0,0,14
722,9/23/15,10,0,3,9,0,22
723,9/24/15,12,0,0,4,0,16
724,9/25/15,14,0,2,3,0,19
725,9/26/15,32,0,0,7,0,39
726,9/27/15,14,0,0,2,0,16
727,9/28/15,19,0,1,4,0,24
728,9/29/15,15,0,1,4,0,20
729,9/30/15,24,0,2,10,0,36
730,10/1/15,16,0,3,2,0,21
731,10/2/15,22,0,2,2,0,26
732,10/3/15,25,1,1,9,0,36
733,10/4/15,16,1,2,3,0,22
734,10/5/15,22,0,2,3,0,27
735,10/6/15,29,0,4,7,0,40
736,10/7/15,23,0,2,7,0,32
737,10/8/15,22,0,3,6,0,31
738,10/9/15,12,0,6,4,0,22
739,10/10/15,12,0,0,1,0,13
740,10/11/15,21,0,3,10,0,34
741,10/12/15,15,0,1,2,0,18
742,10/13/15,14,0,2,4,0,20
743,10/14/15,16,0,3,4,0,23
744,10/15/15,18,0,0,7,0,25
745,10/16/15,14,0,4,5,0,23
746,10/17/15,14,1,1,5,0,21
747,10/18/15,17,0,1,9,0,27
748,10/19/15,25,0,0,5,0,30
749,10/20/15,14,0,0,3,0,17
750,10/21/15,11,0,3,4,0,18
751,10/22/15,13,0,1,7,0,21
752,10/23/15,17,0,4,5,0,26
753,10/24/15,26,0,1,0,0,27
754,10/25/15,27,1,3,5,0,36
755,10/26/15,31,1,4,2,0,38
756,10/27/15,22,0,1,11,0,34
757,10/28/15,18,0,1,4,0,23
758,10/29/15,18,0,1,14,0,33
759,10/30/15,25,0,21,1,0,47
760,10/31/15,35,0,4,3,0,42
761,11/1/15,29,0,0,5,0,34
762,11/2/15,23,0,2,10,0,35
763,11/3/15,34,0,4,3,0,41
764,11/4/15,25,0,2,9,0,36
765,11/5/15,23,0,4,3,0,30
766,11/6/15,31,0,4,4,0,39
767,11/7/15,16,0,0,6,0,22
768,11/8/15,22,0,1,3,0,26
769,11/9/15,21,2,1,2,0,26
770,11/10/15,19,0,3,2,0,24
771,11/11/15,25,0,4,5,0,34
772,11/12/15,27,0,4,4,0,35
773,11/13/15,20,0,3,5,0,28
774,11/14/15,19,0,3,3,0,25
775,11/15/15,28,0,3,3,0,34
776,11/16/15,15,0,1,7,0,23
777,11/17/15,22,0,0,4,0,26
778,11/18/15,35,0,1,2,0,38
779,11/19/15,20,0,0,4,0,24
780,11/20/15,18,0,2,6,0,26
781,11/21/15,24,0,0,7,0,31
782,11/22/15,19,0,1,5,0,25
783,11/23/15,12,0,3,7,0,22
784,11/24/15,24,0,4,1,0,29
785,11/25/15,24,0,9,2,0,35
786,11/26/15,7,0,0,0,0,7
787,11/27/15,27,0,2,6,0,35
788,11/28/15,24,0,1,1,0,26
789,11/29/15,18,0,0,5,0,23
790,11/30/15,19,0,3,4,0,26
791,12/1/15,34,1,0,1,0,36
792,12/2/15,23,1,1,5,0,30
793,12/3/15,23,2,2,7,0,34
794,12/4/15,5,0,1,9,0,15
795,12/5/15,12,0,1,6,0,19
796,12/6/15,15,0,0,4,0,19
797,12/7/15,29,0,2,11,0,42
798,12/8/15,17,0,0,3,0,20
799,12/9/15,26,0,3,3,0,32
800,12/10/15,13,0,10,2,0,25
801,12/11/15,22,1,1,3,0,27
802,12/12/15,17,0,2,1,0,20
803,12/13/15,17,0,0,3,0,20
804,12/14/15,10,0,4,8,0,22
805,12/15/15,17,0,1,3,0,21
806,12/16/15,37,0,2,3,0,42
807,12/17/15,31,1,1,6,0,39
808,12/18/15,14,0,1,5,0,20
809,12/19/15,17,0,1,5,0,23
810,12/20/15,23,0,1,4,0,28
811,12/21/15,22,0,2,9,0,33
812,12/22/15,13,1,0,2,0,16
813,12/23/15,14,0,1,4,0,19
814,12/24/15,8,0,1,0,0,9
815,12/25/15,8,0,2,1,0,11
816,12/26/15,35,0,3,4,0,42
817,12/27/15,13,0,2,2,0,17
818,12/28/15,21,0,2,0,0,23
819,12/29/15,17,0,2,7,0,26
820,12/30/15,14,0,2,3,0,19
821,12/31/15,19,0,4,4,0,27
822,1/1/16,31,0,3,0,0,34
823,1/2/16,31,0,2,8,0,41
824,1/3/16,14,0,1,5,0,20
825,1/4/16,22,0,2,3,0,27
826,1/5/16,13,0,2,4,0,19
827,1/6/16,23,0,2,4,0,29
828,1/7/16,19,0,0,3,0,22
829,1/8/16,21,0,3,3,0,27
830,1/9/16,16,0,2,4,0,22
831,1/10/16,29,0,0,5,0,34
832,1/11/16,20,1,2,9,0,32
833,1/12/16,15,0,1,4,0,20
834,1/13/16,29,0,4,5,0,38
835,1/14/16,14,1,2,6,0,23
836,1/15/16,20,0,4,4,0,28
837,1/16/16,41,1,1,4,0,47
838,1/17/16,20,0,2,5,0,27
839,1/18/16,19,0,4,3,0,26
840,1/19/16,11,0,2,13,0,26
841,1/20/16,18,0,1,5,0,24
842,1/21/16,15,0,5,5,0,25
843,1/22/16,21,1,1,8,0,31
844,1/23/16,21,0,2,3,0,26
845,1/24/16,16,0,3,2,0,21
846,1/25/16,13,0,1,7,0,21
847,1/26/16,18,0,0,0,0,18
848,1/27/16,25,0,1,8,0,34
849,1/28/16,20,0,9,1,0,30
850,1/29/16,12,0,4,2,0,18
851,1/30/16,25,0,0,6,0,31
852,1/31/16,16,1,6,3,0,26
853,2/1/16,13,0,4,5,0,22
854,2/2/16,12,0,15,2,0,29
855,2/3/16,30,0,0,3,0,33
856,2/4/16,12,0,1,9,0,22
857,2/5/16,11,0,4,9,0,24
858,2/6/16,10,0,3,4,0,17
859,2/7/16,13,0,2,7,0,22
860,2/8/16,8,0,1,4,0,13
861,2/9/16,16,0,7,8,0,31
862,2/10/16,16,0,1,10,0,27
863,2/11/16,18,0,2,10,0,30
864,2/12/16,16,0,2,7,0,25
865,2/13/16,33,0,2,3,0,38
866,2/14/16,13,0,1,1,0,15
867,2/15/16,22,0,1,9,0,32
868,2/16/16,17,0,2,6,0,25
869,2/17/16,13,0,1,2,0,16
870,2/18/16,20,0,0,14,0,34
871,2/19/16,22,0,1,5,0,28
872,2/20/16,37,1,2,6,0,46
873,2/21/16,13,0,0,7,0,20
874,2/22/16,17,0,3,8,0,28
875,2/23/16,26,0,4,4,0,34
876,2/24/16,21,0,3,19,0,43
877,2/25/16,23,0,1,9,0,33
878,2/26/16,28,0,4,12,0,44
879,2/27/16,18,0,0,8,0,26
880,2/28/16,24,0,0,10,0,34
881,2/29/16,11,0,2,6,0,19
882,3/1/16,27,0,0,6,0,33
883,3/2/16,28,2,4,5,0,39
884,3/3/16,12,0,1,6,0,19
885,3/4/16,19,0,0,1,0,20
886,3/5/16,19,0,6,3,0,28
887,3/6/16,10,0,5,14,0,29
888,3/7/16,17,0,0,3,0,20
889,3/8/16,22,0,6,9,0,37
890,3/9/16,22,0,2,1,0,25
891,3/10/16,30,0,3,4,0,37
892,3/11/16,20,0,3,7,0,30
893,3/12/16,26,0,2,8,0,36
894,3/13/16,17,0,1,3,0,21
895,3/14/16,23,0,3,5,0,31
896,3/15/16,12,0,3,2,0,17
897,3/16/16,17,0,5,6,0,28
898,3/17/16,21,0,0,4,0,25
899,3/18/16,18,0,2,13,0,33
900,3/19/16,18,0,5,5,0,28
901,3/20/16,18,0,1,9,0,28
902,3/21/16,12,0,5,8,0,25
903,3/22/16,16,0,5,6,0,27
904,3/23/16,14,0,6,8,0,28
905,3/24/16,20,0,1,13,0,34
906,3/25/16,15,0,3,8,0,26
907,3/26/16,15,0,2,7,0,24
908,3/27/16,17,0,5,4,0,26
909,3/28/16,23,0,3,7,0,33
910,3/29/16,17,0,1,7,0,25
911,3/30/16,21,0,2,5,0,28
912,3/31/16,17,0,3,3,0,23
913,4/1/16,18,0,0,1,0,19
914,4/2/16,19,0,3,4,0,26
915,4/3/16,21,0,2,5,0,28
916,4/4/16,16,0,0,5,0,21
917,4/5/16,19,0,4,3,0,26
918,4/6/16,12,0,1,0,0,13
919,4/7/16,9,0,1,11,0,21
920,4/8/16,14,0,5,6,0,25
921,4/9/16,25,0,2,6,0,33
922,4/10/16,13,1,3,4,0,21
923,4/11/16,24,0,3,8,0,35
924,4/12/16,21,1,0,5,0,27
925,4/13/16,17,0,2,6,0,25
926,4/14/16,17,0,2,5,0,24
927,4/15/16,24,0,8,5,0,37
928,4/16/16,21,0,1,9,0,31
929,4/17/16,13,0,5,2,0,20
930,4/18/16,19,0,2,5,0,26
931,4/19/16,18,0,4,8,0,30
932,4/20/16,28,0,0,5,0,33
933,4/21/16,13,0,3,10,0,26
934,4/22/16,41,0,1,4,0,46
935,4/23/16,20,0,2,5,0,27
936,4/24/16,12,0,4,6,0,22
937,4/25/16,16,0,2,7,0,25
938,4/26/16,16,0,1,5,0,22
939,4/27/16,16,0,1,4,0,21
940,4/28/16,22,0,6,3,0,31
941,4/29/16,19,0,3,5,0,27
942,4/30/16,36,0,1,6,0,43
943,5/1/16,17,0,1,9,0,27
944,5/2/16,25,0,4,6,0,35
945,5/3/16,20,0,2,7,0,29
946,5/4/16,20,0,3,8,0,31
947,5/5/16,18,0,5,2,0,25
948,5/6/16,21,0,1,3,0,25
949,5/7/16,19,0,1,8,0,28
950,5/8/16,19,0,2,1,0,22
951,5/9/16,27,0,0,7,0,34
952,5/10/16,24,1,3,4,0,32
953,5/11/16,39,0,1,9,0,49
954,5/12/16,43,0,5,3,0,51
955,5/13/16,24,0,3,6,0,33
956,5/14/16,32,0,2,6,0,40
957,5/15/16,26,0,3,2,0,31
958,5/16/16,24,0,0,5,0,29
959,5/17/16,40,0,2,11,0,53
960,5/18/16,29,0,5,8,0,42
961,5/19/16,19,0,4,3,0,26
962,5/20/16,21,0,3,11,0,35
963,5/21/16,40,0,1,5,0,46
964,5/22/16,20,0,2,6,0,28
965,5/23/16,36,0,0,10,0,46
966,5/24/16,17,0,3,2,0,22
967,5/25/16,29,1,6,11,0,47
968,5/26/16,27,0,2,11,0,40
969,5/27/16,11,0,2,0,0,13
970,5/28/16,14,0,1,1,0,16
971,5/29/16,14,0,1,2,0,17
972,5/30/16,26,0,3,6,0,35
973,5/31/16,28,0,1,4,0,33
974,6/1/16,62,0,1,6,0,69
975,6/2/16,15,0,1,22,0,38
976,6/3/16,17,0,1,6,0,24
977,6/4/16,11,0,1,3,0,15
978,6/5/16,28,0,0,6,0,34
979,6/6/16,36,0,0,5,0,41
980,6/7/16,24,0,3,5,0,32
981,6/8/16,29,0,2,1,0,32
982,6/9/16,17,0,1,6,0,24
983,6/10/16,14,0,5,3,0,22
984,6/11/16,11,0,1,8,0,20
985,6/12/16,11,0,2,7,0,20
986,6/13/16,13,0,5,7,0,25
987,6/14/16,22,0,9,13,0,44
988,6/15/16,19,0,7,2,0,28
989,6/16/16,11,0,2,7,0,20
990,6/17/16,11,0,3,3,0,17
991,6/18/16,16,0,1,9,0,26
992,6/19/16,21,0,2,4,0,27
993,6/20/16,25,0,4,0,0,29
994,6/21/16,16,0,1,7,0,24
995,6/22/16,20,0,0,6,0,26
996,6/23/16,15,0,3,2,0,20
997,6/24/16,20,0,6,5,0,31
998,6/25/16,21,0,4,7,0,32
999,6/26/16,17,0,2,6,0,25
1000,6/27/16,26,0,1,4,0,31
1001,6/28/16,21,0,3,4,0,28
1002,6/29/16,19,0,0,3,0,22
1003,6/30/16,22,0,2,4,0,28
1004,7/1/16,26,0,2,3,0,31
1005,7/2/16,18,0,2,2,0,22
1006,7/3/16,20,0,1,0,0,21
1007,7/4/16,11,0,1,2,0,14
1008,7/5/16,27,0,4,3,0,34
1009,7/6/16,22,0,1,3,0,26
1010,7/7/16,23,0,6,2,0,31
1011,7/8/16,14,0,1,3,0,18
1012,7/9/16,20,0,0,2,0,22
1013,7/10/16,20,0,2,5,0,27
1014,7/11/16,18,0,2,5,0,25
1015,7/12/16,16,0,0,3,0,19
1016,7/13/16,15,0,6,4,0,25
1017,7/14/16,17,0,2,7,0,26
1018,7/15/16,15,0,3,12,0,30
1019,7/16/16,17,0,5,6,0,28
1020,7/17/16,17,0,0,5,0,22
1021,7/18/16,8,0,0,2,0,10
1022,7/19/16,17,0,1,4,0,22
1023,7/20/16,16,0,2,2,0,20
1024,7/21/16,17,0,0,6,0,23
1025,7/22/16,19,0,0,5,0,24
1026,7/23/16,32,0,0,7,0,39
1027,7/24/16,12,0,1,8,0,21
1028,7/25/16,12,0,2,6,0,20
1029,7/26/16,22,0,4,2,0,28
1030,7/27/16,31,0,5,3,0,39
1031,7/28/16,23,0,4,6,0,33
1032,7/29/16,16,0,0,4,0,20
1033,7/30/16,13,0,1,4,0,18
1034,7/31/16,19,0,5,3,0,27
1035,8/1/16,15,0,1,4,0,20
1036,8/2/16,12,0,2,1,0,15
1037,8/3/16,18,0,2,6,0,26
1038,8/4/16,20,0,4,5,0,29
1039,8/5/16,11,0,2,8,0,21
1040,8/6/16,22,0,1,5,0,28
1041,8/7/16,14,0,3,9,0,26
1042,8/8/16,21,0,2,6,0,29
1043,8/9/16,22,0,2,7,0,31
1044,8/10/16,18,0,4,6,0,28
1045,8/11/16,19,0,6,3,0,28
1046,8/12/16,12,0,2,5,0,19
1047,8/13/16,18,0,0,2,0,20
1048,8/14/16,18,0,0,4,0,22
1049,8/15/16,41,0,3,4,0,48
1050,8/16/16,21,0,2,6,0,29
1051,8/17/16,21,0,7,1,0,29
1052,8/18/16,20,0,2,4,0,26
1053,8/19/16,19,0,3,5,0,27
1054,8/20/16,27,0,1,5,0,33
1055,8/21/16,18,0,1,14,0,33
1056,8/22/16,22,0,3,3,0,28
1057,8/23/16,13,0,3,4,0,20
1058,8/24/16,19,0,1,2,0,22
1059,8/25/16,19,0,1,4,0,24
1060,8/26/16,22,0,2,5,0,29
1061,8/27/16,21,0,3,2,0,26
1062,8/28/16,21,0,2,5,0,28
1063,8/29/16,15,0,4,2,0,21
1064,8/30/16,17,0,1,2,0,20
1065,8/31/16,15,0,0,2,0,17
1066,9/1/16,19,0,1,5,0,25
1067,9/2/16,17,0,4,8,0,29
1068,9/3/16,21,0,5,18,0,44
1069,9/4/16,11,0,6,5,0,22
1070,9/5/16,25,0,0,5,0,30
1071,9/6/16,23,0,1,15,0,39
1072,9/7/16,13,0,0,5,0,18
1073,9/8/16,23,0,3,4,0,30
1074,9/9/16,12,0,3,5,0,20
1075,9/10/16,26,0,3,4,0,33
1076,9/11/16,17,0,2,9,0,28
1077,9/12/16,13,0,3,3,0,19
1078,9/13/16,13,1,4,5,0,23
1079,9/14/16,18,0,3,4,0,25
1080,9/15/16,22,0,1,4,0,27
1081,9/16/16,15,0,1,3,0,19
1082,9/17/16,29,0,2,4,0,35
1083,9/18/16,8,0,0,7,0,15
1084,9/19/16,25,0,2,5,0,32
1085,9/20/16,13,0,1,8,0,22
1086,9/21/16,19,0,3,6,0,28
1087,9/22/16,18,0,3,3,0,24
1088,9/23/16,12,0,2,6,0,20
1089,9/24/16,17,0,1,3,0,21
1090,9/25/16,31,0,3,6,0,40
1091,9/26/16,23,0,1,4,0,28
1092,9/27/16,22,0,1,1,0,24
1093,9/28/16,25,0,4,3,0,32
1094,9/29/16,14,0,0,7,0,21
1095,9/30/16,14,0,2,3,0,19
1096,10/1/16,27,0,4,4,0,35
1097,10/2/16,20,0,2,3,0,25
1098,10/3/16,33,0,0,4,0,37
1099,10/4/16,5,0,10,4,0,19
1100,10/5/16,10,0,2,2,0,14
1101,10/6/16,5,0,2,1,0,8
1102,10/7/16,11,0,2,4,0,17
1103,10/8/16,33,0,2,1,0,36
1104,10/9/16,21,0,1,5,0,27
1105,10/10/16,21,0,3,4,0,28
1106,10/11/16,15,0,2,6,0,23
1107,10/12/16,16,0,4,5,0,25
1108,10/13/16,21,0,2,2,0,25
1109,10/14/16,12,0,3,9,0,24
1110,10/15/16,20,0,3,3,0,26
1111,10/16/16,27,0,1,8,0,36
1112,10/17/16,17,0,1,7,0,25
1113,10/18/16,7,0,3,13,0,23
1114,10/19/16,18,0,4,2,0,24
1115,10/20/16,14,0,1,5,0,20
1116,10/21/16,23,0,7,13,0,43
1117,10/22/16,23,0,3,5,0,31
1118,10/23/16,18,0,0,4,0,22
1119,10/24/16,9,0,1,10,0,20
1120,10/25/16,15,0,3,1,0,19
1121,10/26/16,17,0,3,4,0,24
1122,10/27/16,9,0,1,4,0,14
1123,10/28/16,11,0,1,5,0,17
1124,10/29/16,9,0,1,6,0,16
1125,10/30/16,6,0,1,3,0,10
1126,10/31/16,21,0,0,6,0,27
1127,11/1/16,18,0,2,5,0,25
1128,11/2/16,26,0,5,1,0,32
1129,11/3/16,16,0,3,1,0,20
1130,11/4/16,36,0,2,7,0,45
1131,11/5/16,17,0,3,8,0,28
1132,11/6/16,20,0,2,7,0,29
1133,11/7/16,22,0,4,1,0,27
1134,11/8/16,23,0,3,4,0,30
1135,11/9/16,23,0,3,1,0,27
1136,11/10/16,35,0,2,8,0,45
1137,11/11/16,20,0,0,5,0,25
1138,11/12/16,15,0,2,5,0,22
1139,11/13/16,21,0,0,4,0,25
1140,11/14/16,21,0,4,3,0,28
1141,11/15/16,16,0,7,6,0,29
1142,11/16/16,15,0,1,6,0,22
1143,11/17/16,24,0,0,4,0,28
1144,11/18/16,13,0,6,2,0,21
1145,11/19/16,19,0,2,9,0,30
1146,11/20/16,24,0,0,3,0,27
1147,11/21/16,20,0,0,3,0,23
1148,11/22/16,15,0,1,5,0,21
1149,11/23/16,15,0,6,2,0,23
1150,11/24/16,0,0,1,2,0,3
1151,11/25/16,19,0,2,3,0,24
1152,11/26/16,24,0,5,9,0,38
1153,11/27/16,25,0,4,6,0,35
1154,11/28/16,22,0,0,8,0,30
1155,11/29/16,16,0,7,2,0,25
1156,11/30/16,21,0,3,4,0,28
1157,12/1/16,12,0,1,8,0,21
1158,12/2/16,16,1,2,1,0,20
1159,12/3/16,31,0,2,4,0,37
1160,12/4/16,20,0,2,1,0,23
1161,12/5/16,19,1,4,13,0,37
1162,12/6/16,19,0,2,8,0,29
1163,12/7/16,23,0,6,8,0,37
1164,12/8/16,26,0,2,6,0,34
1165,12/9/16,25,0,1,12,0,38
1166,12/10/16,20,0,1,4,0,25
1167,12/11/16,17,0,0,8,0,25
1168,12/12/16,13,0,0,5,0,18
1169,12/13/16,11,0,2,4,0,17
1170,12/14/16,16,0,1,4,0,21
1171,12/15/16,16,0,3,6,0,25
1172,12/16/16,26,0,1,6,0,33
1173,12/17/16,21,0,1,8,0,30
1174,12/18/16,12,0,2,10,0,24
1175,12/19/16,28,0,1,9,0,38
1176,12/20/16,10,0,2,4,0,16
1177,12/21/16,13,0,2,3,0,18
1178,12/22/16,9,0,2,6,0,17
1179,12/23/16,13,0,6,3,0,22
1180,12/24/16,8,0,3,2,0,13
1181,12/25/16,3,0,0,0,0,3
1182,12/26/16,44,0,1,2,0,47
1183,12/27/16,12,0,1,8,0,21
1184,12/28/16,28,0,2,1,0,31
1185,12/29/16,27,0,5,3,0,35
1186,12/30/16,16,0,15,4,0,35
1187,12/31/16,18,0,1,4,0,23
1188,1/1/17,19,0,3,1,0,23
1189,1/2/17,34,0,2,2,0,38
1190,1/3/17,33,0,7,3,0,43
1191,1/4/17,15,0,0,0,0,15
1192,1/5/17,18,0,0,2,0,20
1193,1/6/17,15,0,1,3,0,19
1194,1/7/17,15,0,1,4,0,20
1195,1/8/17,22,0,1,5,0,28
1196,1/9/17,18,0,1,4,0,23
1197,1/10/17,16,0,3,3,0,22
1198,1/11/17,15,0,0,4,0,19
1199,1/12/17,17,0,2,11,0,30
1200,1/13/17,15,0,1,3,0,19
1201,1/14/17,25,0,1,7,0,33
1202,1/15/17,15,0,3,6,0,24
1203,1/16/17,21,0,1,3,0,25
1204,1/17/17,10,0,3,6,0,19
1205,1/18/17,22,0,1,8,0,31
1206,1/19/17,17,0,2,4,0,23
1207,1/20/17,23,0,0,1,0,24
1208,1/21/17,29,0,3,10,0,42
1209,1/22/17,32,0,1,5,0,38
1210,1/23/17,21,0,0,5,0,26
1211,1/24/17,13,0,0,10,0,23
1212,1/25/17,24,0,2,8,0,34
1213,1/26/17,19,0,1,6,0,26
1214,1/27/17,16,0,1,17,0,34
1215,1/28/17,12,0,1,13,0,26
1216,1/29/17,13,0,2,10,0,25
1217,1/30/17,18,0,1,11,0,30
1218,1/31/17,15,0,1,7,0,23
1219,2/1/17,12,0,6,2,0,20
1220,2/2/17,17,0,4,10,0,31
1221,2/3/17,29,0,0,6,0,35
1222,2/4/17,24,0,1,10,0,35
1223,2/5/17,19,0,0,9,0,28
1224,2/6/17,19,0,6,7,0,32
1225,2/7/17,13,0,2,17,0,32
1226,2/8/17,16,0,8,5,0,29
1227,2/9/17,17,0,0,7,0,24
1228,2/10/17,29,0,5,9,0,43
1229,2/11/17,13,0,0,17,0,30
1230,2/12/17,16,0,2,21,0,39
1231,2/13/17,16,0,1,20,0,37
1232,2/14/17,18,0,1,10,0,29
1233,2/15/17,20,0,1,9,0,30
1234,2/16/17,15,0,3,16,0,34
1235,2/17/17,13,0,0,9,0,22
1236,2/18/17,16,0,2,15,0,33
1237,2/19/17,14,0,1,4,0,19
1238,2/20/17,20,1,2,9,0,32
1239,2/21/17,18,0,0,5,0,23
1240,2/22/17,20,0,0,9,0,29
1241,2/23/17,26,1,4,9,0,40
1242,2/24/17,14,0,4,3,0,21
1243,2/25/17,24,0,5,4,0,33
1244,2/26/17,19,0,1,4,0,24
1245,2/27/17,24,0,8,6,0,38
1246,2/28/17,20,0,4,7,0,31
1247,3/1/17,18,0,4,4,0,26
1248,3/2/17,28,0,4,3,0,35
1249,3/3/17,23,0,2,2,0,27
1250,3/4/17,14,0,2,4,0,20
1251,3/5/17,16,0,2,3,0,21
1252,3/6/17,15,0,8,3,0,26
1253,3/7/17,16,0,7,2,0,25
1254,3/8/17,17,0,4,2,0,23
1255,3/9/17,29,0,1,4,0,34
1256,3/10/17,24,0,0,6,0,30
1257,3/11/17,16,0,1,5,0,22
1258,3/12/17,21,0,1,6,0,28
1259,3/13/17,29,0,2,7,0,38
1260,3/14/17,22,0,5,7,0,34
1261,3/15/17,20,0,5,5,0,30
1262,3/16/17,20,0,0,8,0,28
1263,3/17/17,18,0,5,6,0,29
1264,3/18/17,8,0,2,12,0,22
1265,3/19/17,7,0,1,1,0,9
1266,3/20/17,15,0,1,5,0,21
1267,3/21/17,20,0,2,5,0,27
1268,3/22/17,19,0,3,1,0,23
1269,3/23/17,15,0,2,5,0,22
1270,3/24/17,15,0,2,10,0,27
1271,3/25/17,25,0,1,9,0,35
1272,3/26/17,18,0,1,4,0,23
1273,3/27/17,22,0,0,12,0,34
1274,3/28/17,21,0,2,6,0,29
1275,3/29/17,28,0,1,7,0,36
1276,3/30/17,13,0,4,2,0,19
1277,3/31/17,19,0,4,4,0,27
1278,4/1/17,14,0,4,5,0,23
1279,4/2/17,11,0,0,3,0,14
1280,4/3/17,29,0,3,3,0,35
1281,4/4/17,21,0,4,5,0,30
1282,4/5/17,22,0,9,10,0,41
1283,4/6/17,10,0,1,7,0,18
1284,4/7/17,14,0,1,4,0,19
1285,4/8/17,29,0,1,4,0,34
1286,4/9/17,11,0,3,6,0,20
1287,4/10/17,17,0,1,9,0,27
1288,4/11/17,27,0,3,6,0,36
1289,4/12/17,22,0,2,16,0,40
1290,4/13/17,15,0,1,6,0,22
1291,4/14/17,17,0,0,3,0,20
1292,4/15/17,16,0,2,4,0,22
1293,4/16/17,8,0,0,7,0,15
1294,4/17/17,19,0,4,5,0,28
1295,4/18/17,19,0,5,10,0,34
1296,4/19/17,15,0,3,3,0,21
1297,4/20/17,17,0,1,7,0,25
1298,4/21/17,16,0,2,8,0,26
1299,4/22/17,25,0,1,3,0,29
1300,4/23/17,15,0,1,2,0,18
1301,4/24/17,14,0,5,4,0,23
1302,4/25/17,25,0,4,5,0,34
1303,4/26/17,16,0,2,2,0,20
1304,4/27/17,25,0,3,6,0,34
1305,4/28/17,13,0,3,10,0,26
1306,4/29/17,24,0,3,5,0,32
1307,4/30/17,18,0,0,6,0,24
1308,5/1/17,23,0,5,12,0,40
1309,5/2/17,14,0,5,6,0,25
1310,5/3/17,26,0,11,5,0,42
1311,5/4/17,16,0,5,5,0,26
1312,5/5/17,22,0,2,4,0,28
1313,5/6/17,11,0,2,4,0,17
1314,5/7/17,11,0,1,11,0,23
1315,5/8/17,11,0,1,8,0,20
1316,5/9/17,17,0,1,7,0,25
1317,5/10/17,16,0,1,7,0,24
1318,5/11/17,26,0,5,9,0,40
1319,5/12/17,21,0,1,7,0,29
1320,5/13/17,16,0,1,6,0,23
1321,5/14/17,23,0,1,7,0,31
1322,5/15/17,23,0,1,5,0,29
1323,5/16/17,13,0,1,9,0,23
1324,5/17/17,34,0,2,3,0,39
1325,5/18/17,28,0,3,6,0,37
1326,5/19/17,29,0,4,5,0,38
1327,5/20/17,15,0,1,7,0,23
1328,5/21/17,28,1,1,6,0,36
1329,5/22/17,13,0,0,2,0,15
1330,5/23/17,17,0,1,7,0,25
1331,5/24/17,25,0,0,5,0,30
1332,5/25/17,13,0,2,5,0,20
1333,5/26/17,22,0,1,4,0,27
1334,5/27/17,17,0,5,6,0,28
1335,5/28/17,17,0,2,6,0,25
1336,5/29/17,17,1,5,11,0,34
1337,5/30/17,23,0,1,10,0,34
1338,5/31/17,24,0,6,13,0,43
1339,6/1/17,27,0,3,6,0,36
1340,6/2/17,22,0,0,6,0,28
1341,6/3/17,18,0,0,9,0,27
1342,6/4/17,28,0,1,6,0,35
1343,6/5/17,21,0,3,12,0,36
1344,6/6/17,27,0,0,2,0,29
1345,6/7/17,17,0,4,9,0,30
1346,6/8/17,22,0,2,5,0,29
1347,6/9/17,18,0,4,7,0,29
1348,6/10/17,13,0,5,11,0,29
1349,6/11/17,16,0,3,4,0,23
1350,6/12/17,11,0,0,7,0,18
1351,6/13/17,7,0,4,6,0,17
1352,6/14/17,11,0,4,5,0,20
1353,6/15/17,19,0,2,7,0,28
1354,6/16/17,15,0,1,5,0,21
1355,6/17/17,16,0,2,5,0,23
1356,6/18/17,15,0,1,0,0,16
1357,6/19/17,27,0,2,10,0,39
1358,6/20/17,22,0,3,1,0,26
1359,6/21/17,40,0,5,5,0,50
1360,6/22/17,26,0,5,5,0,36
1361,6/23/17,8,0,2,5,0,15
1362,6/24/17,11,0,3,1,0,15
1363,6/25/17,15,0,4,6,0,25
1364,6/26/17,9,0,2,6,0,17
1365,6/27/17,31,0,3,9,0,43
1366,6/28/17,22,0,5,5,0,32
1367,6/29/17,20,0,3,7,0,30
1368,6/30/17,14,0,3,2,0,19
1369,7/1/17,14,0,1,0,0,15
1370,7/2/17,18,0,3,0,0,21
1371,7/3/17,20,0,2,16,0,38
1372,7/4/17,15,0,4,4,0,23
1373,7/5/17,27,0,4,3,0,34
1374,7/6/17,26,0,3,6,0,35
1375,7/7/17,16,0,2,7,0,25
1376,7/8/17,23,0,0,3,0,26
1377,7/9/17,38,0,0,7,0,45
1378,7/10/17,21,0,4,7,0,32
1379,7/11/17,19,0,2,4,0,25
1380,7/12/17,16,0,0,7,0,23
1381,7/13/17,19,0,5,7,0,31
1382,7/14/17,32,0,1,6,0,39
1383,7/15/17,17,0,3,7,0,27
1384,7/16/17,21,0,2,4,0,27
1385,7/17/17,20,0,1,8,0,29
1386,7/18/17,18,0,2,6,0,26
1387,7/19/17,20,0,6,4,0,30
1388,7/20/17,16,0,2,5,0,23
1389,7/21/17,26,0,0,5,0,31
1390,7/22/17,20,0,3,6,0,29
1391,7/23/17,13,0,0,2,0,15
1392,7/24/17,16,0,1,3,0,20
1393,7/25/17,24,0,2,1,0,27
1394,7/26/17,22,0,1,11,0,34
1395,7/27/17,8,0,2,7,0,17
1396,7/28/17,14,0,2,1,0,17
1397,7/29/17,24,0,1,7,0,32
1398,7/30/17,17,0,0,3,0,20
1399,7/31/17,20,0,0,4,0,24
1400,8/1/17,24,0,4,2,0,30
1401,8/2/17,23,0,3,5,0,31
1402,8/3/17,30,0,2,10,0,42
1403,8/4/17,14,0,3,8,0,25
1404,8/5/17,10,0,5,3,0,18
1405,8/6/17,22,0,1,2,0,25
1406,8/7/17,13,0,3,5,0,21
1407,8/8/17,16,0,2,6,0,24
1408,8/9/17,10,0,3,6,0,19
1409,8/10/17,21,0,1,7,0,29
1410,8/11/17,15,0,15,6,0,36
1411,8/12/17,17,0,1,3,0,21
1412,8/13/17,12,0,0,3,0,15
1413,8/14/17,29,0,3,2,0,34
1414,8/15/17,17,0,1,11,0,29
1415,8/16/17,12,0,0,8,0,20
1416,8/17/17,14,0,3,9,0,26
1417,8/18/17,18,0,0,7,0,25
1418,8/19/17,16,0,4,11,0,31
1419,8/20/17,15,0,0,8,0,23
1420,8/21/17,15,0,0,9,0,24
1421,8/22/17,11,0,4,9,0,24
1422,8/23/17,15,0,2,5,0,22
1423,8/24/17,18,0,1,10,0,29
1424,8/25/17,15,0,1,4,0,20
1425,8/26/17,14,0,6,4,0,24
1426,8/27/17,19,0,0,3,0,22
1427,8/28/17,35,0,1,4,0,40
1428,8/29/17,23,0,6,9,0,38
1429,8/30/17,20,0,3,4,0,27
1430,8/31/17,23,0,4,3,0,30
1431,9/1/17,14,0,65,4,0,83
1432,9/2/17,25,0,14,1,0,40
1433,9/3/17,22,0,40,4,0,66
1434,9/4/17,13,0,42,5,0,60
1435,9/5/17,20,0,6,6,0,32
1436,9/6/17,22,0,8,3,0,33
1437,9/7/17,21,0,7,2,0,30
1438,9/8/17,13,0,2,10,0,25
1439,9/9/17,11,0,2,6,0,19
1440,9/10/17,14,0,6,4,0,24
1441,9/11/17,12,0,22,7,0,41
1442,9/12/17,14,0,2,8,0,24
1443,9/13/17,25,0,7,10,0,42
1444,9/14/17,12,0,2,3,0,17
1445,9/15/17,14,0,4,3,0,21
1446,9/16/17,11,0,3,5,0,19
1447,9/17/17,11,0,4,7,0,22
1448,9/18/17,15,0,5,4,0,24
1449,9/19/17,18,0,5,8,0,31
1450,9/20/17,17,0,2,9,0,28
1451,9/21/17,17,0,1,7,0,25
1452,9/22/17,13,0,1,3,0,17
1453,9/23/17,25,0,5,5,0,35
1454,9/24/17,11,0,1,5,0,17
1455,9/25/17,17,0,2,14,0,33
1456,9/26/17,18,0,0,8,0,26
1457,9/27/17,23,0,2,5,0,30
1458,9/28/17,17,0,3,5,0,25
1459,9/29/17,18,0,5,3,0,26
1460,9/30/17,22,0,4,2,0,28
1461,10/1/17,25,0,1,7,0,33
1462,10/2/17,30,0,4,16,0,50
1463,10/3/17,25,0,0,5,0,30
1464,10/4/17,21,0,2,3,0,26
1465,10/5/17,15,0,4,2,0,21
1466,10/6/17,15,0,4,3,0,22
1467,10/7/17,28,0,0,3,0,31
1468,10/8/17,16,0,4,3,0,23
1469,10/9/17,21,0,0,8,0,29
1470,10/10/17,22,0,0,5,0,27
1471,10/11/17,32,0,3,6,0,41
1472,10/12/17,16,0,2,3,0,21
1473,10/13/17,21,1,3,9,0,34
1474,10/14/17,16,0,4,0,0,20
1475,10/15/17,26,0,3,1,0,30
1476,10/16/17,21,0,0,7,0,28
1477,10/17/17,16,0,1,2,0,19
1478,10/18/17,17,0,4,6,0,27
1479,10/19/17,13,0,0,5,0,18
1480,10/20/17,17,0,1,5,0,23
1481,10/21/17,10,0,3,3,0,16
1482,10/22/17,20,0,1,10,0,31
1483,10/23/17,20,0,3,3,0,26
1484,10/24/17,25,0,0,2,0,27
1485,10/25/17,21,0,2,3,0,26
1486,10/26/17,15,0,4,2,0,21
1487,10/27/17,16,0,4,1,0,21
1488,10/28/17,21,0,2,6,0,29
1489,10/29/17,19,0,7,7,0,33
1490,10/30/17,14,0,1,7,0,22
1491,10/31/17,12,0,1,3,0,16
1492,11/1/17,23,0,2,2,0,27
1493,11/2/17,17,0,5,4,0,26
1494,11/3/17,10,0,4,4,0,18
1495,11/4/17,24,0,1,4,0,29
1496,11/5/17,18,0,3,10,0,31
1497,11/6/17,28,0,2,1,0,31
1498,11/7/17,16,0,4,6,0,26
1499,11/8/17,18,0,4,3,0,25
1500,11/9/17,19,0,0,6,0,25
1501,11/10/17,8,0,2,3,0,13
1502,11/11/17,22,0,0,1,0,23
1503,11/12/17,21,0,1,3,0,25
1504,11/13/17,21,0,1,7,0,29
1505,11/14/17,18,0,0,5,0,23
1506,11/15/17,15,0,2,1,0,18
1507,11/16/17,15,0,3,16,0,34
1508,11/17/17,15,0,2,2,0,19
1509,11/18/17,15,0,0,6,0,21
1510,11/19/17,17,0,1,6,0,24
1511,11/20/17,35,0,0,5,0,40
1512,11/21/17,19,0,0,7,0,26
1513,11/22/17,18,0,3,4,0,25
1514,11/23/17,2,0,0,1,0,3
1515,11/24/17,15,0,3,5,0,23
1516,11/25/17,11,0,1,5,0,17
1517,11/26/17,9,0,1,3,0,13
1518,11/27/17,13,0,4,3,0,20
1519,11/28/17,16,0,7,6,0,29
1520,11/29/17,13,0,2,6,0,21
1521,11/30/17,29,0,1,3,0,33
1522,12/1/17,12,0,3,5,0,20
1523,12/2/17,16,0,4,3,0,23
1524,12/3/17,20,0,2,4,0,26
1525,12/4/17,14,0,7,5,0,26
1526,12/5/17,24,0,1,16,0,41
1527,12/6/17,20,0,2,5,0,27
1528,12/7/17,19,0,1,8,0,28
1529,12/8/17,18,0,1,4,0,23
1530,12/9/17,24,0,5,2,0,31
1531,12/10/17,11,0,2,3,0,16
1532,12/11/17,14,0,3,9,0,26
1533,12/12/17,18,0,2,9,0,29
1534,12/13/17,11,0,3,3,0,17
1535,12/14/17,10,0,3,4,0,17
1536,12/15/17,15,0,2,7,0,24
1537,12/16/17,20,0,4,6,0,30
1538,12/17/17,19,0,0,3,0,22
1539,12/18/17,25,0,2,6,0,33
1540,12/19/17,22,0,1,11,0,34
1541,12/20/17,17,0,2,5,0,24
1542,12/21/17,15,0,1,11,0,27
1543,12/22/17,16,0,0,4,0,20
1544,12/23/17,17,0,4,5,0,26
1545,12/24/17,11,0,2,0,0,13
1546,12/25/17,0,0,2,0,0,2
1547,12/26/17,20,0,4,9,0,33
1548,12/27/17,18,0,2,8,0,28
1549,12/28/17,14,0,3,4,0,21
1550,12/29/17,18,0,1,6,0,25
1551,12/30/17,26,0,0,8,0,34
1552,12/31/17,21,0,2,8,0,31
1553,1/1/18,7,0,5,1,0,13
1554,1/2/18,25,0,6,7,0,38
1555,1/3/18,24,0,0,2,0,26
1556,1/4/18,13,0,1,3,0,17
1557,1/5/18,18,0,0,8,0,26
1558,1/6/18,20,0,1,9,0,30
1559,1/7/18,18,0,0,4,0,22
1560,1/8/18,28,0,1,6,0,35
1561,1/9/18,13,0,4,4,0,21
1562,1/10/18,15,0,3,6,0,24
1563,1/11/18,13,0,2,2,0,17
1564,1/12/18,21,0,4,5,0,30
1565,1/13/18,18,0,1,6,0,25
1566,1/14/18,14,0,1,5,0,20
1567,1/15/18,15,0,1,16,0,32
1568,1/16/18,8,0,2,0,0,10
1569,1/17/18,33,0,3,7,0,43
1570,1/18/18,22,0,0,4,0,26
1571,1/19/18,9,0,3,1,0,13
1572,1/20/18,26,0,1,3,0,30
1573,1/21/18,18,0,4,8,0,30
1574,1/22/18,26,0,1,9,0,36
1575,1/23/18,13,0,2,13,0,28
1576,1/24/18,20,0,1,6,0,27
1577,1/25/18,15,0,1,6,0,22
1578,1/26/18,17,0,4,8,0,29
1579,1/27/18,16,0,2,5,0,23
1580,1/28/18,20,0,4,4,0,28
1581,1/29/18,16,0,2,6,0,24
1582,1/30/18,18,0,1,7,0,26
1583,1/31/18,18,0,3,5,0,26
1584,2/1/18,24,0,2,5,0,31
1585,2/2/18,11,0,2,4,0,17
1586,2/3/18,15,0,1,4,0,20
1587,2/4/18,16,0,3,10,0,29
1588,2/5/18,11,0,1,8,0,20
1589,2/6/18,17,0,1,5,0,23
1590,2/7/18,25,0,5,7,0,37
1591,2/8/18,27,0,2,5,0,34
1592,2/9/18,12,0,2,11,0,25
1593,2/10/18,17,0,4,2,0,23
1594,2/11/18,22,0,2,9,0,33
1595,2/12/18,12,0,2,6,0,20
1596,2/13/18,19,0,0,4,0,23
1597,2/14/18,15,0,2,5,0,22
1598,2/15/18,32,0,2,3,0,37
1599,2/16/18,24,0,0,3,0,27
1600,2/17/18,24,0,1,4,0,29
1601,2/18/18,17,0,1,8,0,26
1602,2/19/18,14,0,4,4,0,22
1603,2/20/18,16,0,1,8,0,25
1604,2/21/18,11,0,2,6,0,19
1605,2/22/18,9,0,1,6,0,16
1606,2/23/18,19,0,4,6,0,29
1607,2/24/18,29,0,2,2,0,33
1608,2/25/18,22,0,1,6,0,29
1609,2/26/18,23,0,4,6,0,33
1610,2/27/18,19,0,3,4,0,26
1611,2/28/18,21,0,2,6,0,29
1612,3/1/18,25,0,2,2,0,29
1613,3/2/18,23,0,1,6,0,30
1614,3/3/18,19,0,0,17,0,36
1615,3/4/18,14,0,0,5,0,19
1616,3/5/18,24,0,3,8,0,35
1617,3/6/18,43,0,2,3,0,48
1618,3/7/18,6,0,3,4,0,13
1619,3/8/18,21,0,6,6,0,33
1620,3/9/18,16,0,2,7,0,25
1621,3/10/18,18,0,2,6,0,26
1622,3/11/18,13,0,5,8,0,26
1623,3/12/18,13,0,2,6,0,21
1624,3/13/18,20,0,0,15,0,35
1625,3/14/18,15,0,4,3,0,22
1626,3/15/18,12,0,3,6,0,21
1627,3/16/18,10,0,0,3,0,13
1628,3/17/18,20,0,1,5,0,26
1629,3/18/18,15,0,2,7,0,24
1630,3/19/18,12,0,4,5,0,21
1631,3/20/18,21,0,2,10,0,33
1632,3/21/18,24,0,5,3,0,32
1633,3/22/18,19,0,3,3,0,25
1634,3/23/18,29,0,2,14,0,45
1635,3/24/18,23,0,3,4,0,30
1636,3/25/18,24,0,1,4,0,29
1637,3/26/18,17,0,4,6,0,27
1638,3/27/18,18,0,2,5,0,25
1639,3/28/18,27,0,5,5,0,37
1640,3/29/18,16,0,4,6,0,26
1641,3/30/18,29,0,3,4,0,36
1642,3/31/18,16,0,1,3,0,20
1643,4/1/18,18,0,4,8,0,30
1644,4/2/18,19,0,3,7,0,29
1645,4/3/18,11,0,4,6,0,21
1646,4/4/18,33,0,0,9,0,42
1647,4/5/18,19,0,6,7,0,32
1648,4/6/18,21,0,2,6,0,29
1649,4/7/18,19,0,2,10,0,31
1650,4/8/18,10,0,0,3,0,13
1651,4/9/18,9,0,4,8,0,21
1652,4/10/18,23,0,2,9,0,34
1653,4/11/18,13,0,4,6,0,23
1654,4/12/18,26,0,2,6,0,34
1655,4/13/18,15,0,1,6,0,22
1656,4/14/18,17,0,4,8,0,29
1657,4/15/18,12,0,2,10,0,24
1658,4/16/18,29,0,2,5,0,36
1659,4/17/18,19,0,9,7,0,35
1660,4/18/18,17,0,4,2,0,23
1661,4/19/18,9,0,1,4,0,14
1662,4/20/18,16,0,0,7,0,23
1663,4/21/18,11,0,3,5,0,19
1664,4/22/18,11,0,4,4,0,19
1665,4/23/18,13,0,5,6,0,24
1666,4/24/18,18,0,1,5,0,24
1667,4/25/18,23,0,5,7,0,35
1668,4/26/18,26,0,1,7,0,34
1669,4/27/18,24,0,2,5,0,31
1670,4/28/18,16,0,3,7,0,26
1671,4/29/18,14,0,0,5,0,19
1672,4/30/18,30,0,0,7,0,37
1673,5/1/18,11,0,2,13,0,26
1674,5/2/18,9,0,6,6,0,21
1675,5/3/18,19,0,5,4,0,28
1676,5/4/18,15,0,1,5,0,21
1677,5/5/18,18,0,2,10,0,30
1678,5/6/18,20,0,0,3,0,23
1679,5/7/18,21,0,0,9,0,30
1680,5/8/18,15,0,1,3,0,19
1681,5/9/18,17,0,2,7,0,26
1682,5/10/18,14,0,0,7,0,21
1683,5/11/18,13,0,1,11,0,25
1684,5/12/18,21,0,1,5,0,27
1685,5/13/18,14,0,4,4,0,22
1686,5/14/18,11,0,0,11,0,22
1687,5/15/18,18,0,5,4,0,27
1688,5/16/18,11,0,6,6,0,23
1689,5/17/18,8,0,2,5,0,15
1690,5/18/18,13,0,3,6,0,22
1691,5/19/18,17,0,2,11,0,30
1692,5/20/18,25,0,4,14,0,43
1693,5/21/18,20,0,1,7,0,28
1694,5/22/18,31,0,3,7,0,41
1695,5/23/18,21,0,2,2,0,25
1696,5/24/18,28,0,2,0,0,30
1697,5/25/18,11,0,0,7,0,18
1698,5/26/18,10,0,3,4,0,17
1699,5/27/18,25,0,1,4,0,30
1700,5/28/18,15,0,0,1,0,16
1701,5/29/18,31,0,2,6,0,39
1702,5/30/18,27,0,6,8,0,41
1703,5/31/18,9,0,2,8,0,19
1704,6/1/18,19,0,2,5,0,26
1705,6/2/18,17,0,1,18,0,36
1706,6/3/18,19,0,3,15,0,37
1707,6/4/18,20,0,3,9,0,32
1708,6/5/18,19,0,4,9,0,32
1709,6/6/18,17,0,1,13,0,31
1710,6/7/18,21,0,2,4,0,27
1711,6/8/18,21,0,3,7,0,31
1712,6/9/18,20,0,2,3,0,25
1713,6/10/18,17,0,0,4,0,21
1714,6/11/18,18,0,3,6,0,27
1715,6/12/18,15,0,1,5,0,21
1716,6/13/18,9,0,5,7,0,21
1717,6/14/18,16,0,1,14,0,31
1718,6/15/18,14,0,0,5,0,19
1719,6/16/18,21,0,3,2,0,26
1720,6/17/18,14,0,2,0,0,16
1721,6/18/18,19,0,1,11,0,31
1722,6/19/18,18,0,1,1,0,20
1723,6/20/18,28,0,0,8,0,36
1724,6/21/18,34,0,3,3,0,40
1725,6/22/18,17,0,1,3,0,21
1726,6/23/18,24,0,0,5,0,29
1727,6/24/18,12,0,0,2,0,14
1728,6/25/18,17,0,0,3,0,20
1729,6/26/18,12,0,4,2,0,18
1730,6/27/18,40,0,2,7,0,49
1731,6/28/18,20,0,1,6,0,27
1732,6/29/18,18,0,1,5,0,24
1733,6/30/18,11,0,2,4,0,17
1734,7/1/18,12,0,1,11,0,24
1735,7/2/18,30,0,4,7,0,41
1736,7/3/18,25,0,8,3,0,36
1737,7/4/18,13,0,2,5,0,20
1738,7/5/18,38,0,3,1,0,42
1739,7/6/18,38,0,1,3,0,42
1740,7/7/18,22,0,2,2,0,26
1741,7/8/18,21,0,2,3,0,26
1742,7/9/18,34,0,0,8,0,42
1743,7/10/18,20,0,7,8,0,35
1744,7/11/18,32,0,0,5,0,37
1745,7/12/18,16,0,4,2,0,22
1746,7/13/18,18,0,1,2,0,21
1747,7/14/18,22,0,1,10,0,33
1748,7/15/18,16,0,6,7,0,29
1749,7/16/18,14,0,5,5,0,24
1750,7/17/18,16,0,4,5,0,25
1751,7/18/18,20,0,1,4,0,25
1752,7/19/18,20,0,1,4,0,25
1753,7/20/18,20,0,1,4,0,25
1754,7/21/18,18,0,5,6,0,29
1755,7/22/18,10,0,0,5,0,15
1756,7/23/18,24,0,3,10,0,37
1757,7/24/18,22,0,0,6,0,28
1758,7/25/18,14,0,3,9,0,26
1759,7/26/18,8,0,3,4,0,15
1760,7/27/18,15,0,7,4,0,26
1761,7/28/18,17,0,2,4,0,23
1762,7/29/18,8,0,2,5,0,15
1763,7/30/18,5,0,3,7,0,15
1764,7/31/18,20,0,4,9,0,33
1765,8/1/18,13,0,2,8,0,23
1766,8/2/18,19,0,1,0,0,20
1767,8/3/18,19,0,3,5,0,27
1768,8/4/18,24,0,1,7,0,32
1769,8/5/18,21,0,1,6,0,28
1770,8/6/18,19,0,3,19,0,41
1771,8/7/18,16,0,5,23,0,44
1772,8/8/18,21,0,2,1,0,24
1773,8/9/18,19,0,2,7,0,28
1774,8/10/18,17,0,0,12,0,29
1775,8/11/18,15,0,0,1,0,16
1776,8/12/18,15,0,2,2,0,19
1777,8/13/18,25,0,3,2,0,30
1778,8/14/18,19,0,3,5,0,27
1779,8/15/18,22,0,4,2,0,28
1780,8/16/18,23,0,3,2,0,28
1781,8/17/18,21,0,1,5,0,27
1782,8/18/18,11,0,2,10,0,23
1783,8/19/18,20,0,2,5,0,27
1784,8/20/18,15,0,7,8,0,30
1785,8/21/18,8,0,3,5,0,16
1786,8/22/18,15,0,5,8,0,28
1787,8/23/18,15,0,2,10,0,27
1788,8/24/18,25,0,3,10,0,38
1789,8/25/18,13,0,3,5,0,21
1790,8/26/18,19,0,4,5,0,28
1791,8/27/18,12,0,2,4,0,18
1792,8/28/18,11,0,2,6,0,19
1793,8/29/18,26,0,1,4,0,31
1794,8/30/18,14,0,0,5,0,19
1795,8/31/18,18,0,4,6,0,28
1796,9/1/18,17,0,2,8,0,27
1797,9/2/18,17,0,5,6,0,28
1798,9/3/18,29,0,3,4,0,36
1799,9/4/18,13,0,1,6,0,20
1800,9/5/18,26,0,3,7,0,36
1801,9/6/18,15,0,2,3,0,20
1802,9/7/18,24,0,2,4,0,30
1803,9/8/18,29,0,1,8,0,38
1804,9/9/18,17,0,3,8,0,28
1805,9/10/18,38,0,2,7,0,47
1806,9/11/18,28,0,5,2,0,35
1807,9/12/18,19,0,7,7,0,33
1808,9/13/18,29,0,7,1,0,37
1809,9/14/18,21,0,1,6,0,28
1810,9/15/18,17,0,2,8,0,27
1811,9/16/18,19,0,0,5,0,24
1812,9/17/18,17,0,3,7,0,27
1813,9/18/18,14,0,1,5,0,20
1814,9/19/18,13,0,2,13,0,28
1815,9/20/18,25,0,3,6,0,34
1816,9/21/18,28,0,3,7,0,38
1817,9/22/18,25,0,1,11,0,37
1818,9/23/18,31,0,3,9,0,43
1819,9/24/18,35,0,1,9,0,45
1820,9/25/18,23,0,2,10,0,35
1821,9/26/18,12,0,1,5,0,18
1822,9/27/18,22,0,0,6,0,28
1823,9/28/18,18,0,3,4,0,25
1824,9/29/18,20,0,0,6,0,26
1825,9/30/18,18,0,1,6,0,25
1826,10/1/18,15,0,2,12,0,29
1827,10/2/18,13,0,4,2,0,19
1828,10/3/18,23,0,3,6,0,32
1829,10/4/18,23,0,2,6,0,31
1830,10/5/18,19,0,4,1,0,24
1831,10/6/18,31,0,3,8,0,42
1832,10/7/18,12,0,0,6,0,18
1833,10/8/18,20,0,6,7,0,33
1834,10/9/18,35,0,2,7,0,44
1835,10/10/18,35,0,0,4,0,39
1836,10/11/18,21,0,2,3,0,26
1837,10/12/18,25,0,0,8,0,33
1838,10/13/18,29,0,7,14,0,50
1839,10/14/18,24,0,2,2,0,28
1840,10/15/18,10,0,3,1,0,14
1841,10/16/18,16,0,1,0,0,17
1842,10/17/18,19,0,2,5,0,26
1843,10/18/18,19,0,1,3,0,23
1844,10/19/18,27,0,1,13,0,41
1845,10/20/18,38,0,5,6,0,49
1846,10/21/18,27,0,1,6,0,34
1847,10/22/18,30,0,5,4,0,39
1848,10/23/18,44,0,2,7,0,53
1849,10/24/18,18,0,3,6,0,27
1850,10/25/18,20,0,1,3,0,24
1851,10/26/18,9,0,1,5,0,15
1852,10/27/18,30,0,1,7,0,38
1853,10/28/18,9,0,1,4,0,14
1854,10/29/18,22,0,1,8,0,31
1855,10/30/18,24,0,2,5,0,31
1856,10/31/18,22,0,1,10,0,33
1857,11/1/18,17,0,3,7,0,27
1858,11/2/18,14,0,4,6,0,24
1859,11/3/18,15,0,1,3,0,19
1860,11/4/18,22,0,1,2,0,25
1861,11/5/18,22,0,3,7,0,32
1862,11/6/18,19,0,2,3,0,24
1863,11/7/18,22,0,5,6,0,33
1864,11/8/18,16,0,2,10,0,28
1865,11/9/18,30,0,1,5,0,36
1866,11/10/18,20,0,2,6,0,28
1867,11/11/18,28,0,1,1,0,30
1868,11/12/18,25,0,0,3,0,28
1869,11/13/18,20,0,4,4,0,28
1870,11/14/18,23,0,2,1,0,26
1871,11/15/18,16,0,9,3,0,28
1872,11/16/18,20,0,1,4,0,25
1873,11/17/18,18,0,3,6,0,27
1874,11/18/18,20,0,0,4,0,24
1875,11/19/18,34,0,4,3,0,41
1876,11/20/18,20,0,3,9,0,32
1877,11/21/18,23,0,0,3,0,26
1878,11/22/18,1,0,0,0,0,1
1879,11/23/18,32,0,1,7,0,40
1880,11/24/18,20,0,4,3,0,27
1881,11/25/18,26,0,1,5,0,32
1882,11/26/18,13,0,1,4,0,18
1883,11/27/18,14,0,1,10,0,25
1884,11/28/18,14,0,1,4,0,19
1885,11/29/18,16,0,3,6,0,25
1886,11/30/18,10,0,4,3,0,17
1887,12/1/18,18,0,4,3,0,25
1888,12/2/18,23,0,1,1,0,25
1889,12/3/18,26,0,4,14,0,44
1890,12/4/18,12,0,3,10,0,25
1891,12/5/18,20,0,4,7,0,31
1892,12/6/18,12,0,6,4,0,22
1893,12/7/18,22,0,0,10,0,32
1894,12/8/18,21,0,5,2,0,28
1895,12/9/18,20,0,3,1,0,24
1896,12/10/18,28,0,6,7,0,41
1897,12/11/18,15,0,6,1,0,22
1898,12/12/18,20,0,1,4,0,25
1899,12/13/18,22,0,4,3,0,29
1900,12/14/18,29,0,1,5,0,35
1901,12/15/18,16,0,1,8,0,25
1902,12/16/18,14,0,1,2,0,17
1903,12/17/18,13,0,1,3,0,17
1904,12/18/18,10,0,0,4,0,14
1905,12/19/18,17,0,1,7,0,25
1906,12/20/18,17,0,4,12,0,33
1907,12/21/18,17,0,3,7,0,27
1908,12/22/18,16,0,0,13,0,29
1909,12/23/18,25,0,0,3,0,28
1910,12/24/18,18,0,1,0,0,19
1911,12/25/18,4,0,0,0,0,4
1912,12/26/18,18,0,2,11,0,31
1913,12/27/18,28,0,6,12,0,46
1914,12/28/18,25,0,3,8,0,36
1915,12/29/18,10,0,0,6,0,16
1916,12/30/18,10,0,2,4,0,16
1917,12/31/18,17,0,2,7,0,26
1918,1/1/19,12,0,0,2,0,14
1919,1/2/19,38,0,4,4,0,46
1920,1/3/19,29,0,1,5,0,35
1921,1/4/19,20,0,3,7,0,30
1922,1/5/19,23,0,1,4,0,28
1923,1/6/19,20,0,3,7,0,30
1924,1/7/19,23,0,3,3,0,29
1925,1/8/19,24,0,0,2,0,26
1926,1/9/19,28,0,3,4,0,35
1927,1/10/19,28,0,2,3,0,33
1928,1/11/19,23,0,2,10,0,35
1929,1/12/19,23,0,4,7,0,34
1930,1/13/19,16,0,1,2,0,19
1931,1/14/19,25,0,0,9,0,34
1932,1/15/19,19,0,2,4,0,25
1933,1/16/19,13,0,1,8,0,22
1934,1/17/19,25,0,5,3,0,33
1935,1/18/19,26,0,7,5,0,38
1936,1/19/19,29,0,2,4,0,35
1937,1/20/19,19,0,0,6,0,25
1938,1/21/19,18,0,2,7,0,27
1939,1/22/19,16,0,0,13,0,29
1940,1/23/19,11,0,3,8,0,22
1941,1/24/19,6,0,2,7,0,15
1942,1/25/19,28,0,2,2,0,32
1943,1/26/19,17,0,3,12,0,32
1944,1/27/19,19,0,1,9,0,29
1945,1/28/19,9,0,3,3,0,15
1946,1/29/19,22,0,3,6,0,31
1947,1/30/19,23,0,2,2,0,27
1948,1/31/19,13,0,1,5,0,19
1949,2/1/19,20,0,2,10,0,32
1950,2/2/19,29,0,5,8,0,42
1951,2/3/19,13,0,1,2,0,16
1952,2/4/19,27,0,2,12,0,41
1953,2/5/19,19,0,2,6,0,27
1954,2/6/19,13,0,2,7,0,22
1955,2/7/19,24,0,1,8,0,33
1956,2/8/19,20,0,4,5,0,29
1957,2/9/19,15,0,3,5,0,23
1958,2/10/19,21,0,0,3,0,24
1959,2/11/19,10,0,2,8,0,20
1960,2/12/19,31,0,4,4,0,39
1961,2/13/19,24,0,0,7,0,31
1962,2/14/19,11,0,2,7,0,20
1963,2/15/19,15,0,3,9,0,27
1964,2/16/19,20,0,2,4,0,26
1965,2/17/19,14,0,0,8,0,22
1966,2/18/19,25,0,0,6,0,31
1967,2/19/19,11,0,2,16,0,29
1968,2/20/19,19,0,5,4,0,28
1969,2/21/19,25,0,2,3,0,30
1970,2/22/19,18,0,1,5,0,24
1971,2/23/19,17,0,0,4,0,21
1972,2/24/19,21,0,2,7,0,30
1973,2/25/19,16,0,0,8,0,24
1974,2/26/19,20,0,4,12,0,36
1975,2/27/19,11,0,2,7,0,20
1976,2/28/19,24,0,3,1,0,28
1977,3/1/19,24,0,4,7,0,35
1978,3/2/19,19,0,5,13,0,37
1979,3/3/19,25,0,2,6,0,33
1980,3/4/19,27,0,5,4,0,36
1981,3/5/19,31,0,1,12,0,44
1982,3/6/19,25,0,1,7,0,33
1983,3/7/19,27,0,3,12,0,42
1984,3/8/19,19,0,1,7,0,27
1985,3/9/19,22,0,1,5,0,28
1986,3/10/19,28,0,2,3,0,33
1987,3/11/19,23,0,1,7,0,31
1988,3/12/19,24,0,1,10,0,35
1989,3/13/19,19,0,2,4,0,25
1990,3/14/19,12,0,4,10,0,26
1991,3/15/19,23,0,1,4,0,28
1992,3/16/19,21,0,4,11,0,36
1993,3/17/19,11,0,2,7,0,20
1994,3/18/19,27,0,3,8,0,38
1995,3/19/19,23,0,5,2,0,30
1996,3/20/19,17,0,3,13,0,33
1997,3/21/19,39,0,2,5,0,46
1998,3/22/19,28,0,3,6,0,37
1999,3/23/19,13,0,4,13,0,30
2000,3/24/19,10,0,1,8,0,19
2001,3/25/19,16,0,6,11,0,33
2002,3/26/19,20,0,3,6,0,29
2003,3/27/19,18,0,6,4,0,28
2004,3/28/19,23,0,3,5,0,31
2005,3/29/19,12,0,3,5,0,20
2006,3/30/19,18,0,3,6,0,27
2007,3/31/19,26,0,3,4,0,33
2008,4/1/19,19,0,2,11,0,32
2009,4/2/19,8,0,4,8,0,20
2010,4/3/19,19,0,2,15,0,36
2011,4/4/19,16,0,4,7,0,27
2012,4/5/19,16,0,4,2,0,22
2013,4/6/19,14,0,0,4,0,18
2014,4/7/19,29,0,3,4,0,36
2015,4/8/19,35,0,0,6,0,41
2016,4/9/19,28,0,3,12,0,43
2017,4/10/19,30,0,1,4,0,35
2018,4/11/19,23,0,0,10,0,33
2019,4/12/19,16,0,5,1,0,22
2020,4/13/19,25,0,2,6,0,33
2021,4/14/19,16,0,3,6,0,25
2022,4/15/19,25,0,1,8,0,34
2023,4/16/19,13,0,3,10,0,26
2024,4/17/19,22,0,3,15,0,40
2025,4/18/19,33,0,0,6,0,39
2026,4/19/19,21,0,3,5,0,29
2027,4/20/19,16,0,0,6,0,22
2028,4/21/19,10,0,2,4,0,16
2029,4/22/19,19,0,3,8,0,30
2030,4/23/19,13,0,0,13,0,26
2031,4/24/19,10,0,1,4,0,15
2032,4/25/19,22,0,2,8,0,32
2033,4/26/19,30,0,2,16,0,48
2034,4/27/19,23,0,9,6,0,38
2035,4/28/19,21,0,1,3,0,25
2036,4/29/19,19,0,3,10,0,32
2037,4/30/19,15,0,4,5,0,24
2038,5/1/19,18,0,5,4,0,27
2039,5/2/19,23,0,1,8,0,32
2040,5/3/19,20,0,3,6,0,29
2041,5/4/19,36,0,2,9,0,47
2042,5/5/19,17,0,1,6,0,24
2043,5/6/19,27,0,3,7,0,37
2044,5/7/19,20,0,1,4,0,25
2045,5/8/19,34,0,1,8,0,43
2046,5/9/19,24,0,2,7,0,33
2047,5/10/19,29,0,4,5,0,38
2048,5/11/19,30,0,3,17,0,50
2049,5/12/19,21,0,1,2,0,24
2050,5/13/19,11,0,2,6,0,19
2051,5/14/19,18,0,1,1,0,20
2052,5/15/19,25,0,0,7,0,32
2053,5/16/19,17,0,3,4,0,24
2054,5/17/19,15,0,0,5,0,20
2055,5/18/19,28,0,1,8,0,37
2056,5/19/19,15,0,0,8,0,23
2057,5/20/19,29,0,4,20,0,53
2058,5/21/19,23,0,3,3,0,29
2059,5/22/19,15,0,1,3,0,19
2060,5/23/19,32,0,4,4,0,40
2061,5/24/19,20,0,1,11,0,32
2062,5/25/19,14,0,3,8,0,25
2063,5/26/19,14,0,2,3,0,19
2064,5/27/19,16,0,2,9,0,27
2065,5/28/19,35,0,3,12,0,50
2066,5/29/19,16,0,3,2,0,21
2067,5/30/19,25,0,3,9,0,37
2068,5/31/19,19,0,2,3,0,24
2069,6/1/19,19,0,3,3,0,25
2070,6/2/19,31,0,2,6,0,39
2071,6/3/19,37,0,2,6,0,45
2072,6/4/19,40,0,5,6,0,51
2073,6/5/19,20,0,2,14,0,36
2074,6/6/19,24,0,3,6,0,33
2075,6/7/19,22,0,4,5,0,31
2076,6/8/19,20,0,2,7,0,29
2077,6/9/19,17,0,2,6,0,25
2078,6/10/19,36,0,3,12,0,51
2079,6/11/19,20,0,3,8,0,31
2080,6/12/19,14,0,4,7,0,25
2081,6/13/19,22,0,2,8,0,32
2082,6/14/19,15,0,2,16,0,33
2083,6/15/19,22,0,2,1,0,25
2084,6/16/19,14,0,0,8,0,22
2085,6/17/19,33,0,1,10,0,44
2086,6/18/19,23,0,2,9,0,34
2087,6/19/19,34,0,1,4,0,39
2088,6/20/19,11,0,1,3,0,15
2089,6/21/19,23,0,4,9,0,36
2090,6/22/19,31,0,3,5,0,39
2091,6/23/19,20,0,1,4,0,25
2092,6/24/19,23,0,2,10,0,35
2093,6/25/19,22,0,2,6,0,30
2094,6/26/19,37,0,3,5,0,45
2095,6/27/19,22,0,2,13,0,37
2096,6/28/19,8,0,2,5,0,15
2097,6/29/19,12,0,3,1,0,16
2098,6/30/19,14,0,3,10,0,27
2099,7/1/19,25,0,3,11,0,39
2100,7/2/19,21,0,2,7,0,30
2101,7/3/19,26,0,3,5,0,34
2102,7/4/19,2,0,4,1,0,7
2103,7/5/19,42,0,5,12,0,59
2104,7/6/19,29,0,9,18,0,56
2105,7/7/19,12,0,10,8,0,30
2106,7/8/19,48,0,0,0,0,48
2107,7/9/19,10,0,4,1,0,15
2108,7/10/19,31,0,24,6,0,61
2109,7/11/19,32,0,3,9,0,44
2110,7/12/19,22,0,5,5,0,32
2111,7/13/19,18,0,2,13,0,33
2112,7/14/19,13,0,0,6,0,19
2113,7/15/19,17,0,3,9,0,29
2114,7/16/19,18,0,6,7,0,31
2115,7/17/19,16,0,5,7,0,28
2116,7/18/19,9,0,4,4,0,17
2117,7/19/19,19,0,1,7,0,27
2118,7/20/19,21,0,2,10,0,33
2119,7/21/19,18,0,1,3,0,22
2120,7/22/19,30,0,7,5,0,42
2121,7/23/19,13,0,4,7,0,24
2122,7/24/19,29,0,6,3,0,38
2123,7/25/19,9,0,1,2,0,12
2124,7/26/19,28,0,3,6,0,37
2125,7/27/19,12,0,2,16,0,30
2126,7/28/19,26,0,5,6,0,37
2127,7/29/19,17,0,2,10,0,29
2128,7/30/19,14,0,4,5,0,23
2129,7/31/19,29,0,4,7,0,40
2130,8/1/19,15,0,5,12,0,32
2131,8/2/19,20,0,4,4,0,28
2132,8/3/19,25,0,1,2,0,28
2133,8/4/19,26,0,0,9,0,35
2134,8/5/19,29,0,2,6,0,37
2135,8/6/19,22,0,1,3,0,26
2136,8/7/19,24,0,5,3,0,32
2137,8/8/19,10,0,1,3,0,14
2138,8/9/19,18,0,3,11,0,32
2139,8/10/19,12,0,3,3,0,18
2140,8/11/19,12,0,2,6,0,20
2141,8/12/19,23,0,4,4,0,31
2142,8/13/19,26,0,3,6,0,35
2143,8/14/19,9,0,2,2,0,13
2144,8/15/19,44,0,0,11,0,55
2145,8/16/19,23,0,1,11,0,35
2146,8/17/19,24,0,0,8,0,32
2147,8/18/19,19,0,4,3,0,26
2148,8/19/19,10,0,5,10,0,25
2149,8/20/19,22,0,3,10,0,35
2150,8/21/19,28,0,0,3,0,31
2151,8/22/19,21,0,0,11,0,32
2152,8/23/19,20,0,0,3,0,23
2153,8/24/19,27,0,0,6,0,33
2154,8/25/19,13,0,2,12,0,27
2155,8/26/19,22,0,0,6,0,28
2156,8/27/19,24,0,5,2,0,31
2157,8/28/19,19,0,1,10,0,30
2158,8/29/19,20,0,5,9,0,34
2159,8/30/19,14,0,6,5,0,25
2160,8/31/19,32,0,8,11,0,51
2161,9/1/19,13,0,0,6,0,19
2162,9/2/19,33,0,2,7,0,42
2163,9/3/19,21,0,12,9,0,42
2164,9/4/19,16,0,2,6,0,24
2165,9/5/19,22,0,2,2,0,26
2166,9/6/19,18,0,1,2,0,21
2167,9/7/19,14,0,2,2,0,18
2168,9/8/19,22,0,2,7,0,31
2169,9/9/19,21,0,1,9,0,31
2170,9/10/19,19,0,1,12,0,32
2171,9/11/19,29,0,3,12,0,44
2172,9/12/19,34,0,1,4,0,39
2173,9/13/19,19,0,1,9,0,29
2174,9/14/19,15,0,2,14,0,31
2175,9/15/19,18,0,2,7,0,27
2176,9/16/19,24,0,2,5,0,31
2177,9/17/19,33,0,2,7,0,42
2178,9/18/19,15,0,2,9,0,26
2179,9/19/19,23,0,1,2,0,26
2180,9/20/19,15,0,6,7,0,28
2181,9/21/19,36,0,1,13,0,50
2182,9/22/19,17,0,0,10,0,27
2183,9/23/19,23,0,0,18,0,41
2184,9/24/19,24,0,3,8,0,35
2185,9/25/19,13,0,2,4,0,19
2186,9/26/19,12,0,1,9,0,22
2187,9/27/19,22,0,2,11,0,35
2188,9/28/19,17,0,1,11,0,29
2189,9/29/19,11,0,1,22,0,34
2190,9/30/19,12,0,2,8,0,22
2191,10/1/19,23,0,1,9,0,33
2192,10/2/19,35,0,4,8,0,47
2193,10/3/19,19,0,1,17,0,37
2194,10/4/19,22,0,0,8,0,30
2195,10/5/19,24,0,2,12,0,38
2196,10/6/19,27,0,6,3,0,36
2197,10/7/19,20,0,0,4,0,24
2198,10/8/19,12,0,2,10,0,24
2199,10/9/19,14,0,1,6,0,21
2200,10/10/19,15,0,3,8,0,26
2201,10/11/19,27,0,1,5,0,33
2202,10/12/19,19,0,2,9,0,30
2203,10/13/19,25,0,6,4,0,35
2204,10/14/19,13,0,2,7,0,22
2205,10/15/19,11,0,2,4,0,17
2206,10/16/19,22,0,2,12,0,36
2207,10/17/19,14,0,1,3,0,18
2208,10/18/19,16,0,2,6,0,24
2209,10/19/19,16,0,0,15,0,31
2210,10/20/19,21,0,3,2,0,26
2211,10/21/19,32,0,0,5,0,37
2212,10/22/19,15,0,4,14,0,33
2213,10/23/19,18,0,4,25,0,47
2214,10/24/19,33,0,0,9,0,42
2215,10/25/19,19,0,0,14,0,33
2216,10/26/19,19,0,1,5,0,25
2217,10/27/19,14,0,0,5,0,19
2218,10/28/19,22,0,2,6,0,30
2219,10/29/19,14,0,1,2,0,17
2220,10/30/19,19,0,0,5,0,24
2221,10/31/19,28,0,0,7,0,35
2222,11/1/19,13,0,1,9,0,23
2223,11/2/19,13,0,1,15,0,29
2224,11/3/19,23,0,0,9,0,32
2225,11/4/19,20,0,2,7,0,29
2226,11/5/19,21,0,2,7,0,30
2227,11/6/19,14,0,1,12,0,27
2228,11/7/19,26,0,1,5,0,32
2229,11/8/19,18,0,1,4,0,23
2230,11/9/19,21,0,1,3,0,25
2231,11/10/19,26,0,0,15,0,41
2232,11/11/19,22,0,2,3,0,27
2233,11/12/19,13,0,0,2,0,15
2234,11/13/19,22,0,5,4,0,31
2235,11/14/19,36,0,2,4,0,42
2236,11/15/19,22,0,2,3,0,27
2237,11/16/19,14,0,0,6,0,20
2238,11/17/19,27,0,0,7,0,34
2239,11/18/19,28,0,4,8,0,40
2240,11/19/19,15,0,0,5,0,20
2241,11/20/19,21,0,0,8,0,29
2242,11/21/19,24,0,0,7,0,31
2243,11/22/19,22,0,0,8,0,30
2244,11/23/19,35,0,1,9,0,45
2245,11/24/19,13,0,0,5,0,18
2246,11/25/19,26,0,0,12,0,38
2247,11/26/19,16,0,2,3,0,21
2248,11/27/19,22,0,1,5,0,28
2249,11/28/19,2,0,0,0,0,2
2250,11/29/19,17,0,1,10,0,28
2251,11/30/19,21,0,0,14,0,35
2252,12/1/19,16,0,2,8,0,26
2253,12/2/19,24,0,0,6,0,30
2254,12/3/19,31,0,2,6,0,39
2255,12/4/19,22,0,1,6,0,29
2256,12/5/19,17,0,1,1,0,19
2257,12/6/19,13,0,2,4,0,19
2258,12/7/19,21,0,0,12,0,33
2259,12/8/19,26,0,2,2,0,30
2260,12/9/19,15,0,4,12,0,31
2261,12/10/19,11,0,2,9,0,22
2262,12/11/19,17,0,1,11,0,29
2263,12/12/19,14,0,2,3,0,19
2264,12/13/19,16,0,1,11,0,28
2265,12/14/19,17,0,2,12,0,31
2266,12/15/19,17,0,1,3,0,21
2267,12/16/19,19,0,2,6,0,27
2268,12/17/19,18,0,1,5,0,24
2269,12/18/19,39,0,4,5,0,48
2270,12/19/19,12,0,0,6,0,18
2271,12/20/19,11,0,2,8,0,21
2272,12/21/19,22,0,1,3,0,26
2273,12/22/19,15,0,0,13,0,28
2274,12/23/19,21,0,1,14,0,36
2275,12/24/19,0,0,2,0,0,2
,12/25/19,,,,,,
2276,12/26/19,30,0,0,4,0,34
2277,12/27/19,21,0,0,4,0,25
2278,12/28/19,14,0,3,4,0,21
2279,12/29/19,19,0,3,6,0,28
2280,12/30/19,25,0,1,6,0,32
2281,12/31/19,31,0,2,5,0,38
2282,1/1/20,9,0,0,0,0,9
2283,1/2/20,38,0,3,6,0,47
2284,1/3/20,29,0,1,5,0,35
2285,1/4/20,31,0,0,12,0,43
2286,1/5/20,20,0,3,4,0,27
2287,1/6/20,14,0,2,14,0,30
2288,1/7/20,25,0,1,7,0,33
2289,1/8/20,13,0,2,2,0,17
2290,1/9/20,19,0,0,0,0,19
2291,1/10/20,11,0,2,7,0,20
2292,1/11/20,18,0,0,10,0,28
2293,1/12/20,15,0,2,4,0,21
2294,1/13/20,18,0,2,7,0,27
2295,1/14/20,11,0,2,5,0,18
2296,1/15/20,17,0,3,8,0,28
2297,1/16/20,20,0,2,10,0,32
2298,1/17/20,21,0,1,6,0,28
2299,1/18/20,23,0,0,17,0,40
2300,1/19/20,19,0,0,5,0,24
2301,1/20/20,3,0,1,0,0,4
2302,1/21/20,25,0,1,10,0,36
2303,1/22/20,19,0,5,12,0,36
2304,1/23/20,29,0,0,10,0,39
2305,1/24/20,10,0,0,8,0,18
2306,1/25/20,17,0,1,14,0,32
2307,1/26/20,11,0,2,5,0,18
2308,1/27/20,20,0,1,10,0,31
2309,1/28/20,25,0,3,9,0,37
2310,1/29/20,13,0,1,19,0,33
2311,1/30/20,14,0,2,6,0,22
2312,1/31/20,18,0,3,7,0,28
2313,2/1/20,18,0,1,6,0,25
2314,2/2/20,16,0,1,4,0,21
2315,2/3/20,21,0,7,3,0,31
2316,2/4/20,16,0,2,6,0,24
2317,2/5/20,22,0,1,3,0,26
2318,2/6/20,19,0,1,6,0,26
2319,2/7/20,21,0,5,3,0,29
2320,2/8/20,25,0,0,6,0,31
2321,2/9/20,19,0,3,5,0,27
2322,2/10/20,13,0,1,1,0,15
2323,2/11/20,18,0,2,6,0,26
2324,2/12/20,8,0,1,0,0,9
2325,2/13/20,20,0,0,9,0,29
2326,2/14/20,35,0,1,6,0,42
2327,2/15/20,18,0,1,12,0,31
2328,2/16/20,16,0,2,8,0,26
2329,2/17/20,10,0,0,1,0,11
2330,2/18/20,18,0,0,15,0,33
2331,2/19/20,12,0,1,12,0,25
2332,2/20/20,18,0,0,6,0,24
2333,2/21/20,16,0,0,9,0,25
2334,2/22/20,13,0,0,9,0,22
2335,2/23/20,25,0,1,10,0,36
2336,2/24/20,22,0,4,4,0,30
2337,2/25/20,18,0,3,15,0,36
2338,2/26/20,26,0,0,10,0,36
2339,2/27/20,24,0,0,5,0,29
2340,2/28/20,16,0,1,11,0,28
2341,2/29/20,20,0,1,7,0,28
2342,3/1/20,16,0,2,7,0,25
2343,3/2/20,30,0,2,6,0,38
2344,3/3/20,20,0,2,14,0,36
2345,3/4/20,17,0,1,9,0,27
2346,3/5/20,13,0,1,14,0,28
2347,3/6/20,19,0,1,6,0,26
2348,3/7/20,25,0,0,4,0,29
2349,3/8/20,21,0,0,5,0,26
2350,3/9/20,23,0,2,7,0,32
2351,3/10/20,20,0,1,6,0,27
2352,3/11/20,26,0,2,6,0,34
2353,3/12/20,17,0,20,6,0,43
2354,3/13/20,13,0,6,13,0,32
2355,3/14/20,13,0,0,7,0,20
2356,3/15/20,19,0,2,14,0,35
2357,3/16/20,6,0,3,1,0,10
2358,3/17/20,4,0,0,0,0,4
2359,3/18/20,1,0,1,1,0,3
2360,3/19/20,1,0,0,1,0,2
2361,3/20/20,8,0,0,0,0,8
2362,3/21/20,3,0,3,0,0,6
2363,3/22/20,3,0,1,1,0,5
2364,3/23/20,16,0,0,0,0,16
2365,3/24/20,0,0,3,4,0,7
2366,3/25/20,1,0,2,1,0,4
2367,3/26/20,4,0,3,0,0,7
2368,3/27/20,0,0,1,0,0,1
2369,3/28/20,6,0,2,2,0,10
2370,3/29/20,3,0,0,2,0,5
2371,3/30/20,7,0,2,0,0,9
2372,3/31/20,3,0,1,0,0,4
2373,4/1/20,3,0,0,1,0,4
2374,4/2/20,6,0,2,1,0,9
2375,4/3/20,4,0,1,3,0,8
2376,4/4/20,2,0,1,1,0,4
2377,4/5/20,3,0,1,0,0,4
2378,4/6/20,2,0,1,0,0,3
2379,4/7/20,5,0,2,1,0,8
2380,4/8/20,8,0,2,0,0,10
2381,4/9/20,1,0,5,0,0,6
2382,4/10/20,5,0,2,0,0,7
2383,4/11/20,2,0,2,1,0,5
2384,4/12/20,2,0,0,0,0,2
2385,4/13/20,4,0,2,2,0,8
2386,4/14/20,10,0,2,3,0,15
2387,4/15/20,4,0,1,1,0,6
2388,4/16/20,4,0,1,0,0,5
2389,4/17/20,4,0,1,0,0,5
2390,4/18/20,3,0,1,5,0,9
2391,4/19/20,0,0,8,0,0,8
2392,4/20/20,1,0,1,0,0,2
,4/21/20,,,,,,
2393,4/22/20,5,0,0,1,0,6
2394,4/23/20,5,0,1,0,0,6
2395,4/24/20,3,0,0,3,0,6
2396,4/25/20,1,0,1,0,0,2
2397,4/26/20,2,0,1,1,0,4
2398,4/27/20,3,0,1,2,0,6
2399,4/28/20,8,0,3,1,0,12
2400,4/29/20,3,0,1,1,0,5
2401,4/30/20,4,0,1,0,0,5
2402,5/1/20,4,0,1,2,0,7
2403,5/2/20,1,0,1,2,0,4
2404,5/3/20,2,0,2,0,0,4
2405,5/4/20,1,0,1,1,0,3
2406,5/5/20,4,0,0,0,0,4
2407,5/6/20,6,0,1,0,0,7
2408,5/7/20,10,0,1,1,0,12
2409,5/8/20,9,0,2,4,0,15
2410,5/9/20,0,0,1,1,0,2
,5/10/20,,,,,,
2411,5/11/20,4,0,1,2,0,7
2412,5/12/20,5,0,2,1,0,8
2413,5/13/20,7,0,4,4,0,15
2414,5/14/20,4,0,1,1,0,6
2415,5/15/20,6,0,0,0,0,6
2416,5/16/20,3,0,1,4,0,8
2417,5/17/20,3,0,1,2,0,6
2418,5/18/20,1,0,1,1,0,3
2419,5/19/20,5,0,1,2,0,8
2420,5/20/20,2,0,0,2,0,4
2421,5/21/20,3,0,0,4,0,7
2422,5/22/20,4,0,0,6,0,10
2423,5/23/20,4,0,5,3,0,12
2424,5/24/20,12,0,2,0,0,14
2425,5/25/20,7,0,1,0,0,8
2426,5/26/20,7,0,1,6,0,14
2427,5/27/20,12,0,0,0,0,12
2428,5/28/20,5,0,1,0,0,6
2429,5/29/20,6,0,0,2,0,8
2430,5/30/20,12,0,1,0,0,13
2431,5/31/20,3,0,1,1,0,5
2432,6/1/20,7,0,0,7,0,14
2433,6/2/20,10,0,0,6,0,16
2434,6/3/20,11,0,0,6,0,17
2435,6/4/20,6,0,2,5,0,13
2436,6/5/20,5,0,0,4,0,9
2437,6/6/20,4,0,0,0,0,4
2438,6/7/20,6,0,0,1,0,7
2439,6/8/20,12,0,3,6,0,21
2440,6/9/20,10,0,4,1,0,15
2441,6/10/20,6,0,2,7,0,15
2442,6/11/20,7,0,1,4,0,12
2443,6/12/20,8,0,1,8,0,17
2444,6/13/20,5,0,7,0,0,12
2445,6/14/20,3,0,2,0,0,5
2446,6/15/20,13,0,4,4,0,21
2447,6/16/20,8,0,0,1,0,9
2448,6/17/20,4,0,1,4,0,9
2449,6/18/20,9,0,1,7,0,17
2450,6/19/20,1,0,2,1,0,4
2451,6/20/20,2,0,0,0,0,2
2452,6/21/20,6,0,0,1,0,7
2453,6/22/20,9,0,0,5,0,14
2454,6/23/20,13,0,1,4,0,18
2455,6/24/20,7,0,1,4,0,12
2456,6/25/20,9,0,1,4,0,14
2457,6/26/20,7,0,2,17,0,26
2458,6/27/20,6,0,1,1,0,8
2459,6/28/20,11,0,0,0,0,11
2460,6/29/20,13,0,1,3,0,17
2461,6/30/20,11,0,0,6,0,17
2462,7/1/20,6,0,0,5,0,11
2463,7/2/20,9,0,0,6,0,15
2464,7/3/20,3,0,4,0,0,7
2465,7/4/20,5,0,1,2,0,8
2466,7/5/20,9,0,0,0,0,9
2467,7/6/20,7,0,0,5,0,12
2468,7/7/20,14,0,1,3,0,18
2469,7/8/20,4,0,1,1,0,6
2470,7/9/20,8,0,2,3,0,13
2471,7/10/20,8,0,1,5,0,14
2472,7/11/20,5,0,0,0,0,5
2473,7/12/20,5,0,2,1,0,8
2474,7/13/20,11,0,1,2,0,14
2475,7/14/20,9,0,0,6,0,15
2476,7/15/20,14,0,0,3,0,17
2477,7/16/20,8,0,0,3,0,11
2478,7/17/20,10,0,3,1,0,14
2479,7/18/20,7,0,1,1,0,9
2480,7/19/20,5,0,0,0,0,5
2481,7/20/20,7,0,2,2,0,11
2482,7/21/20,2,0,0,1,0,3
2483,7/22/20,12,0,1,3,0,16
2484,7/23/20,9,0,1,4,0,14
2485,7/24/20,5,0,0,3,0,8
2486,7/25/20,4,0,1,2,0,7
2487,7/26/20,10,0,0,1,0,11
2488,7/27/20,6,0,0,6,0,12
2489,7/28/20,14,0,0,0,0,14
2490,7/29/20,5,0,1,5,0,11
2491,7/30/20,3,0,0,7,0,10
2492,7/31/20,5,0,1,4,0,10
2493,8/1/20,6,0,1,0,0,7
2494,8/2/20,25,0,1,0,0,26
2495,8/3/20,16,0,0,17,0,33
2496,8/4/20,7,0,1,4,0,12
2497,8/5/20,12,0,1,5,0,18
2498,8/6/20,13,0,0,7,0,20
2499,8/7/20,5,0,0,1,0,6
2500,8/8/20,4,0,0,2,0,6
2501,8/9/20,4,0,1,2,0,7
2502,8/10/20,5,0,0,5,0,10
2503,8/11/20,6,0,1,4,0,11
2504,8/12/20,5,0,2,3,0,10
2505,8/13/20,5,0,0,8,0,13
2506,8/14/20,7,0,2,3,0,12
2507,8/15/20,3,0,3,0,0,6
2508,8/16/20,4,0,0,0,0,4
2509,8/17/20,5,0,0,2,0,7
2510,8/18/20,15,0,6,5,0,26
2511,8/19/20,5,0,1,6,0,12
2512,8/20/20,8,0,0,5,0,13
2513,8/21/20,7,0,2,2,0,11
2514,8/22/20,6,0,1,0,0,7
2515,8/23/20,4,0,1,0,0,5
2516,8/24/20,8,0,0,5,0,13
2517,8/25/20,10,0,4,5,0,19
2518,8/26/20,5,0,1,7,0,13
2519,8/27/20,9,0,4,7,0,20
2520,8/28/20,19,0,3,5,0,27
2521,8/29/20,5,0,0,1,0,6
2522,8/30/20,7,0,0,1,0,8
2523,8/31/20,6,0,1,2,0,9
2524,9/1/20,14,0,0,4,0,18
2525,9/2/20,14,0,1,7,0,22
2526,9/3/20,8,0,1,10,0,19
2527,9/4/20,13,0,10,1,0,24
2528,9/5/20,8,0,1,0,0,9
2529,9/6/20,1,0,1,0,0,2
2530,9/7/20,4,0,1,0,0,5
2531,9/8/20,7,0,2,1,0,10
2532,9/9/20,11,0,0,1,0,12
2533,9/10/20,19,0,0,3,0,22
2534,9/11/20,6,0,2,6,0,14
2535,9/12/20,7,0,1,1,0,9
2536,9/13/20,8,0,2,0,0,10
2537,9/14/20,9,0,1,3,0,13
2538,9/15/20,8,0,1,4,0,13
2539,9/16/20,4,0,0,6,0,10
2540,9/17/20,7,0,2,2,0,11
2541,9/18/20,11,0,2,4,0,17
2542,9/19/20,9,0,1,1,0,11
2543,9/20/20,7,0,1,0,0,8
2544,9/21/20,12,0,0,3,0,15
2545,9/22/20,6,0,2,5,0,13
2546,9/23/20,13,0,0,4,0,17
2547,9/24/20,11,0,2,7,0,20
2548,9/25/20,6,0,1,4,0,11
2549,9/26/20,10,0,2,0,0,12
2550,9/27/20,6,0,0,0,0,6
2551,9/28/20,6,0,9,3,0,18
2552,9/29/20,8,0,0,7,0,15
2553,9/30/20,12,0,1,7,0,20
2554,10/1/20,14,0,2,18,0,34
2555,10/2/20,12,0,4,3,0,19
2556,10/3/20,7,0,1,1,0,9
2557,10/4/20,7,0,3,0,0,10
2558,10/5/20,12,0,2,9,0,23
2559,10/6/20,3,0,5,6,0,14
2560,10/7/20,6,0,2,3,0,11
2561,10/8/20,3,0,1,9,0,13
2562,10/9/20,5,0,4,6,0,15
2563,10/10/20,2,0,0,0,0,2
2564,10/11/20,2,0,0,1,0,3
2565,10/12/20,6,0,0,6,0,12
2566,10/13/20,13,0,1,7,0,21
2567,10/14/20,11,0,1,2,0,14
2568,10/15/20,8,0,1,3,0,12
2569,10/16/20,6,0,1,3,0,10
2570,10/17/20,2,0,0,1,0,3
2571,10/18/20,3,0,1,3,0,7
2572,10/19/20,8,0,0,0,0,8
2573,10/20/20,3,0,1,1,0,5
2574,10/21/20,14,0,0,7,0,21
2575,10/22/20,9,0,0,8,0,17
2576,10/23/20,18,0,2,0,0,20
2577,10/24/20,8,0,1,1,0,10
2578,10/25/20,5,0,0,1,0,6
2579,10/26/20,12,0,1,3,0,16
2580,10/27/20,16,0,3,6,0,25
2581,10/28/20,13,0,0,5,0,18
2582,10/29/20,17,0,1,8,0,26
2583,10/30/20,7,0,1,8,0,16
2584,10/31/20,4,0,0,2,0,6
2585,11/1/20,8,0,1,2,0,11
2586,11/2/20,12,0,0,2,0,14
2587,11/3/20,3,0,1,1,0,5
2588,11/4/20,9,0,0,9,0,18
2589,11/5/20,15,0,2,2,0,19
2590,11/6/20,7,0,0,5,0,12
2591,11/7/20,8,0,0,3,0,11
2592,11/8/20,10,0,0,1,0,11
2593,11/9/20,8,0,2,3,0,13
2594,11/10/20,14,0,3,7,0,24
2595,11/11/20,2,0,2,1,0,5
2596,11/12/20,9,0,1,13,0,23
2597,11/13/20,6,0,0,7,0,13
2598,11/14/20,8,0,0,0,0,8
2599,11/15/20,8,0,1,2,0,11
2600,11/16/20,6,0,1,4,0,11
2601,11/17/20,16,0,1,6,0,23
2602,11/18/20,6,0,2,8,0,16
2603,11/19/20,5,0,0,15,0,20
2604,11/20/20,9,0,0,6,0,15
2605,11/21/20,3,0,1,5,0,9
2606,11/22/20,9,0,0,1,0,10
2607,11/23/20,17,0,1,4,0,22
2608,11/24/20,14,0,1,4,0,19
2609,11/25/20,21,0,0,4,0,25
2610,11/26/20,2,0,4,2,0,8
2611,11/27/20,4,0,0,0,0,4
2612,11/28/20,6,0,2,0,0,8
2613,11/29/20,5,0,0,1,0,6
2614,11/30/20,19,0,1,4,0,24
2615,12/1/20,9,0,2,3,0,14
2616,12/2/20,13,0,2,10,0,25
2617,12/3/20,11,0,1,4,0,16
2618,12/4/20,11,0,1,10,0,22
2619,12/5/20,7,0,1,2,0,10
2620,12/6/20,12,0,2,1,0,15
2621,12/7/20,8,0,1,17,0,26
2622,12/8/20,5,0,1,7,0,13
2623,12/9/20,12,0,1,4,0,17
2624,12/10/20,15,0,2,10,0,27
2625,12/11/20,6,0,4,6,0,16
2626,12/12/20,4,0,0,1,0,5
2627,12/13/20,9,0,1,2,0,12
2628,12/14/20,9,0,0,6,0,15
2629,12/15/20,6,0,1,1,0,8
2630,12/16/20,13,0,2,4,0,19
2631,12/17/20,11,0,0,4,0,15
2632,12/18/20,12,0,0,7,0,19
2633,12/19/20,4,0,2,4,0,10
2634,12/20/20,5,0,2,0,0,7
2635,12/21/20,10,0,1,1,0,12
2636,12/22/20,14,0,0,2,0,16
2637,12/23/20,8,0,0,7,0,15
2638,12/24/20,3,0,3,0,0,6
2639,12/25/20,3,0,0,1,0,4
2640,12/26/20,5,0,1,0,0,6
2641,12/27/20,5,0,0,0,0,5
2642,12/28/20,14,0,4,4,0,22
2643,12/29/20,5,0,3,2,0,10
2644,12/30/20,9,0,0,3,0,12
2645,12/31/20,11,0,0,3,0,14
2646,1/1/21,2,0,2,0,0,4
2647,1/2/21,8,0,0,2,0,10
2648,1/3/21,9,0,0,0,0,9
2649,1/4/21,5,0,1,2,0,8
2650,1/5/21,16,0,0,2,0,18
2651,1/6/21,8,0,4,1,0,13
2652,1/7/21,9,0,1,1,0,11
2653,1/8/21,10,0,0,1,0,11
2654,1/9/21,3,0,1,1,0,5
2655,1/10/21,3,0,0,1,0,4
2656,1/11/21,10,0,2,4,0,16
2657,1/12/21,13,0,4,0,0,17
2658,1/13/21,11,0,0,1,0,12
2659,1/14/21,7,0,0,4,0,11
2660,1/15/21,9,0,1,0,0,10
2661,1/16/21,8,0,2,3,0,13
2662,1/17/21,5,0,0,2,0,7
2663,1/18/21,3,0,1,0,0,4
2664,1/19/21,7,0,2,6,0,15
2665,1/20/21,12,0,1,2,0,15
2666,1/21/21,10,0,1,10,0,21
2667,1/22/21,7,0,2,4,0,13
2668,1/23/21,7,0,1,0,0,8
2669,1/24/21,14,0,0,0,0,14
2670,1/25/21,11,0,1,3,0,15
2671,1/26/21,16,0,4,10,0,30
2672,1/27/21,13,0,1,3,0,17
2673,1/28/21,11,0,0,4,0,15
2674,1/29/21,6,0,0,7,0,13
2675,1/30/21,2,0,2,3,0,7
2676,1/31/21,4,0,2,0,0,6
2677,2/1/21,8,0,1,9,0,18
2678,2/2/21,9,0,7,5,0,21
2679,2/3/21,7,0,1,4,0,12
2680,2/4/21,8,0,3,3,0,14
2681,2/5/21,3,0,3,4,0,10
2682,2/6/21,2,0,1,0,0,3
2683,2/7/21,4,0,1,1,0,6
2684,2/8/21,12,0,1,3,0,16
2685,2/9/21,13,0,1,5,0,19
2686,2/10/21,8,0,0,6,0,14
2687,2/11/21,7,0,0,11,0,18
2688,2/12/21,7,0,1,0,0,8
2689,2/13/21,6,0,0,0,0,6
,2/14/21,,,,,,
,2/15/21,,,,,,
,2/16/21,,,,,,
2690,2/17/21,1,0,4,0,0,5
2691,2/18/21,0,0,2,0,0,2
2692,2/19/21,2,0,1,1,0,4
2693,2/20/21,8,0,3,1,0,12
2694,2/21/21,2,0,0,1,0,3
2695,2/22/21,11,0,1,7,0,19
2696,2/23/21,7,0,0,4,0,11
2697,2/24/21,1,0,2,1,0,4
2698,2/25/21,7,0,1,3,0,11
2699,2/26/21,10,0,1,1,0,12
2700,2/27/21,8,0,0,0,0,8
2701,2/28/21,5,0,0,0,0,5
2702,3/1/21,6,0,0,2,0,8
2703,3/2/21,16,0,1,9,0,26
2704,3/3/21,17,0,0,12,0,29
2705,3/4/21,3,0,1,2,0,6
2706,3/5/21,9,0,0,6,0,15
2707,3/6/21,1,0,1,0,0,2
2708,3/7/21,8,0,2,0,0,10
2709,3/8/21,15,0,1,3,0,19
2710,3/9/21,7,0,0,6,0,13
2711,3/10/21,9,0,1,5,0,15
2712,3/11/21,9,0,1,15,0,25
2713,3/12/21,6,0,1,5,0,12
2714,3/13/21,1,0,1,0,0,2
2715,3/14/21,5,0,1,1,0,7
2716,3/15/21,6,0,1,6,0,13
2717,3/16/21,6,0,5,4,0,15
2718,3/17/21,5,0,0,2,0,7
2719,3/18/21,3,0,2,14,0,19
2720,3/19/21,5,0,0,9,0,14
2721,3/20/21,7,0,0,1,0,8
2722,3/21/21,11,0,2,1,0,14
2723,3/22/21,12,0,3,3,0,18
2724,3/23/21,6,0,1,5,0,12
2725,3/24/21,11,0,0,10,0,21
2726,3/25/21,8,0,0,3,0,11
2727,3/26/21,9,0,0,6,0,15
2728,3/27/21,3,0,0,3,0,6
2729,3/28/21,10,0,1,2,0,13
2730,3/29/21,7,0,2,4,0,13
2731,3/30/21,3,0,0,14,0,17
2732,3/31/21,10,0,4,13,0,27
2733,4/1/21,6,0,1,4,0,11
2734,4/2/21,7,0,2,3,0,12
2735,4/3/21,4,0,0,0,0,4
2736,4/4/21,6,0,0,0,0,6
2737,4/5/21,15,0,2,3,0,20
2738,4/6/21,7,0,1,4,0,12
2739,4/7/21,7,0,1,2,0,10
2740,4/8/21,8,0,2,3,0,13
2741,4/9/21,4,0,1,5,0,10
2742,4/10/21,4,0,1,1,0,6
2743,4/11/21,6,0,0,1,0,7
2744,4/12/21,7,0,1,7,0,15
2745,4/13/21,24,0,2,5,0,31
2746,4/14/21,15,0,0,6,0,21
2747,4/15/21,10,0,2,4,0,16
2748,4/16/21,22,0,1,4,0,27
2749,4/17/21,11,0,0,0,0,11
2750,4/18/21,3,0,6,1,0,10
2751,4/19/21,12,0,2,5,0,19
2752,4/20/21,11,0,1,5,0,17
2753,4/21/21,14,0,0,17,0,31
2754,4/22/21,5,0,1,5,0,11
2755,4/23/21,15,0,2,5,0,22
2756,4/24/21,8,0,0,1,0,9
2757,4/25/21,5,0,1,0,0,6
2758,4/26/21,6,0,2,6,0,14
2759,4/27/21,5,0,1,3,0,9
2760,4/28/21,9,0,1,3,0,13
2761,4/29/21,14,0,1,7,0,22
2762,4/30/21,10,0,3,3,0,16
2763,5/1/21,8,0,1,2,0,11
2764,5/2/21,8,0,0,1,0,9
2765,5/3/21,13,0,0,12,0,25
2766,5/4/21,11,0,2,2,0,15
2767,5/5/21,7,0,0,6,0,13
2768,5/6/21,9,0,0,4,0,13
2769,5/7/21,7,0,2,5,0,14
2770,5/8/21,9,0,2,0,0,11
2771,5/9/21,6,0,1,2,0,9
2772,5/10/21,8,0,1,6,0,15
2773,5/11/21,10,0,0,2,0,12
2774,5/12/21,14,0,0,5,0,19
2775,5/13/21,10,0,5,7,0,22
2776,5/14/21,8,0,4,3,0,15
2777,5/15/21,16,0,0,1,0,17
2778,5/16/21,8,0,0,1,0,9
2779,5/17/21,9,0,3,5,0,17
2780,5/18/21,13,0,1,2,0,16
2781,5/19/21,9,0,0,4,0,13
2782,5/20/21,10,0,0,10,0,20
2783,5/21/21,5,0,0,4,0,9
2784,5/22/21,7,0,0,1,0,8
2785,5/23/21,8,0,3,0,0,11
2786,5/24/21,13,0,3,4,0,20
2787,5/25/21,17,0,2,9,0,28
2788,5/26/21,10,0,3,6,0,19
2789,5/27/21,18,0,0,7,0,25
2790,5/28/21,11,0,1,3,0,15
2791,5/29/21,6,0,1,2,0,9
2792,5/30/21,13,0,7,0,0,20
2793,5/31/21,5,0,2,4,0,11
2794,6/1/21,13,0,1,6,0,20
2795,6/2/21,11,0,1,5,0,17
2796,6/3/21,19,0,0,9,0,28
2797,6/4/21,10,0,1,5,0,16
2798,6/5/21,4,0,0,1,0,5
2799,6/6/21,8,0,1,1,0,10
2800,6/7/21,14,0,1,6,0,21
2801,6/8/21,9,0,1,12,0,22
2802,6/9/21,15,0,0,9,0,24
2803,6/10/21,21,0,1,4,0,26
2804,6/11/21,33,0,5,7,0,45
2805,6/12/21,10,0,11,3,0,24
2806,6/13/21,20,0,1,1,0,22
2807,6/14/21,7,0,1,2,0,10
2808,6/15/21,14,0,26,8,0,48
2809,6/16/21,19,0,2,7,0,28
2810,6/17/21,12,0,0,12,0,24
2811,6/18/21,6,0,3,0,0,9
2812,6/19/21,1,0,1,4,0,6
2813,6/20/21,8,0,1,0,0,9
2814,6/21/21,13,0,1,19,0,33
2815,6/22/21,8,0,1,10,0,19
2816,6/23/21,16,0,2,11,0,29
2817,6/24/21,7,0,0,7,0,14
2818,6/25/21,12,0,0,7,0,19
2819,6/26/21,8,0,0,5,0,13
2820,6/27/21,2,0,0,1,0,3
2821,6/28/21,18,0,1,6,0,25
2822,6/29/21,10,0,1,7,0,18
2823,6/30/21,14,0,1,5,0,20
2824,7/1/21,8,0,0,7,0,15
2825,7/2/21,26,0,1,8,0,35
2826,7/3/21,7,0,2,2,0,11
2827,7/4/21,7,0,3,1,0,11
2828,7/5/21,3,0,4,1,0,8
2829,7/6/21,21,0,4,9,0,34
2830,7/7/21,24,0,1,12,0,37
2831,7/8/21,31,0,1,7,0,39
2832,7/9/21,15,0,1,8,0,24
2833,7/10/21,9,0,0,1,0,10
2834,7/11/21,2,0,0,1,0,3
2835,7/12/21,20,0,0,7,0,27
2836,7/13/21,22,0,0,5,0,27
2837,7/14/21,11,0,5,12,0,28
2838,7/15/21,17,0,0,5,0,22
2839,7/16/21,17,0,0,11,0,28
2840,7/17/21,15,0,1,2,0,18
2841,7/18/21,9,0,0,2,0,11
2842,7/19/21,10,0,2,7,0,19
2843,7/20/21,19,0,1,4,0,24
2844,7/21/21,13,0,1,3,0,17
2845,7/22/21,17,0,0,6,0,23
2846,7/23/21,12,0,4,13,0,29
2847,7/24/21,15,0,2,0,0,17
2848,7/25/21,4,0,0,1,0,5
2849,7/26/21,7,0,0,6,0,13
2850,7/27/21,11,0,2,8,0,21
2851,7/28/21,15,0,1,16,0,32
2852,7/29/21,15,0,0,17,0,32
2853,7/30/21,8,0,1,9,0,18
2854,7/31/21,8,0,2,2,0,12
2855,8/1/21,4,0,0,3,0,7
2856,8/2/21,21,0,0,8,0,29
2857,8/3/21,18,0,1,13,0,32
2858,8/4/21,15,0,2,8,0,25
2859,8/5/21,9,0,0,7,0,16
2860,8/6/21,14,0,0,7,0,21
2861,8/7/21,9,0,0,7,0,16
2862,8/8/21,7,0,1,1,0,9
2863,8/9/21,8,0,1,16,0,25
2864,8/10/21,13,0,2,4,0,19
2865,8/11/21,6,0,1,12,0,19
2866,8/12/21,14,0,2,6,0,22
2867,8/13/21,13,0,1,1,0,15
2868,8/14/21,3,0,2,2,0,7
2869,8/15/21,3,0,1,0,0,4
2870,8/16/21,20,0,2,17,0,39
2871,8/17/21,18,0,0,9,0,27
2872,8/18/21,11,0,3,6,0,20
2873,8/19/21,9,0,2,11,0,22
2874,8/20/21,14,0,1,6,0,21
2875,8/21/21,5,0,0,2,0,7
2876,8/22/21,15,0,2,1,0,18
2877,8/23/21,11,0,3,14,0,28
2878,8/24/21,15,0,1,9,0,25
2879,8/25/21,17,0,0,1,0,18
2880,8/26/21,5,0,0,20,0,25
2881,8/27/21,19,0,0,7,0,26
2882,8/28/21,8,0,2,4,0,14
2883,8/29/21,3,0,2,1,0,6
2884,8/30/21,21,0,1,8,0,30
2885,8/31/21,12,0,1,13,0,26
2886,9/1/21,13,0,0,9,0,22
2887,9/2/21,12,0,1,3,0,16
2888,9/3/21,12,0,1,9,0,22
2889,9/4/21,12,0,1,2,0,15
2890,9/5/21,5,0,0,2,0,7
2891,9/6/21,2,0,1,0,0,3
2892,9/7/21,12,0,4,5,0,21
2893,9/8/21,12,0,1,9,0,22
2894,9/9/21,17,0,1,4,0,22
2895,9/10/21,12,0,0,9,0,21
2896,9/11/21,4,0,1,2,0,7
2897,9/12/21,9,0,1,11,0,21
2898,9/13/21,12,0,0,7,0,19
2899,9/14/21,15,0,2,9,0,26
2900,9/15/21,12,0,3,11,0,26
2901,9/16/21,13,0,4,8,0,25
2902,9/17/21,25,0,0,9,0,34
2903,9/18/21,9,0,0,2,0,11
2904,9/19/21,2,0,2,3,0,7
2905,9/20/21,13,0,1,5,0,19
2906,9/21/21,21,0,0,17,0,38
2907,9/22/21,12,0,0,7,0,19
2908,9/23/21,14,0,1,8,0,23
2909,9/24/21,13,0,3,10,0,26
2910,9/25/21,10,0,1,1,0,12
2911,9/26/21,8,0,0,0,0,8
2912,9/27/21,14,0,1,8,0,23
2913,9/28/21,9,0,0,9,0,18
2914,9/29/21,13,0,0,25,0,38
2915,9/30/21,8,0,9,13,0,30
2916,10/1/21,10,0,0,12,0,22
2917,10/2/21,11,1,1,4,0,17
2918,10/3/21,9,0,2,2,0,13
2919,10/4/21,8,0,0,5,0,13
2920,10/5/21,12,0,0,9,0,21
2921,10/6/21,16,0,1,9,0,26
2922,10/7/21,13,0,0,16,0,29
2923,10/8/21,12,0,0,9,0,21
2924,10/9/21,7,0,2,2,0,11
2925,10/10/21,6,0,0,2,0,8
2926,10/11/21,13,0,1,13,0,27
2927,10/12/21,13,0,0,9,0,22
2928,10/13/21,14,0,2,6,0,22
2929,10/14/21,11,0,2,7,0,20
2930,10/15/21,13,0,0,7,0,20
2931,10/16/21,9,0,1,0,0,10
2932,10/17/21,14,0,1,0,0,15
2933,10/18/21,19,0,0,5,0,24
2934,10/19/21,13,0,2,4,0,19
2935,10/20/21,26,0,1,6,0,33
2936,10/21/21,12,0,1,4,0,17
2937,10/22/21,16,0,0,4,0,20
2938,10/23/21,8,0,1,1,0,10
2939,10/24/21,9,0,1,1,0,11
2940,10/25/21,19,0,1,8,0,28
2941,10/26/21,9,0,3,8,0,20
2942,10/27/21,17,0,0,4,0,21
2943,10/28/21,15,0,0,6,0,21
2944,10/29/21,11,0,0,5,0,16
2945,10/30/21,7,0,2,0,0,9
2946,10/31/21,7,0,4,2,0,13
2947,11/1/21,10,0,1,12,0,23
2948,11/2/21,8,0,1,10,0,19
2949,11/3/21,12,0,4,5,0,21
2950,11/4/21,9,0,0,10,0,19
2951,11/5/21,23,0,0,9,0,32
2952,11/6/21,8,0,0,4,0,12
2953,11/7/21,6,0,0,0,0,6
2954,11/8/21,11,0,1,8,0,20
2955,11/9/21,16,0,0,8,0,24
2956,11/10/21,13,0,3,19,0,35
2957,11/11/21,6,0,1,0,0,7
2958,11/12/21,19,0,4,5,0,28
2959,11/13/21,9,0,0,2,0,11
2960,11/14/21,3,0,0,2,0,5
2961,11/15/21,9,0,1,19,0,29
2962,11/16/21,8,0,5,6,0,19
2963,11/17/21,25,0,1,11,0,37
2964,11/18/21,12,0,1,18,0,31
2965,11/19/21,10,0,0,5,0,15
2966,11/20/21,6,0,0,1,0,7
2967,11/21/21,8,0,0,1,0,9
2968,11/22/21,16,0,2,11,0,29
2969,11/23/21,23,0,2,3,0,28
2970,11/24/21,11,0,5,10,0,26
2971,11/25/21,3,0,0,0,0,3
2972,11/26/21,4,0,5,0,0,9
2973,11/27/21,7,0,0,2,0,9
2974,11/28/21,7,0,1,4,0,12
2975,11/29/21,16,0,2,9,0,27
2976,11/30/21,7,0,0,5,0,12
2977,12/1/21,13,0,0,3,0,16
2978,12/2/21,19,0,0,15,0,34
2979,12/3/21,14,0,2,9,0,25
2980,12/4/21,12,0,3,2,0,17
2981,12/5/21,9,0,1,2,0,12
2982,12/6/21,23,0,4,12,0,39
2983,12/7/21,9,0,0,1,0,10
2984,12/8/21,8,0,0,13,0,21
2985,12/9/21,16,0,1,4,0,21
2986,12/10/21,8,0,2,9,0,19
2987,12/11/21,8,0,5,1,0,14
2988,12/12/21,6,0,0,0,0,6
2989,12/13/21,19,0,2,12,0,33
2990,12/14/21,13,0,4,8,0,25
2991,12/15/21,10,0,3,5,0,18
2992,12/16/21,10,0,2,4,0,16
2993,12/17/21,19,0,0,10,0,29
2994,12/18/21,8,0,0,1,0,9
2995,12/19/21,5,0,2,2,0,9
2996,12/20/21,21,0,1,8,0,30
2997,12/21/21,12,0,1,9,0,22
2998,12/22/21,5,0,1,18,0,24
2999,12/23/21,9,0,0,3,0,12
3000,12/24/21,3,0,1,0,0,4
,12/25/21,,,,,,
3001,12/26/21,15,0,0,3,0,18
3002,12/27/21,23,0,2,11,0,36
3003,12/28/21,21,0,12,7,0,40
3004,12/29/21,28,0,0,10,0,38
3005,12/30/21,9,0,0,6,0,15
3006,12/31/21,27,0,0,5,0,32
3007,1/1/22,2,0,0,0,0,2
3008,1/2/22,16,0,1,4,0,21
3009,1/3/22,23,0,0,7,0,30
3010,1/4/22,12,0,0,16,0,28
3011,1/5/22,9,0,1,4,0,14
3012,1/6/22,14,0,3,5,0,22
3013,1/7/22,20,0,2,5,0,27
3014,1/8/22,19,0,2,0,0,21
3015,1/9/22,5,0,1,0,0,6
3016,1/10/22,13,0,4,19,0,36
3017,1/11/22,11,0,0,11,0,22
3018,1/12/22,8,0,2,9,0,19
3019,1/13/22,15,0,0,5,0,20
3020,1/14/22,9,0,1,10,0,20
3021,1/15/22,15,0,0,0,0,15
3022,1/16/22,6,0,0,3,0,9
3023,1/17/22,7,0,2,0,0,9
3024,1/18/22,27,0,1,9,0,37
3025,1/19/22,15,0,3,6,0,24
3026,1/20/22,8,0,4,6,0,18
3027,1/21/22,31,0,1,11,0,43
3028,1/22/22,7,0,0,5,0,12
,1/23/22,,,,,,
3029,1/24/22,13,0,2,8,0,23
3030,1/25/22,15,0,2,6,0,23
3031,1/26/22,23,0,2,5,0,30
3032,1/27/22,17,0,1,5,0,23
3033,1/28/22,10,0,0,4,0,14
3034,1/29/22,9,0,1,4,0,14
3035,1/30/22,7,0,0,0,0,7
3036,1/31/22,17,0,3,15,0,35
3037,2/1/22,19,0,0,5,0,24
3038,2/2/22,14,0,2,17,0,33
3039,2/3/22,6,0,2,0,0,8
3040,2/4/22,2,0,1,0,0,3
3041,2/5/22,13,0,3,2,0,18
3042,2/6/22,2,0,0,0,0,2
3043,2/7/22,18,0,3,12,0,33
3044,2/8/22,12,0,5,19,0,36
3045,2/9/22,13,0,2,4,0,19
3046,2/10/22,17,0,1,12,0,30
3047,2/11/22,13,0,4,4,0,21
3048,2/12/22,7,0,0,2,0,9
3049,2/13/22,3,0,0,0,0,3
3050,2/14/22,19,0,1,6,0,26
3051,2/15/22,24,0,1,4,0,29
3052,2/16/22,10,0,0,4,0,14
3053,2/17/22,12,0,0,4,0,16
3054,2/18/22,22,0,1,7,0,30
3055,2/19/22,7,0,1,0,0,8
3056,2/20/22,3,0,0,0,0,3
3057,2/21/22,24,0,3,0,0,27
3058,2/22/22,11,0,5,7,0,23
3059,2/23/22,16,0,3,2,0,21
3060,2/24/22,20,0,2,2,0,24
3061,2/25/22,13,0,1,3,0,17
3062,2/26/22,5,0,1,1,0,7
3063,2/27/22,4,0,0,1,0,5
3064,2/28/22,8,0,1,5,0,14
3065,3/1/22,14,0,1,6,0,21
3066,3/2/22,12,0,5,4,0,21
3067,3/3/22,15,0,6,11,0,32
3068,3/4/22,13,0,4,9,0,26
3069,3/5/22,13,0,1,4,0,18
3070,3/6/22,5,0,0,0,0,5
3071,3/7/22,14,0,3,7,0,24
3072,3/8/22,16,0,0,4,0,20
3073,3/9/22,13,0,0,4,0,17
3074,3/10/22,11,0,2,4,0,17
3075,3/11/22,15,0,3,4,0,22
3076,3/12/22,8,0,0,0,0,8
3077,3/13/22,5,0,1,0,0,6
3078,3/14/22,7,0,0,7,0,14
3079,3/15/22,15,0,3,5,0,23
3080,3/16/22,16,0,3,2,0,21
3081,3/17/22,9,0,2,9,0,20
3082,3/18/22,24,0,1,3,0,28
3083,3/19/22,7,0,0,3,0,10
3084,3/20/22,3,0,1,1,0,5
3085,3/21/22,7,0,1,1,0,9
3086,3/22/22,16,0,0,11,0,27
3087,3/23/22,6,0,0,2,0,8
3088,3/24/22,18,0,0,5,0,23
3089,3/25/22,8,0,1,3,0,12
3090,3/26/22,9,0,3,2,0,14
3091,3/27/22,1,0,1,0,0,2
3092,3/28/22,11,0,1,6,0,18
3093,3/29/22,11,0,0,10,0,21
3094,3/30/22,22,0,0,10,0,32
3095,3/31/22,4,0,2,9,0,15
3096,4/1/22,16,0,22,2,0,40
3097,4/2/22,10,0,1,0,0,11
3098,4/3/22,3,0,0,1,0,4
3099,4/4/22,30,0,4,14,0,48
3100,4/5/22,16,0,3,4,0,23
3101,4/6/22,5,0,2,2,0,9
3102,4/7/22,15,0,2,3,0,20
3103,4/8/22,10,0,0,6,0,16
3104,4/9/22,4,0,0,0,0,4
3105,4/10/22,7,0,1,0,0,8
3106,4/11/22,33,0,2,7,0,42
3107,4/12/22,14,0,0,8,0,22
3108,4/13/22,19,0,3,6,0,28
3109,4/14/22,9,0,1,11,0,21
3110,4/15/22,11,0,0,10,0,21
3111,4/16/22,6,0,1,3,0,10
3112,4/17/22,2,0,2,1,0,5
3113,4/18/22,14,0,0,5,0,19
3114,4/19/22,14,0,2,5,0,21
3115,4/20/22,7,0,1,2,0,10
3116,4/21/22,10,0,3,4,0,17
3117,4/22/22,22,0,4,14,0,40
3118,4/23/22,11,0,1,11,0,23
3119,4/24/22,2,0,1,0,0,3
3120,4/25/22,11,0,0,3,0,14
3121,4/26/22,18,0,0,5,0,23
3122,4/27/22,18,0,0,4,0,22
3123,4/28/22,11,0,2,3,0,16
3124,4/29/22,16,0,8,4,0,28
3125,4/30/22,5,0,0,0,0,5
3126,5/1/22,4,0,0,0,0,4
3127,5/2/22,39,0,1,9,0,49
3128,5/3/22,17,0,1,3,0,21
3129,5/4/22,11,0,2,7,0,20
3130,5/5/22,16,0,5,1,0,22
3131,5/6/22,15,0,2,6,0,23
3132,5/7/22,4,0,2,0,0,6
3133,5/8/22,4,0,0,1,0,5
3134,5/9/22,16,0,3,10,0,29
3135,5/10/22,5,0,5,5,0,15
3136,5/11/22,22,0,1,5,0,28
3137,5/12/22,16,0,8,2,0,26
3138,5/13/22,23,0,3,5,0,31
3139,5/14/22,5,0,2,0,0,7
3140,5/15/22,3,0,1,0,0,4
3141,5/16/22,12,0,2,10,0,24
3142,5/17/22,8,0,0,5,0,13
3143,5/18/22,14,0,6,4,0,24
3144,5/19/22,25,0,1,2,0,28
3145,5/20/22,12,0,1,4,0,17
3146,5/21/22,12,0,1,1,0,14
3147,5/22/22,3,0,1,0,0,4
3148,5/23/22,30,0,3,11,0,44
3149,5/24/22,12,0,4,2,0,18
3150,5/25/22,18,0,0,8,0,26
3151,5/26/22,14,0,2,7,0,23
3152,5/27/22,10,0,0,1,0,11
3153,5/28/22,5,0,3,1,0,9
3154,5/29/22,3,0,1,1,0,5
3155,5/30/22,5,0,0,7,0,12
3156,5/31/22,21,0,2,3,0,26
3157,6/1/22,36,0,0,4,0,40
3158,6/2/22,7,0,1,6,0,14
3159,6/3/22,8,0,1,2,0,11
3160,6/4/22,9,0,2,0,0,11
3161,6/5/22,4,0,0,0,0,4
3162,6/6/22,5,0,2,2,0,9
3163,6/7/22,13,0,1,12,0,26
3164,6/8/22,11,0,2,7,0,20
3165,6/9/22,13,0,0,2,0,15
3166,6/10/22,16,0,2,3,0,21
3167,6/11/22,7,0,0,6,0,13
3168,6/12/22,6,0,1,0,0,7
3169,6/13/22,10,0,0,5,0,15
3170,6/14/22,13,0,0,4,0,17
3171,6/15/22,25,0,4,7,0,36
3172,6/16/22,34,0,0,3,0,37
3173,6/17/22,7,0,2,4,0,13
3174,6/18/22,3,0,0,1,0,4
3175,6/19/22,1,0,3,0,0,4
3176,6/20/22,22,0,3,3,0,28
3177,6/21/22,11,0,6,3,0,20
3178,6/22/22,25,0,3,5,0,33
3179,6/23/22,20,0,4,9,0,33
3180,6/24/22,14,0,1,7,0,22
3181,6/25/22,13,0,0,3,0,16
3182,6/26/22,1,0,0,0,0,1
3183,6/27/22,19,0,2,7,0,28
3184,6/28/22,12,0,1,6,0,19
3185,6/29/22,20,0,2,5,0,27
3186,6/30/22,15,0,0,8,0,23
3187,7/1/22,10,0,2,17,0,29
,7/2/22,,,,,,
3188,7/3/22,2,0,0,0,0,2
3189,7/4/22,3,0,1,0,0,4
3190,7/5/22,6,0,1,6,0,13
3191,7/6/22,26,0,4,15,0,45
3192,7/7/22,16,0,10,10,0,36
3193,7/8/22,25,0,0,5,0,30
3194,7/9/22,7,0,0,1,0,8
3195,7/10/22,4,0,0,0,0,4
3196,7/11/22,24,0,1,1,0,26
3197,7/12/22,22,0,10,14,0,46
3198,7/13/22,11,0,7,2,0,20
3199,7/14/22,26,0,2,3,0,31
3200,7/15/22,14,0,0,2,0,16
3201,7/16/22,8,0,1,1,0,10
3202,7/17/22,11,0,0,0,0,11
3203,7/18/22,24,0,3,7,0,34
3204,7/19/22,15,0,1,6,0,22
3205,7/20/22,15,0,3,15,0,33
3206,7/21/22,18,0,7,2,0,27
3207,7/22/22,8,0,0,42,0,50
3208,7/23/22,15,0,3,10,0,28
3209,7/24/22,1,0,0,11,0,12
3210,7/25/22,19,0,2,13,0,34
3211,7/26/22,8,0,4,5,0,17
3212,7/27/22,26,0,11,7,0,44
3213,7/28/22,13,0,0,3,0,16
3214,7/29/22,11,0,0,8,0,19
3215,7/30/22,23,0,5,1,0,29
,7/31/22,,,,,,
3216,8/1/22,32,0,0,5,0,37
3217,8/2/22,12,0,0,3,0,15
3218,8/3/22,19,0,0,12,0,31
3219,8/4/22,13,0,0,10,0,23
3220,8/5/22,17,0,0,7,0,24
3221,8/6/22,10,0,1,0,0,11
3222,8/7/22,3,0,2,0,0,5
3223,8/8/22,11,0,1,6,0,18
3224,8/9/22,13,0,4,2,0,19
3225,8/10/22,9,0,1,7,0,17
3226,8/11/22,21,0,3,3,0,27
3227,8/12/22,15,0,1,3,0,19
3228,8/13/22,7,0,2,1,0,10
3229,8/14/22,2,0,1,0,0,3
3230,8/15/22,18,0,1,4,0,23
3231,8/16/22,25,0,5,5,0,35
3232,8/17/22,18,0,5,3,0,26
3233,8/18/22,15,0,2,5,0,22
3234,8/19/22,26,0,1,6,0,33
3235,8/20/22,3,0,0,1,0,4
3236,8/21/22,5,0,0,0,0,5
3237,8/22/22,18,0,0,3,0,21
3238,8/23/22,16,0,1,10,0,27
3239,8/24/22,13,0,3,7,0,23
3240,8/25/22,11,0,4,5,0,20
3241,8/26/22,14,0,1,13,0,28
3242,8/27/22,9,0,1,2,0,12
3243,8/28/22,2,0,1,0,0,3
3244,8/29/22,28,0,3,5,0,36
3245,8/30/22,12,0,1,10,0,23
3246,8/31/22,8,0,0,11,0,19
3247,9/1/22,33,0,1,6,0,40
3248,9/2/22,10,0,1,6,0,17
3249,9/3/22,12,0,0,0,0,12
3250,9/4/22,4,0,1,0,0,5
3251,9/5/22,7,0,0,0,0,7
3252,9/6/22,20,0,2,4,0,26
3253,9/7/22,20,0,1,8,0,29
3254,9/8/22,15,0,4,7,0,26
3255,9/9/22,14,0,1,1,0,16
3256,9/10/22,12,0,1,1,0,14
3257,9/11/22,2,0,1,0,0,3
3258,9/12/22,17,0,0,4,0,21
3259,9/13/22,5,0,0,7,0,12
3260,9/14/22,3,0,0,2,0,5
3261,9/15/22,0,0,0,1,0,1
3262,9/16/22,2,0,0,5,0,7
3263,9/17/22,6,0,0,1,0,7
3264,9/18/22,3,0,1,0,0,4
3265,9/19/22,5,0,1,3,0,9
3266,9/20/22,5,0,2,3,0,10
3267,9/21/22,5,0,0,9,0,14
3268,9/22/22,11,0,0,7,0,18
3269,9/23/22,8,0,1,8,0,17
3270,9/24/22,3,0,0,4,0,7
3271,9/25/22,4,0,0,2,0,6
3272,9/26/22,11,0,1,2,0,14
3273,9/27/22,10,0,0,4,0,14
3274,9/28/22,7,0,0,6,0,13
3275,9/29/22,13,0,0,3,0,16
3276,9/30/22,9,0,1,3,0,13
3277,10/1/22,6,0,0,2,0,8
3278,10/2/22,7,0,4,1,0,12
3279,10/3/22,10,0,1,0,0,11
3280,10/4/22,4,0,7,3,0,14
3281,10/5/22,7,0,0,3,0,10
3282,10/6/22,16,0,0,3,0,19
3283,10/7/22,8,0,3,4,0,15
3284,10/8/22,11,0,1,2,0,14
3285,10/9/22,2,0,1,1,0,4
3286,10/10/22,29,0,0,3,0,32
3287,10/11/22,7,0,2,10,0,19
3288,10/12/22,5,0,1,4,0,10
3289,10/13/22,20,0,2,3,0,25
3290,10/14/22,8,0,1,2,0,11
3291,10/15/22,11,0,2,0,0,13
3292,10/16/22,3,0,0,0,0,3
3293,10/17/22,13,0,1,4,0,18
3294,10/18/22,18,0,0,9,0,27
3295,10/19/22,14,0,1,4,0,19
3296,10/20/22,10,0,1,3,0,14
3297,10/21/22,6,0,6,5,0,17
3298,10/22/22,13,0,2,10,0,25
3299,10/23/22,2,0,1,1,0,4
3300,10/24/22,6,0,0,5,0,11
3301,10/25/22,14,0,3,11,0,28
3302,10/26/22,23,0,3,7,0,33
3303,10/27/22,9,0,1,10,0,20
3304,10/28/22,25,0,1,5,0,31
3305,10/29/22,7,0,1,0,0,8
3306,10/30/22,10,0,1,0,0,11
3307,10/31/22,9,0,0,1,0,10
3308,11/1/22,6,0,1,12,0,19
3309,11/2/22,6,0,10,5,0,21
3310,11/3/22,7,0,2,7,0,16
3311,11/4/22,11,0,2,3,0,16
3312,11/5/22,9,0,0,0,0,9
3313,11/6/22,4,0,0,1,0,5
3314,11/7/22,19,0,0,2,0,21
3315,11/8/22,9,0,1,5,0,15
3316,11/9/22,12,0,1,4,0,17
3317,11/10/22,11,0,2,10,0,23
3318,11/11/22,1,0,2,0,0,3
3319,11/12/22,8,0,0,1,0,9
3320,11/13/22,3,0,0,0,0,3
3321,11/14/22,10,0,0,10,0,20
3322,11/15/22,6,0,1,5,0,12
3323,11/16/22,17,0,1,0,0,18
3324,11/17/22,13,0,1,7,0,21
3325,11/18/22,11,0,1,7,0,19
3326,11/19/22,3,0,0,0,0,3
3327,11/20/22,5,0,0,0,0,5
3328,11/21/22,20,0,1,1,0,22
3329,11/22/22,9,0,0,11,0,20
3330,11/23/22,19,0,0,4,0,23
3331,11/24/22,4,0,0,0,0,4
3332,11/25/22,8,0,2,0,0,10
3333,11/26/22,10,0,2,1,0,13
3334,11/27/22,3,0,0,1,0,4
3335,11/28/22,12,0,0,8,0,20
3336,11/29/22,18,0,0,8,0,26
3337,11/30/22,20,0,2,2,0,24
3338,12/1/22,8,0,5,4,0,17
3339,12/2/22,7,0,0,9,0,16
3340,12/3/22,4,0,1,3,0,8
3341,12/4/22,3,0,1,0,0,4
3342,12/5/22,6,0,2,1,0,9
3343,12/6/22,28,0,4,2,0,34
3344,12/7/22,9,0,0,1,0,10
3345,12/8/22,22,0,5,3,0,30
3346,12/9/22,8,0,0,2,0,10
3347,12/10/22,7,0,0,1,0,8
3348,12/11/22,5,0,3,0,0,8
3349,12/12/22,4,0,0,3,0,7
3350,12/13/22,9,0,3,11,0,23
3351,12/14/22,8,0,1,5,0,14
3352,12/15/22,8,0,1,2,0,11
3353,12/16/22,12,0,3,3,0,18
3354,12/17/22,4,0,0,1,0,5
3355,12/18/22,2,0,1,0,0,3
3356,12/19/22,3,0,0,6,0,9
3357,12/20/22,18,0,1,1,0,20
3358,12/21/22,24,0,0,4,0,28
3359,12/22/22,23,0,4,11,0,38
3360,12/23/22,12,0,0,0,0,12
3361,12/24/22,5,0,0,0,0,5
3362,12/25/22,1,0,0,1,0,2
3363,12/26/22,4,0,1,1,0,6
3364,12/27/22,32,0,1,3,0,36
3365,12/28/22,10,0,0,5,0,15
3366,12/29/22,9,0,0,2,0,11
3367,12/30/22,9,0,0,3,0,12
3368,12/31/22,11,0,1,1,0,13
3369,1/1/23,0,0,2,0,0,2
3370,1/2/23,8,0,1,1,0,10
3371,1/3/23,19,0,1,6,0,26
3372,1/4/23,9,0,2,8,0,19
3373,1/5/23,12,0,0,9,0,21
3374,1/6/23,19,0,1,4,0,24
3375,1/7/23,5,0,0,2,0,7
3376,1/8/23,5,0,0,1,0,6
3377,1/9/23,12,0,0,10,0,22
3378,1/10/23,14,0,1,3,0,18
3379,1/11/23,26,0,2,5,0,33
3380,1/12/23,19,0,0,3,0,22
3381,1/13/23,20,0,0,8,0,28
3382,1/14/23,7,0,1,0,0,8
3383,1/15/23,2,0,0,0,0,2
3384,1/16/23,2,0,0,1,0,3
3385,1/17/23,14,0,1,6,0,21
3386,1/18/23,23,0,3,7,0,33
3387,1/19/23,12,0,0,1,0,13
3388,1/20/23,12,0,1,5,0,18
3389,1/21/23,7,0,0,1,0,8
3390,1/22/23,6,0,0,0,0,6
3391,1/23/23,12,0,1,4,0,17
3392,1/24/23,13,0,0,3,0,16
3393,1/25/23,10,0,2,2,0,14
3394,1/26/23,8,0,1,5,0,14
3395,1/27/23,11,0,1,5,0,17
3396,1/28/23,10,0,0,1,0,11
3397,1/29/23,5,0,1,2,0,8
3398,1/30/23,13,0,0,10,0,23
3399,1/31/23,5,0,6,1,0,12
3400,2/1/23,1,0,1,0,0,2
3401,2/2/23,14,0,0,0,0,14
3402,2/3/23,13,0,3,4,0,20
3403,2/4/23,8,0,0,1,0,9
3404,2/5/23,9,0,1,0,0,10
3405,2/6/23,21,0,0,9,0,30
3406,2/7/23,18,0,0,3,0,21
3407,2/8/23,19,0,0,6,0,25
3408,2/9/23,16,0,0,6,0,22
3409,2/10/23,9,0,2,2,0,13
3410,2/11/23,14,0,0,2,0,16
3411,2/12/23,6,0,0,0,0,6
3412,2/13/23,4,0,0,8,0,12
3413,2/14/23,7,0,3,2,0,12
3414,2/15/23,13,0,0,10,0,23
3415,2/16/23,6,0,0,5,0,11
3416,2/17/23,7,0,3,6,0,16
3417,2/18/23,27,0,0,1,0,28
3418,2/19/23,14,0,2,0,0,16
3419,2/20/23,13,0,1,3,0,17
3420,2/21/23,15,0,0,7,0,22
3421,2/22/23,7,0,2,4,0,13
3422,2/23/23,7,0,1,1,0,9
3423,2/24/23,8,0,5,3,0,16
3424,2/25/23,8,0,1,0,0,9
3425,2/26/23,3,0,0,0,0,3
3426,2/27/23,24,0,2,6,0,32
3427,2/28/23,8,0,1,5,0,14
3428,3/1/23,6,0,0,5,0,11
3429,3/2/23,21,0,2,2,0,25
3430,3/3/23,9,0,0,4,0,13
3431,3/4/23,9,0,1,2,0,12
3432,3/5/23,5,0,0,1,0,6
3433,3/6/23,10,0,1,4,0,15
3434,3/7/23,17,0,10,3,0,30
3435,3/8/23,16,0,0,14,0,30
3436,3/9/23,3,0,1,12,0,16
3437,3/10/23,9,0,1,12,0,22
3438,3/11/23,6,0,1,3,0,10
3439,3/12/23,5,0,0,1,0,6
3440,3/13/23,23,0,5,5,0,33
3441,3/14/23,8,0,2,9,0,19
3442,3/15/23,15,0,3,1,0,19
3443,3/16/23,17,0,3,5,0,25
3444,3/17/23,12,0,3,4,0,19
3445,3/18/23,8,0,1,0,0,9
3446,3/19/23,0,0,0,1,0,1
3447,3/20/23,12,0,0,4,0,16
3448,3/21/23,19,0,2,8,0,29
3449,3/22/23,24,0,0,3,0,27
3450,3/23/23,11,0,4,5,0,20
3451,3/24/23,10,0,2,7,0,19
3452,3/25/23,8,0,0,0,0,8
3453,3/26/23,13,0,1,0,0,14
3454,3/27/23,6,0,2,3,0,11
3455,3/28/23,13,0,0,4,0,17
3456,3/29/23,6,0,0,8,0,14
3457,3/30/23,7,0,1,6,0,14
3458,3/31/23,15,0,0,9,0,24
3459,4/1/23,3,0,0,2,0,5
3460,4/2/23,5,0,0,0,0,5
3461,4/3/23,7,0,2,6,0,15
3462,4/4/23,13,0,2,9,0,24
3463,4/5/23,16,0,1,2,0,19
3464,4/6/23,9,0,0,9,0,18
3465,4/7/23,9,0,0,2,0,11
3466,4/8/23,7,0,0,6,0,13
3467,4/9/23,14,0,0,0,0,14
3468,4/10/23,19,0,0,3,0,22
3469,4/11/23,14,0,0,3,0,17
3470,4/12/23,17,0,1,6,0,24
3471,4/13/23,15,0,1,3,0,19
3472,4/14/23,10,0,0,6,0,16
3473,4/15/23,10,0,2,0,0,12
3474,4/16/23,5,0,4,1,0,10
3475,4/17/23,6,0,3,2,0,11
3476,4/18/23,13,0,0,4,0,17
3477,4/19/23,8,0,2,2,0,12
3478,4/20/23,13,0,3,4,0,20
3479,4/21/23,11,0,0,5,0,16
3480,4/22/23,16,0,0,0,0,16
3481,4/23/23,5,0,3,0,0,8
3482,4/24/23,14,0,6,6,0,26
3483,4/25/23,18,0,0,5,0,23
3484,4/26/23,14,0,0,12,0,26
3485,4/27/23,13,0,4,7,0,24
3486,4/28/23,13,0,4,2,0,19
3487,4/29/23,8,0,0,3,0,11
3488,4/30/23,3,0,3,1,0,7
3489,5/1/23,10,0,1,8,0,19
3490,5/2/23,7,0,1,6,0,14
3491,5/3/23,6,0,19,7,0,32
3492,5/4/23,10,0,0,5,0,15
3493,5/5/23,15,0,7,10,0,32
3494,5/6/23,8,0,2,0,0,10
3495,5/7/23,4,0,1,0,0,5
3496,5/8/23,13,0,0,10,0,23
3497,5/9/23,9,0,2,4,0,15
3498,5/10/23,18,0,2,4,0,24
3499,5/11/23,7,0,1,3,0,11
3500,5/12/23,10,0,1,8,0,19
3501,5/13/23,6,0,1,0,0,7
3502,5/14/23,10,0,0,0,0,10
3503,5/15/23,18,0,1,5,0,24
3504,5/16/23,12,0,3,8,0,23
3505,5/17/23,19,0,1,3,0,23
3506,5/18/23,16,0,1,5,0,22
3507,5/19/23,4,0,4,1,0,9
3508,5/20/23,2,0,1,0,0,3
3509,5/21/23,6,0,0,0,0,6
3510,5/22/23,13,0,1,10,0,24
3511,5/23/23,12,0,2,4,0,18
3512,5/24/23,10,0,4,4,0,18
3513,5/25/23,12,0,1,5,0,18
3514,5/26/23,7,0,0,9,0,16
3515,5/27/23,8,0,2,0,0,10
3516,5/28/23,4,0,0,0,0,4
3517,5/29/23,7,0,3,0,0,10
3518,5/30/23,11,0,2,4,0,17
3519,5/31/23,11,0,1,5,0,17
3520,6/1/23,16,0,0,5,0,21
3521,6/2/23,14,0,1,5,0,20
3522,6/3/23,12,0,3,1,0,16
3523,6/4/23,6,0,0,0,0,6
3524,6/5/23,17,0,2,14,0,33
3525,6/6/23,11,0,0,3,0,14
3526,6/7/23,14,0,1,1,0,16
3527,6/8/23,5,0,1,3,0,9
3528,6/9/23,20,0,2,4,0,26
3529,6/10/23,3,0,3,1,0,7
3530,6/11/23,4,0,0,0,0,4
3531,6/12/23,12,0,0,7,0,19
3532,6/13/23,10,0,3,7,0,20
3533,6/14/23,11,0,0,2,0,13
3534,6/15/23,5,0,2,1,0,8
3535,6/16/23,11,0,0,5,0,16
3536,6/17/23,11,0,0,1,0,12
3537,6/18/23,8,0,0,0,0,8
3538,6/19/23,11,0,0,0,0,11
3539,6/20/23,9,0,2,3,0,14
3540,6/21/23,10,0,3,6,0,19
3541,6/22/23,21,0,0,3,0,24
3542,6/23/23,8,0,1,4,0,13
3543,6/24/23,9,0,0,0,0,9
3544,6/25/23,7,0,1,1,0,9
3545,6/26/23,12,0,9,1,0,22
3546,6/27/23,7,0,0,4,0,11
3547,6/28/23,5,0,2,0,0,7
3548,6/29/23,4,0,3,3,0,10
3549,6/30/23,6,0,2,7,0,15
3550,7/1/23,9,0,1,2,0,12
3551,7/2/23,2,0,0,0,0,2
3552,7/3/23,13,0,1,2,0,16
3553,7/4/23,6,0,0,0,0,6
3554,7/5/23,8,0,6,4,0,18
3555,7/6/23,5,0,1,3,0,9
3556,7/7/23,10,0,2,5,0,17
3557,7/8/23,5,0,0,2,0,7
3558,7/9/23,8,0,0,1,0,9
3559,7/10/23,10,0,2,1,0,13
3560,7/11/23,14,0,0,6,0,20
3561,7/12/23,4,0,1,7,0,12
3562,7/13/23,6,0,1,1,0,8
3563,7/14/23,7,0,0,9,0,16
3564,7/15/23,4,0,0,1,0,5
3565,7/16/23,1,0,4,0,0,5
3566,7/17/23,3,0,0,2,0,5
3567,7/18/23,4,0,0,3,0,7
3568,7/19/23,9,0,1,4,0,14
3569,7/20/23,5,0,0,7,0,12
3570,7/21/23,8,0,0,3,0,11
3571,7/22/23,7,0,1,2,0,10
3572,7/23/23,6,0,1,3,0,10
3573,7/24/23,10,0,5,5,0,20
3574,7/25/23,11,0,1,6,0,18
3575,7/26/23,12,0,1,3,0,16
3576,7/27/23,5,0,0,5,0,10
3577,7/28/23,8,0,4,0,0,12
3578,7/29/23,3,0,1,0,0,4
3579,7/30/23,6,0,1,0,0,7
3580,7/31/23,3,0,3,5,0,11
3581,8/1/23,11,0,1,0,0,12
3582,8/2/23,7,0,1,1,0,9
3583,8/3/23,2,0,4,2,0,8
3584,8/4/23,10,0,2,3,0,15
3585,8/5/23,2,0,3,1,0,6
3586,8/6/23,5,0,3,0,0,8
3587,8/7/23,13,0,4,3,0,20
3588,8/8/23,14,0,1,1,0,16
3589,8/9/23,12,0,1,3,0,16
3590,8/10/23,13,0,1,5,0,19
3591,8/11/23,6,0,2,2,0,10
3592,8/12/23,5,0,1,1,0,7
3593,8/13/23,2,0,0,0,0,2
3594,8/14/23,10,0,0,8,0,18
3595,8/15/23,4,0,1,2,0,7
3596,8/16/23,5,0,0,0,0,5
3597,8/17/23,3,0,1,4,0,8
3598,8/18/23,7,0,3,2,0,12
3599,8/19/23,3,0,3,0,0,6
3600,8/20/23,5,0,0,2,0,7
3601,8/21/23,9,0,1,2,0,12
3602,8/22/23,10,0,1,5,0,16
3603,8/23/23,4,0,4,6,0,14
3604,8/24/23,5,0,0,1,0,6
3605,8/25/23,10,0,0,8,0,18
3606,8/26/23,7,0,2,2,0,11
3607,8/27/23,4,0,1,0,0,5
3608,8/28/23,9,0,4,4,0,17
3609,8/29/23,11,0,1,2,0,14
3610,8/30/23,8,0,3,2,0,13
3611,8/31/23,5,0,1,2,0,8
3612,9/1/23,5,0,0,5,0,10
3613,9/2/23,6,0,1,2,0,9
3614,9/3/23,11,0,0,2,0,13
3615,9/4/23,4,0,0,1,0,5
3616,9/5/23,12,0,5,4,0,21
3617,9/6/23,7,0,1,1,0,9
3618,9/7/23,7,0,1,3,0,11
3619,9/8/23,7,0,0,1,0,8
3620,9/9/23,3,0,1,1,0,5
3621,9/10/23,5,0,2,2,0,9
3622,9/11/23,8,0,0,4,0,12
3623,9/12/23,3,0,0,12,0,15
3624,9/13/23,10,0,1,0,0,11
3625,9/14/23,12,0,4,4,0,20
3626,9/15/23,8,0,0,4,0,12
3627,9/16/23,9,0,0,0,0,9
3628,9/17/23,4,0,0,0,0,4
3629,9/18/23,5,0,0,6,0,11
3630,9/19/23,10,0,3,6,0,19
3631,9/20/23,14,0,1,3,0,18
3632,9/21/23,5,0,3,2,0,10
3633,9/22/23,6,0,0,11,0,17
3634,9/23/23,3,0,0,0,0,3
3635,9/24/23,3,0,0,1,0,4
3636,9/25/23,11,0,1,3,0,15
3637,9/26/23,12,0,0,6,0,18
3638,9/27/23,11,0,0,3,0,14
3639,9/28/23,7,0,1,10,0,18
3640,9/29/23,6,0,1,0,0,7
3641,9/30/23,5,0,1,6,0,12
3642,10/1/23,20,0,0,0,0,20
3643,10/2/23,6,0,1,4,0,11
3644,10/3/23,15,0,2,6,0,23
3645,10/4/23,8,0,0,2,0,10
3646,10/5/23,7,0,3,4,0,14
3647,10/6/23,8,0,1,2,0,11
3648,10/7/23,10,0,4,1,0,15
3649,10/8/23,3,0,0,0,0,3
3650,10/9/23,5,0,1,5,0,11
3651,10/10/23,8,0,2,4,0,14
3652,10/11/23,14,0,0,6,0,20
3653,10/12/23,8,0,4,1,0,13
3654,10/13/23,8,0,7,2,0,17
3655,10/14/23,8,0,2,1,0,11
3656,10/15/23,6,0,1,0,0,7
3657,10/16/23,2,0,1,1,0,4
3658,10/17/23,10,0,0,3,0,13
3659,10/18/23,8,0,3,1,0,12
3660,10/19/23,6,0,1,2,0,9
3661,10/20/23,6,0,0,5,0,11
3662,10/21/23,4,0,0,3,0,7
3663,10/22/23,3,0,1,0,0,4
3664,10/23/23,23,0,0,4,0,27
3665,10/24/23,9,0,0,6,0,15
3666,10/25/23,9,0,2,1,0,12
3667,10/26/23,20,0,1,2,0,23
3668,10/27/23,14,0,1,3,0,18
3669,10/28/23,9,0,0,1,0,10
3670,10/29/23,2,0,1,2,0,5
3671,10/30/23,16,0,0,3,0,19
3672,10/31/23,12,0,3,2,0,17
3673,11/1/23,8,0,0,1,0,9
3674,11/2/23,18,0,1,4,0,23
3675,11/3/23,7,0,0,3,0,10
3676,11/4/23,10,0,1,0,0,11
3677,11/5/23,6,0,0,0,0,6
3678,11/6/23,4,0,0,4,0,8
3679,11/7/23,15,0,2,11,0,28
3680,11/8/23,10,0,3,4,0,17
3681,11/9/23,3,0,2,4,0,9
3682,11/10/23,5,0,0,0,0,5
3683,11/11/23,8,0,0,1,0,9
3684,11/12/23,1,0,0,2,0,3
3685,11/13/23,9,0,1,6,0,16
3686,11/14/23,7,0,0,9,0,16
3687,11/15/23,11,0,0,0,0,11
3688,11/16/23,8,0,3,3,0,14
3689,11/17/23,9,0,1,3,0,13
3690,11/18/23,5,0,0,2,0,7
3691,11/19/23,4,0,3,2,0,9
3692,11/20/23,14,0,1,4,0,19
3693,11/21/23,7,0,3,6,0,16
3694,11/22/23,9,0,0,5,0,14
3695,11/23/23,7,0,0,0,0,7
,11/24/23,,,,,,
3696,11/25/23,17,0,3,1,0,21
3697,11/26/23,3,0,0,1,0,4
3698,11/27/23,11,0,1,9,0,21
3699,11/28/23,16,0,1,1,0,18
3700,11/29/23,11,0,1,3,0,15
3701,11/30/23,10,0,2,3,0,15
3702,12/1/23,8,0,2,15,0,25
3703,12/2/23,2,0,0,1,0,3
3704,12/3/23,5,0,1,0,0,6
3705,12/4/23,8,0,0,3,0,11
3706,12/5/23,7,0,0,0,0,7
3707,12/6/23,9,0,1,12,0,22
3708,12/7/23,13,0,0,3,0,16
3709,12/8/23,15,0,3,7,0,25
3710,12/9/23,1,0,2,2,0,5
3711,12/10/23,1,0,0,0,0,1
3712,12/11/23,7,0,5,3,0,15
3713,12/12/23,6,0,4,1,0,11
3714,12/13/23,5,0,2,2,0,9
3715,12/14/23,12,0,0,7,0,19
3716,12/15/23,24,0,1,8,0,33
3717,12/16/23,14,0,5,0,0,19
3718,12/17/23,6,0,3,1,0,10
3719,12/18/23,8,0,1,4,0,13
3720,12/19/23,11,0,5,6,0,22
3721,12/20/23,10,0,1,4,0,15
3722,12/21/23,16,0,0,7,0,23
3723,12/22/23,6,0,0,3,0,9
3724,12/23/23,12,0,1,1,0,14
3725,12/24/23,3,0,0,1,0,4
3726,12/25/23,4,0,1,0,0,5
3727,12/26/23,6,0,1,0,0,7
3728,12/27/23,11,0,3,4,0,18
3729,12/28/23,7,0,1,2,0,10
3730,12/29/23,15,0,2,0,0,17
3731,12/30/23,4,0,1,2,0,7
3732,12/31/23,0,0,0,1,0,1
3733,1/1/24,9,0,2,0,0,11
3734,1/2/24,6,0,1,2,0,9
3735,1/3/24,15,0,1,4,0,20
3736,1/4/24,6,0,1,2,0,9
3737,1/5/24,22,0,6,5,0,33
3738,1/6/24,4,0,0,1,0,5
3739,1/7/24,2,0,5,0,0,7
3740,1/8/24,11,0,0,5,0,16
3741,1/9/24,2,0,2,15,0,19
3742,1/10/24,11,0,1,4,0,16
3743,1/11/24,7,0,1,7,0,15
3744,1/12/24,6,0,0,9,0,15
3745,1/13/24,9,0,0,2,0,11
3746,1/14/24,8,0,1,1,0,10
3747,1/15/24,1,0,1,0,0,2
3748,1/16/24,17,0,2,4,0,23
3749,1/17/24,3,0,3,7,0,13
3750,1/18/24,6,0,2,1,0,9
3751,1/19/24,22,0,2,3,0,27
3752,1/20/24,7,0,0,0,0,7
3753,1/21/24,8,0,0,2,0,10
3754,1/22/24,16,0,1,3,0,20
3755,1/23/24,8,0,1,7,0,16
3756,1/24/24,10,0,3,4,0,17
3757,1/25/24,12,0,2,0,0,14
3758,1/26/24,9,0,0,7,0,16
3759,1/27/24,9,0,0,0,0,9
3760,1/28/24,2,0,0,4,0,6
3761,1/29/24,10,0,4,1,0,15
3762,1/30/24,10,0,1,8,0,19
3763,1/31/24,13,0,3,1,0,17
3764,2/1/24,7,0,1,13,0,21
3765,2/2/24,15,0,2,6,0,23
3766,2/3/24,6,0,1,0,0,7
3767,2/4/24,10,0,1,1,0,12
3768,2/5/24,23,0,0,9,0,32
3769,2/6/24,18,0,1,3,0,22
3770,2/7/24,12,0,5,2,0,19
3771,2/8/24,9,0,1,21,0,31
3772,2/9/24,6,0,1,5,0,12
3773,2/10/24,7,0,1,0,0,8
3774,2/11/24,1,0,0,0,0,1
3775,2/12/24,12,0,1,7,0,20
3776,2/13/24,13,0,3,10,0,26
3777,2/14/24,15,0,1,5,0,21
3778,2/15/24,27,0,1,19,0,47
3779,2/16/24,9,0,0,3,0,12
3780,2/17/24,5,0,0,2,0,7
3781,2/18/24,4,0,9,0,0,13
3782,2/19/24,4,0,1,0,0,5
3783,2/20/24,12,0,2,3,0,17
3784,2/21/24,9,0,0,7,0,16
3785,2/22/24,14,0,1,3,0,18
3786,2/23/24,10,0,0,8,0,18
3787,2/24/24,7,0,1,0,0,8
3788,2/25/24,5,0,0,2,0,7
3789,2/26/24,11,0,0,4,0,15
3790,2/27/24,12,0,0,4,0,16
3791,2/28/24,8,0,0,7,0,15
3792,2/29/24,12,0,1,13,0,26
3793,3/1/24,15,0,1,5,0,21
3794,3/2/24,4,0,4,1,0,9
3795,3/3/24,12,0,1,1,0,14
3796,3/4/24,17,0,1,4,0,22
3797,3/5/24,16,0,3,8,0,27
3798,3/6/24,4,0,1,4,0,9
3799,3/7/24,21,0,5,1,0,27
3800,3/8/24,12,0,0,2,0,14
3801,3/9/24,4,0,0,0,0,4
3802,3/10/24,5,0,0,0,0,5
3803,3/11/24,11,0,1,6,0,18
3804,3/12/24,15,0,3,5,0,23
3805,3/13/24,11,0,2,4,0,17
3806,3/14/24,11,0,2,5,0,18
3807,3/15/24,11,0,0,3,0,14
3808,3/16/24,6,0,0,2,0,8
3809,3/17/24,6,0,0,1,0,7
3810,3/18/24,5,0,0,10,0,15
3811,3/19/24,18,0,2,3,0,23
3812,3/20/24,27,0,15,4,0,46
3813,3/21/24,5,0,0,1,0,6
3814,3/22/24,12,0,0,8,0,20
3815,3/23/24,5,0,2,1,0,8
3816,3/24/24,6,0,2,1,0,9
3817,3/25/24,11,0,0,10,0,21
3818,3/26/24,7,0,0,5,0,12
3819,3/27/24,17,0,3,6,0,26
3820,3/28/24,12,0,1,4,0,17
3821,3/29/24,10,0,1,3,0,14
3822,3/30/24,6,0,0,2,0,8
3823,3/31/24,5,0,1,0,0,6
3824,4/1/24,10,0,0,5,0,15
3825,4/2/24,12,0,1,0,0,13
3826,4/3/24,21,0,1,3,0,25
3827,4/4/24,17,0,0,3,0,20
3828,4/5/24,14,0,1,8,0,23
3829,4/6/24,2,0,0,2,0,4
3830,4/7/24,3,0,0,1,0,4
3831,4/8/24,4,0,0,1,0,5
3832,4/9/24,21,0,1,4,0,26
3833,4/10/24,15,0,3,2,0,20
3834,4/11/24,10,0,1,4,0,15
3835,4/12/24,22,0,0,4,0,26
3836,4/13/24,5,0,0,1,0,6
3837,4/14/24,6,0,1,1,0,8
3838,4/15/24,14,0,1,2,0,17
3839,4/16/24,11,0,4,4,0,19
3840,4/17/24,7,0,1,4,0,12
3841,4/18/24,20,0,5,3,0,28
3842,4/19/24,18,0,0,3,0,21
3843,4/20/24,10,0,0,0,0,10
3844,4/21/24,8,0,1,0,0,9
3845,4/22/24,17,0,4,1,0,22
3846,4/23/24,21,0,0,7,0,28
3847,4/24/24,10,0,3,2,0,15
3848,4/25/24,13,0,3,5,0,21
3849,4/26/24,4,0,4,1,0,9
3850,4/27/24,7,0,1,2,0,10
3851,4/28/24,9,0,0,1,0,10
3852,4/29/24,28,0,1,10,0,39
3853,4/30/24,19,0,0,13,0,32
3854,5/1/24,13,0,3,3,0,19
3855,5/2/24,18,0,0,7,0,25
3856,5/3/24,9,0,2,6,0,17
3857,5/4/24,6,0,4,2,0,12
3858,5/5/24,9,0,4,4,0,17
3859,5/6/24,10,0,2,3,0,15
3860,5/7/24,7,0,2,8,0,17
3861,5/8/24,10,0,1,2,0,13
3862,5/9/24,11,0,0,6,0,17
3863,5/10/24,8,0,2,12,0,22
3864,5/11/24,6,0,0,0,0,6
3865,5/12/24,18,0,0,1,0,19
3866,5/13/24,12,0,2,11,0,25
3867,5/14/24,17,0,2,5,0,24
3868,5/15/24,14,0,0,3,0,17
3869,5/16/24,2,0,0,0,0,2