,DateTime,Adopt,Euth,RTO,Unintended,Other,TotalOutcomes
0,10/1/13,6,7,11,0,5,29
1,10/2/13,12,2,9,0,10,33
2,10/3/13,7,0,6,0,5,18
3,10/4/13,6,3,9,0,5,23
4,10/5/13,22,2,6,0,8,38
5,10/6/13,18,1,9,0,4,32
6,10/7/13,14,2,6,0,8,30
7,10/8/13,6,0,9,0,1,16
8,10/9/13,11,2,3,0,5,21
9,10/10/13,9,4,5,1,21,40
10,10/11/13,10,2,5,0,16,33
11,10/12/13,21,3,18,0,6,48
12,10/13/13,35,0,4,0,4,43
13,10/14/13,7,3,9,0,19,38
14,10/15/13,11,5,10,0,24,50
15,10/16/13,8,0,7,0,20,35
16,10/17/13,11,1,6,0,1,19
17,10/18/13,7,4,14,0,6,31
18,10/19/13,17,0,2,0,3,22
19,10/20/13,17,1,9,0,12,39
20,10/21/13,14,1,9,0,8,32
21,10/22/13,7,3,7,1,3,21
22,10/23/13,6,0,6,0,7,19
23,10/24/13,15,6,10,0,15,46
24,10/25/13,4,2,7,1,8,22
25,10/26/13,13,0,5,0,3,21
26,10/27/13,14,1,6,0,4,25
27,10/28/13,2,6,9,1,20,38
28,10/29/13,12,3,5,0,11,31
29,10/30/13,6,3,5,0,9,23
30,10/31/13,17,3,7,0,1,28
31,11/1/13,18,1,9,0,8,36
32,11/2/13,18,0,5,0,5,28
33,11/3/13,30,3,4,0,5,42
34,11/4/13,11,3,8,0,20,42
35,11/5/13,7,1,11,0,2,21
36,11/6/13,3,1,7,0,6,17
37,11/7/13,8,2,12,0,11,33
38,11/8/13,4,2,9,0,12,27
39,11/9/13,17,0,13,0,8,38
40,11/10/13,24,4,5,0,3,36
41,11/11/13,16,2,11,0,7,36
42,11/12/13,6,1,7,0,1,15
43,11/13/13,4,1,7,0,5,17
44,11/14/13,8,1,4,0,3,16
45,11/15/13,8,5,4,0,14,31
46,11/16/13,11,3,13,0,8,35
47,11/17/13,8,0,8,0,13,29
48,11/18/13,5,0,3,0,1,9
49,11/19/13,10,2,11,0,8,31
50,11/20/13,4,1,7,0,7,19
51,11/21/13,7,5,5,0,6,23
52,11/22/13,7,2,8,0,6,23
53,11/23/13,13,2,12,0,6,33
54,11/24/13,9,1,7,0,4,21
55,11/25/13,9,0,6,0,10,25
56,11/26/13,5,5,5,0,9,24
57,11/27/13,9,1,8,0,9,27
58,11/28/13,5,1,2,0,2,10
59,11/29/13,6,3,7,0,16,32
60,11/30/13,34,0,4,0,11,49
61,12/1/13,23,0,6,1,6,36
62,12/2/13,7,4,13,1,3,28
63,12/3/13,11,0,5,0,6,22
64,12/4/13,12,2,3,0,8,25
65,12/5/13,9,5,4,0,5,23
66,12/6/13,9,5,4,0,17,35
67,12/7/13,14,1,3,0,1,19
68,12/8/13,16,1,4,1,6,28
69,12/9/13,10,0,8,0,13,31
70,12/10/13,8,1,5,0,5,19
71,12/11/13,6,5,9,0,2,22
72,12/12/13,10,3,4,0,10,27
73,12/13/13,12,1,6,0,12,31
74,12/14/13,16,2,9,0,4,31
75,12/15/13,12,2,7,0,6,27
76,12/16/13,13,1,6,0,3,23
77,12/17/13,10,0,12,0,1,23
78,12/18/13,15,1,7,0,8,31
79,12/19/13,11,3,8,0,8,30
80,12/20/13,15,0,9,0,8,32
81,12/21/13,24,3,12,0,7,46
82,12/22/13,15,0,14,0,1,30
83,12/23/13,20,4,15,0,2,41
84,12/24/13,25,2,3,0,7,37
85,12/25/13,0,1,0,0,1,2
86,12/26/13,13,2,12,0,3,30
87,12/27/13,11,7,5,0,6,29
88,12/28/13,25,0,6,0,13,44
89,12/29/13,12,1,7,0,7,27
90,12/30/13,11,3,8,1,4,27
91,12/31/13,10,1,15,0,9,35
92,1/1/14,20,2,8,0,10,40
93,1/2/14,11,1,8,0,5,25
94,1/3/14,13,1,16,1,11,42
95,1/4/14,17,1,4,0,2,24
96,1/5/14,28,0,13,0,14,55
97,1/6/14,10,3,9,0,4,26
98,1/7/14,12,2,4,0,9,27
99,1/8/14,6,4,9,0,5,24
100,1/9/14,7,2,6,0,6,21
101,1/10/14,13,3,7,0,11,34
102,1/11/14,13,1,6,0,5,25
103,1/12/14,12,0,8,0,11,31
104,1/13/14,11,1,12,0,1,25
105,1/14/14,7,1,12,0,3,23
106,1/15/14,12,0,12,0,4,28
107,1/16/14,6,1,19,0,7,33
108,1/17/14,7,3,7,0,11,28
109,1/18/14,19,2,4,0,5,30
110,1/19/14,13,0,6,0,10,29
111,1/20/14,15,2,3,0,13,33
112,1/21/14,9,1,5,0,3,18
113,1/22/14,13,2,7,1,4,27
114,1/23/14,10,1,8,1,7,27
115,1/24/14,4,2,5,0,5,16
116,1/25/14,13,1,11,0,7,32
117,1/26/14,14,2,3,0,11,30
118,1/27/14,9,1,5,0,2,17
119,1/28/14,5,1,11,1,2,20
120,1/29/14,15,0,7,0,10,32
121,1/30/14,9,1,7,0,3,20
122,1/31/14,6,3,6,0,3,18
123,2/1/14,25,1,8,0,0,34
124,2/2/14,16,3,10,0,6,35
125,2/3/14,14,4,11,1,5,35
126,2/4/14,10,1,8,0,12,31
127,2/5/14,3,1,8,0,3,15
128,2/6/14,10,3,5,0,4,22
129,2/7/14,5,0,7,0,14,26
130,2/8/14,13,0,7,0,3,23
131,2/9/14,15,0,5,0,5,25
132,2/10/14,7,2,9,0,11,29
133,2/11/14,12,1,11,0,5,29
134,2/12/14,4,3,6,0,3,16
135,2/13/14,6,2,16,0,15,39
136,2/14/14,11,2,5,0,7,25
137,2/15/14,16,4,4,0,3,27
138,2/16/14,26,1,2,0,11,40
139,2/17/14,14,0,9,0,8,31
140,2/18/14,11,0,8,0,2,21
141,2/19/14,12,0,12,0,9,33
142,2/20/14,3,2,9,0,8,22
143,2/21/14,12,1,7,0,4,24
144,2/22/14,16,2,5,0,7,30
145,2/23/14,20,1,8,0,2,31
146,2/24/14,15,2,10,0,10,37
147,2/25/14,17,6,13,0,2,38
148,2/26/14,11,3,6,1,1,22
149,2/27/14,6,0,6,0,3,15
150,2/28/14,10,2,4,0,3,19
151,3/1/14,18,0,6,0,5,29
152,3/2/14,14,3,8,1,7,33
153,3/3/14,6,2,4,0,11,23
154,3/4/14,13,0,6,0,5,24
155,3/5/14,11,1,6,0,1,19
156,3/6/14,9,0,7,0,2,18
157,3/7/14,9,5,10,0,5,29
158,3/8/14,19,2,10,0,4,35
159,3/9/14,18,1,7,0,9,35
160,3/10/14,13,2,9,1,7,32
161,3/11/14,11,4,7,0,6,28
162,3/12/14,6,2,6,0,3,17
163,3/13/14,17,1,13,0,16,47
164,3/14/14,14,1,9,0,13,37
165,3/15/14,14,2,6,0,10,32
166,3/16/14,15,2,13,0,11,41
167,3/17/14,9,2,14,0,11,36
168,3/18/14,11,1,11,0,8,31
169,3/19/14,8,4,8,0,2,22
170,3/20/14,11,3,10,0,4,28
171,3/21/14,9,4,9,0,8,30
172,3/22/14,17,1,11,0,4,33
173,3/23/14,19,0,11,0,17,47
174,3/24/14,6,3,5,0,3,17
175,3/25/14,11,2,9,0,2,24
176,3/26/14,8,2,7,0,4,21
177,3/27/14,7,4,12,0,5,28
178,3/28/14,9,1,7,0,4,21
179,3/29/14,18,0,8,0,6,32
180,3/30/14,31,1,12,0,7,51
181,3/31/14,8,3,4,0,2,17
182,4/1/14,3,4,14,0,3,24
183,4/2/14,7,1,13,0,4,25
184,4/3/14,16,2,8,0,15,41
185,4/4/14,6,0,13,0,2,21
186,4/5/14,18,3,10,1,12,44
187,4/6/14,19,0,14,0,3,36
188,4/7/14,10,1,10,1,6,28
189,4/8/14,12,1,9,0,4,26
190,4/9/14,9,0,12,0,8,29
191,4/10/14,13,4,5,0,6,28
192,4/11/14,8,0,6,0,4,18
193,4/12/14,12,0,8,0,3,23
194,4/13/14,12,0,8,0,4,24
195,4/14/14,4,3,6,0,6,19
196,4/15/14,6,0,11,0,12,29
197,4/16/14,8,0,15,0,16,39
198,4/17/14,7,5,9,0,14,35
199,4/18/14,7,0,5,0,19,31
200,4/19/14,29,0,8,0,3,40
201,4/20/14,17,0,9,0,5,31
202,4/21/14,13,1,4,0,3,21
203,4/22/14,9,0,8,0,2,19
204,4/23/14,8,3,12,0,7,30
205,4/24/14,12,0,12,0,6,30
206,4/25/14,9,1,11,0,9,30
207,4/26/14,13,1,6,1,8,29
208,4/27/14,12,1,6,0,1,20
209,4/28/14,9,1,10,1,4,25
210,4/29/14,10,1,7,0,0,18
211,4/30/14,13,1,9,0,11,34
212,5/1/14,8,4,13,0,2,27
213,5/2/14,4,0,6,0,4,14
214,5/3/14,17,0,5,0,4,26
215,5/4/14,28,5,14,0,4,51
216,5/5/14,16,3,8,0,3,30
217,5/6/14,6,1,9,1,7,24
218,5/7/14,8,0,2,0,8,18
219,5/8/14,5,3,6,0,4,18
220,5/9/14,7,3,11,0,11,32
221,5/10/14,16,1,9,0,4,30
222,5/11/14,11,1,11,0,12,35
223,5/12/14,5,0,10,0,3,18
224,5/13/14,11,0,14,0,8,33
225,5/14/14,13,8,9,0,9,39
226,5/15/14,3,3,10,0,8,24
227,5/16/14,6,1,10,0,11,28
228,5/17/14,15,2,7,0,6,30
229,5/18/14,13,2,10,0,5,30
230,5/19/14,14,1,9,0,3,27
231,5/20/14,10,0,9,1,5,25
232,5/21/14,13,0,5,0,7,25
233,5/22/14,8,5,8,2,5,28
234,5/23/14,18,1,7,0,7,33
235,5/24/14,10,3,6,2,18,39
236,5/25/14,10,0,5,0,11,26
237,5/26/14,21,1,14,0,10,46
238,5/27/14,12,1,13,0,4,30
239,5/28/14,6,2,11,0,4,23
240,5/29/14,11,2,9,0,2,24
241,5/30/14,8,1,13,0,12,34
242,5/31/14,21,0,6,0,25,52
243,6/1/14,20,0,10,0,8,38
244,6/2/14,14,2,7,0,2,25
245,6/3/14,19,3,11,0,12,45
246,6/4/14,4,0,8,0,7,19
247,6/5/14,7,0,4,0,5,16
248,6/6/14,10,1,11,0,10,32
249,6/7/14,18,3,6,0,12,39
250,6/8/14,14,0,7,0,1,22
251,6/9/14,13,4,10,0,3,30
252,6/10/14,7,1,9,0,8,25
253,6/11/14,7,2,2,0,6,17
254,6/12/14,5,1,4,0,3,13
255,6/13/14,8,1,8,0,3,20
256,6/14/14,15,2,14,0,0,31
257,6/15/14,19,1,7,0,9,36
258,6/16/14,14,2,4,0,9,29
259,6/17/14,12,5,12,0,16,45
260,6/18/14,13,1,4,0,3,21
261,6/19/14,10,4,9,0,19,42
262,6/20/14,9,0,4,0,7,20
263,6/21/14,16,0,11,0,3,30
264,6/22/14,17,4,2,0,12,35
265,6/23/14,7,1,4,1,4,17
266,6/24/14,6,2,9,0,6,23
267,6/25/14,8,1,5,0,3,17
268,6/26/14,7,4,10,0,30,51
269,6/27/14,6,2,9,1,1,19
270,6/28/14,13,1,7,0,8,29
271,6/29/14,23,1,3,0,8,35
272,6/30/14,13,1,14,0,5,33
273,7/1/14,24,2,7,0,7,40
274,7/2/14,14,3,15,0,6,38
275,7/3/14,9,1,5,0,5,20
276,7/4/14,9,0,5,0,19,33
277,7/5/14,15,1,10,0,13,39
278,7/6/14,19,2,15,0,1,37
279,7/7/14,24,2,16,0,2,44
280,7/8/14,9,4,6,0,2,21
281,7/9/14,15,0,8,0,4,27
282,7/10/14,19,4,10,0,6,39
283,7/11/14,18,2,6,0,7,33
284,7/12/14,13,2,7,0,4,26
285,7/13/14,23,1,5,0,2,31
286,7/14/14,14,0,3,0,5,22
287,7/15/14,13,0,5,0,6,24
288,7/16/14,13,3,5,0,13,34
289,7/17/14,19,3,3,0,6,31
290,7/18/14,11,2,9,0,10,32
291,7/19/14,22,1,5,1,2,31
292,7/20/14,7,1,1,0,5,14
293,7/21/14,10,4,15,0,21,50
294,7/22/14,16,0,6,1,2,25
295,7/23/14,17,16,9,0,12,54
296,7/24/14,11,1,7,0,7,26
297,7/25/14,10,2,11,0,3,26
298,7/26/14,14,0,7,0,2,23
299,7/27/14,18,2,9,0,11,40
300,7/28/14,5,1,8,0,3,17
301,7/29/14,19,2,6,0,2,29
302,7/30/14,11,4,11,0,9,35
303,7/31/14,5,1,8,0,4,18
304,8/1/14,21,1,8,0,4,34
305,8/2/14,17,1,5,1,8,32
306,8/3/14,22,0,5,0,8,35
307,8/4/14,18,2,11,0,7,38
308,8/5/14,10,1,10,1,3,25
309,8/6/14,14,4,13,0,5,36
310,8/7/14,11,0,16,1,3,31
311,8/8/14,10,2,6,0,0,18
312,8/9/14,13,1,8,0,5,27
313,8/10/14,25,0,11,0,5,41
314,8/11/14,16,1,6,0,6,29
315,8/12/14,11,3,4,0,4,22
316,8/13/14,25,4,6,0,2,37
317,8/14/14,6,1,4,0,13,24
318,8/15/14,4,0,7,0,4,15
319,8/16/14,15,1,8,0,4,28
320,8/17/14,27,1,4,0,3,35
321,8/18/14,17,2,7,0,9,35
322,8/19/14,22,1,3,0,6,32
323,8/20/14,13,3,8,0,11,35
324,8/21/14,15,1,5,0,16,37
325,8/22/14,16,0,9,0,1,26
326,8/23/14,17,0,8,0,5,30
327,8/24/14,17,0,9,0,2,28
328,8/25/14,17,1,4,0,0,22
329,8/26/14,10,0,4,0,0,14
330,8/27/14,9,3,8,0,6,26
331,8/28/14,11,1,5,0,5,22
332,8/29/14,11,6,7,0,9,33
333,8/30/14,28,1,11,0,4,44
334,8/31/14,18,1,8,0,6,33
335,9/1/14,14,4,6,0,4,28
336,9/2/14,14,0,5,0,6,25
337,9/3/14,9,2,10,0,15,36
338,9/4/14,10,1,11,0,6,28
339,9/5/14,11,2,7,0,6,26
340,9/6/14,12,0,10,0,14,36
341,9/7/14,21,1,4,0,9,35
342,9/8/14,17,3,9,0,9,38
343,9/9/14,14,3,5,0,10,32
344,9/10/14,14,2,10,0,1,27
345,9/11/14,11,0,7,0,1,19
346,9/12/14,15,0,8,0,1,24
347,9/13/14,18,0,13,0,8,39
348,9/14/14,16,3,11,0,11,41
349,9/15/14,3,1,10,0,9,23
350,9/16/14,6,2,8,0,8,24
351,9/17/14,13,1,3,0,4,21
352,9/18/14,8,2,7,0,1,18
353,9/19/14,6,4,13,0,5,28
354,9/20/14,22,0,15,0,7,44
355,9/21/14,18,3,4,0,8,33
356,9/22/14,13,0,14,0,6,33
357,9/23/14,9,0,7,0,8,24
358,9/24/14,14,2,11,0,1,28
359,9/25/14,4,0,5,0,3,12
360,9/26/14,7,4,11,0,14,36
361,9/27/14,30,0,8,0,6,44
362,9/28/14,10,0,9,0,3,22
363,9/29/14,15,5,7,1,16,44
364,9/30/14,5,1,5,0,8,19
365,10/1/14,5,2,3,0,10,20
366,10/2/14,3,2,5,0,17,27
367,10/3/14,9,0,6,0,4,19
368,10/4/14,9,2,11,0,10,32
369,10/5/14,14,0,6,0,1,21
370,10/6/14,7,1,10,0,8,26
371,10/7/14,9,1,4,0,4,18
372,10/8/14,11,3,6,0,8,28
373,10/9/14,8,6,16,0,7,37
374,10/10/14,20,4,2,0,6,32
375,10/11/14,18,1,4,0,5,28
376,10/12/14,26,1,6,0,4,37
377,10/13/14,14,2,8,0,7,31
378,10/14/14,11,6,11,0,5,33
379,10/15/14,3,0,8,0,1,12
380,10/16/14,4,2,8,0,13,27
381,10/17/14,6,1,9,0,5,21
382,10/18/14,25,1,8,0,5,39
383,10/19/14,28,2,1,0,6,37
384,10/20/14,21,0,13,0,6,40
385,10/21/14,7,4,4,0,5,20
386,10/22/14,13,3,5,0,12,33
387,10/23/14,13,2,11,0,5,31
388,10/24/14,6,6,10,0,4,26
389,10/25/14,15,1,9,0,9,34
390,10/26/14,18,4,10,0,7,39
391,10/27/14,6,1,4,0,14,25
392,10/28/14,3,1,6,0,0,10
393,10/29/14,7,1,14,0,4,26
394,10/30/14,10,3,5,0,12,30
395,10/31/14,5,2,8,0,1,16
396,11/1/14,10,3,5,0,2,20
397,11/2/14,15,1,5,0,14,35
398,11/3/14,11,2,15,0,5,33
399,11/4/14,11,5,11,0,12,39
400,11/5/14,8,1,6,0,5,20
401,11/6/14,8,2,1,0,2,13
402,11/7/14,6,2,4,0,23,35
403,11/8/14,13,1,10,0,4,28
404,11/9/14,12,0,9,0,9,30
405,11/10/14,7,5,10,0,0,22
406,11/11/14,3,2,9,0,13,27
407,11/12/14,12,3,12,0,9,36
408,11/13/14,9,1,6,0,5,21
409,11/14/14,7,2,10,0,3,22
410,11/15/14,16,4,11,0,19,50
411,11/16/14,10,0,8,0,4,22
412,11/17/14,8,3,6,0,2,19
413,11/18/14,10,1,4,0,12,27
414,11/19/14,8,1,7,0,2,18
415,11/20/14,5,8,12,0,4,29
416,11/21/14,16,2,5,0,13,36
417,11/22/14,9,2,11,0,5,27
418,11/23/14,24,1,12,0,12,49
419,11/24/14,9,2,9,0,10,30
420,11/25/14,9,2,8,0,7,26
421,11/26/14,16,0,8,0,4,28
422,11/27/14,2,1,2,0,4,9
423,11/28/14,13,2,11,0,4,30
424,11/29/14,23,0,6,0,14,43
425,11/30/14,18,1,9,0,8,36
426,12/1/14,11,2,11,0,6,30
427,12/2/14,14,2,10,0,0,26
428,12/3/14,7,1,7,0,5,20
429,12/4/14,7,2,8,1,42,60
430,12/5/14,18,2,11,0,16,47
431,12/6/14,36,1,4,0,2,43
432,12/7/14,32,1,14,0,15,62
433,12/8/14,21,2,7,0,11,41
434,12/9/14,14,1,4,0,8,27
435,12/10/14,5,4,6,0,12,27
436,12/11/14,13,2,7,0,10,32
437,12/12/14,7,1,9,0,8,25
438,12/13/14,17,1,11,0,2,31
439,12/14/14,10,0,7,0,3,20
440,12/15/14,13,4,6,1,7,31
441,12/16/14,9,1,10,1,3,24
442,12/17/14,16,1,16,0,5,38
443,12/18/14,13,3,7,0,9,32
444,12/19/14,15,1,7,0,7,30
445,12/20/14,18,1,10,0,10,39
446,12/21/14,9,0,9,1,0,19
447,12/22/14,11,4,8,0,2,25
448,12/23/14,11,4,1,0,12,28
449,12/24/14,14,1,6,0,3,24
450,12/25/14,0,2,3,0,0,5
451,12/26/14,11,0,11,0,7,29
452,12/27/14,18,0,18,0,13,49
453,12/28/14,13,0,5,0,5,23
454,12/29/14,11,0,5,0,3,19
455,12/30/14,16,2,10,0,5,33
456,12/31/14,18,1,4,0,3,26
457,1/1/15,18,0,10,0,3,31
458,1/2/15,13,0,4,0,6,23
459,1/3/15,20,1,7,0,2,30
460,1/4/15,17,0,7,0,11,35
461,1/5/15,13,0,12,1,6,32
462,1/6/15,9,3,10,0,7,29
463,1/7/15,12,0,5,0,3,20
464,1/8/15,6,0,27,0,2,35
465,1/9/15,6,2,7,0,12,27
466,1/10/15,12,1,1,0,5,19
467,1/11/15,14,0,3,0,3,20
468,1/12/15,15,2,9,0,13,39
469,1/13/15,2,1,7,0,1,11
470,1/14/15,6,1,8,0,5,20
471,1/15/15,7,0,4,0,3,14
472,1/16/15,8,0,6,0,4,18
473,1/17/15,25,2,11,0,0,38
474,1/18/15,33,1,3,0,4,41
475,1/19/15,22,1,4,0,3,30
476,1/20/15,11,3,10,0,14,38
477,1/21/15,11,2,11,0,3,27
478,1/22/15,6,3,14,0,2,25
479,1/23/15,7,0,5,0,5,17
480,1/24/15,11,1,7,0,3,22
481,1/25/15,13,1,7,0,3,24
482,1/26/15,16,2,10,0,3,31
483,1/27/15,14,2,4,0,7,27
484,1/28/15,6,3,7,0,3,19
485,1/29/15,7,2,9,0,4,22
486,1/30/15,16,2,10,0,3,31
487,1/31/15,23,0,4,0,6,33
488,2/1/15,16,0,9,1,8,34
489,2/2/15,15,2,12,0,10,39
490,2/3/15,8,1,12,0,7,28
491,2/4/15,16,0,6,0,10,32
492,2/5/15,12,4,4,0,1,21
493,2/6/15,7,4,5,0,7,23
494,2/7/15,24,0,8,0,6,38
495,2/8/15,23,3,3,0,5,34
496,2/9/15,10,1,12,0,10,33
497,2/10/15,12,1,10,0,5,28
498,2/11/15,9,2,3,0,5,19
499,2/12/15,21,2,9,0,7,39
500,2/13/15,8,3,9,0,7,27
501,2/14/15,23,1,4,0,2,30
502,2/15/15,18,2,7,0,5,32
503,2/16/15,14,1,12,0,2,29
504,2/17/15,14,1,6,0,0,21
505,2/18/15,9,2,9,0,7,27
506,2/19/15,8,3,17,0,4,32
507,2/20/15,11,2,10,0,11,34
508,2/21/15,22,1,4,0,5,32
509,2/22/15,15,2,11,0,6,34
510,2/23/15,15,1,3,0,10,29
511,2/24/15,7,3,6,0,6,22
512,2/25/15,11,0,14,1,2,28
513,2/26/15,5,3,9,0,7,24
514,2/27/15,16,1,6,0,2,25
515,2/28/15,12,1,9,1,3,26
516,3/1/15,20,2,6,0,5,33
517,3/2/15,13,0,7,0,6,26
518,3/3/15,11,0,7,0,1,19
519,3/4/15,9,1,4,0,1,15
520,3/5/15,3,0,7,0,2,12
521,3/6/15,4,3,8,0,10,25
522,3/7/15,15,2,4,0,5,26
523,3/8/15,16,0,2,0,7,25
524,3/9/15,13,0,6,0,2,21
525,3/10/15,13,1,7,0,4,25
526,3/11/15,7,2,10,0,0,19
527,3/12/15,6,1,7,0,3,17
528,3/13/15,12,5,9,0,5,31
529,3/14/15,30,3,7,0,9,49
530,3/15/15,23,3,5,0,3,34
531,3/16/15,12,1,7,0,5,25
532,3/17/15,9,2,10,0,1,22
533,3/18/15,8,0,6,0,1,15
534,3/19/15,5,3,5,0,3,16
535,3/20/15,12,0,9,0,4,25
536,3/21/15,15,1,10,0,0,26
537,3/22/15,15,0,5,0,9,29
538,3/23/15,11,2,14,1,4,32
539,3/24/15,11,0,25,0,4,40
540,3/25/15,10,0,9,1,14,34
541,3/26/15,7,2,11,0,6,26
542,3/27/15,10,3,15,0,1,29
543,3/28/15,14,1,7,0,2,24
544,3/29/15,16,3,7,0,2,28
545,3/30/15,15,2,6,0,10,33
546,3/31/15,5,0,12,2,0,19
547,4/1/15,8,2,13,0,4,27
548,4/2/15,10,1,7,0,31,49
549,4/3/15,11,1,0,1,11,24
550,4/4/15,21,0,4,0,11,36
551,4/5/15,20,1,5,0,7,33
552,4/6/15,15,0,13,0,1,29
553,4/7/15,13,0,11,0,1,25
554,4/8/15,8,0,8,0,11,27
555,4/9/15,9,0,11,0,4,24
556,4/10/15,6,4,8,0,14,32
557,4/11/15,13,0,7,0,4,24
558,4/12/15,9,1,15,0,8,33
559,4/13/15,10,3,12,0,9,34
560,4/14/15,7,2,9,0,1,19
561,4/15/15,5,1,6,0,5,17
562,4/16/15,4,0,6,0,6,16
563,4/17/15,9,1,9,0,2,21
564,4/18/15,13,1,6,0,4,24
565,4/19/15,19,4,5,0,9,37
566,4/20/15,4,3,11,0,7,25
567,4/21/15,12,4,19,0,5,40
568,4/22/15,11,2,10,0,2,25
569,4/23/15,6,5,8,0,3,22
570,4/24/15,4,2,16,0,7,29
571,4/25/15,24,0,6,0,6,36
572,4/26/15,13,1,15,0,1,30
573,4/27/15,9,1,10,0,5,25
574,4/28/15,11,0,10,0,9,30
575,4/29/15,12,3,8,0,7,30
576,4/30/15,12,1,2,0,4,19
577,5/1/15,6,5,10,0,8,29
578,5/2/15,34,0,13,0,1,48
579,5/3/15,35,0,9,1,8,53
580,5/4/15,11,6,9,0,4,30
581,5/5/15,22,1,10,0,5,38
582,5/6/15,7,1,20,0,1,29
583,5/7/15,7,5,8,0,5,25
584,5/8/15,17,1,8,0,0,26
585,5/9/15,18,0,10,0,4,32
586,5/10/15,24,0,10,0,8,42
587,5/11/15,8,1,9,0,3,21
588,5/12/15,6,2,13,0,13,34
589,5/13/15,5,0,6,0,4,15
590,5/14/15,8,4,14,0,3,29
591,5/15/15,6,4,10,2,9,31
592,5/16/15,13,0,14,0,4,31
593,5/17/15,12,3,17,0,5,37
594,5/18/15,12,0,8,0,8,28
595,5/19/15,10,2,7,0,7,26
596,5/20/15,9,3,19,0,11,42
597,5/21/15,15,2,12,0,5,34
598,5/22/15,12,3,9,0,3,27
599,5/23/15,23,0,10,0,8,41
600,5/24/15,20,2,6,0,3,31
601,5/25/15,28,5,14,0,5,52
602,5/26/15,12,2,14,0,19,47
603,5/27/15,13,1,11,0,27,52
604,5/28/15,11,4,13,0,13,41
605,5/29/15,11,0,20,0,14,45
606,5/30/15,18,2,10,0,2,32
607,5/31/15,16,1,8,0,11,36
608,6/1/15,17,1,12,0,2,32
609,6/2/15,5,3,5,0,3,16
610,6/3/15,8,2,19,0,3,32
611,6/4/15,10,1,10,1,8,30
612,6/5/15,7,2,11,0,20,40
613,6/6/15,13,0,6,0,3,22
614,6/7/15,32,0,8,1,5,46
615,6/8/15,10,0,4,0,5,19
616,6/9/15,13,2,10,0,1,26
617,6/10/15,8,2,5,0,4,19
618,6/11/15,15,2,3,0,9,29
619,6/12/15,11,3,7,0,6,27
620,6/13/15,13,0,11,0,11,35
621,6/14/15,13,0,7,0,0,20
622,6/15/15,16,1,8,1,3,29
623,6/16/15,8,1,10,0,2,21
624,6/17/15,8,3,6,0,2,19
625,6/18/15,8,0,14,0,9,31
626,6/19/15,10,0,10,0,27,47
627,6/20/15,17,1,11,0,13,42
628,6/21/15,17,2,10,1,11,41
629,6/22/15,9,1,7,0,1,18
630,6/23/15,16,1,17,0,5,39
631,6/24/15,12,2,8,0,16,38
632,6/25/15,16,4,7,0,4,31
633,6/26/15,14,2,3,1,7,27
634,6/27/15,14,1,5,0,3,23
635,6/28/15,24,2,9,1,2,38
636,6/29/15,15,3,14,0,19,51
637,6/30/15,11,2,5,1,14,33
638,7/1/15,13,1,7,0,12,33
639,7/2/15,13,0,9,0,17,39
640,7/3/15,15,3,5,0,6,29
641,7/4/15,7,2,5,1,0,15
642,7/5/15,23,2,12,1,2,40
643,7/6/15,14,3,12,0,9,38
644,7/7/15,10,1,11,0,2,24
645,7/8/15,16,0,6,0,9,31
646,7/9/15,14,4,6,0,5,29
647,7/10/15,10,2,8,0,8,28
648,7/11/15,12,0,7,0,5,24
649,7/12/15,12,1,9,0,1,23
650,7/13/15,11,2,8,0,9,30
651,7/14/15,8,2,6,0,7,23
652,7/15/15,10,3,10,0,8,31
653,7/16/15,8,2,8,1,4,23
654,7/17/15,13,1,8,0,3,25
655,7/18/15,10,0,8,1,5,24
656,7/19/15,14,0,9,0,11,34
657,7/20/15,11,0,8,0,6,25
658,7/21/15,12,2,10,1,7,32
659,7/22/15,11,0,6,0,5,22
660,7/23/15,12,1,10,0,7,30
661,7/24/15,12,3,13,0,2,30
662,7/25/15,16,2,1,0,5,24
663,7/26/15,19,0,10,0,2,31
664,7/27/15,13,1,4,0,3,21
665,7/28/15,11,1,5,0,7,24
666,7/29/15,8,1,3,0,13,25
667,7/30/15,5,0,12,0,3,20
668,7/31/15,16,1,1,0,15,33
669,8/1/15,24,0,3,0,4,31
670,8/2/15,27,2,5,1,2,37
671,8/3/15,7,2,1,1,11,22
672,8/4/15,12,1,18,0,4,35
673,8/5/15,7,0,6,0,2,15
674,8/6/15,10,0,5,0,3,18
675,8/7/15,10,1,6,1,8,26
676,8/8/15,18,2,3,0,5,28
677,8/9/15,22,0,8,0,7,37
678,8/10/15,11,0,8,0,3,22
679,8/11/15,8,2,6,0,9,25
680,8/12/15,8,3,6,0,7,24
681,8/13/15,12,3,10,0,13,38
682,8/14/15,11,2,10,0,9,32
683,8/15/15,13,2,3,0,2,20
684,8/16/15,15,0,4,0,0,19
685,8/17/15,9,1,8,0,1,19
686,8/18/15,8,0,13,0,6,27
687,8/19/15,7,0,5,1,11,24
688,8/20/15,9,1,9,1,0,20
689,8/21/15,8,0,5,0,4,17
690,8/22/15,11,0,5,0,2,18
691,8/23/15,17,0,6,0,1,24
692,8/24/15,13,0,12,0,2,27
693,8/25/15,8,0,10,2,22,42
694,8/26/15,13,0,6,0,5,24
695,8/27/15,10,1,9,0,8,28
696,8/28/15,12,3,14,0,9,38
697,8/29/15,22,1,8,0,5,36
698,8/30/15,17,1,5,0,5,28
699,8/31/15,13,0,5,0,12,30
700,9/1/15,12,0,11,0,6,29
701,9/2/15,7,0,4,0,6,17
702,9/3/15,6,1,12,1,6,26
703,9/4/15,11,2,12,1,3,29
704,9/5/15,12,2,3,0,3,20
705,9/6/15,17,0,7,0,6,30
706,9/7/15,19,0,7,0,8,34
707,9/8/15,12,1,3,0,6,22
708,9/9/15,9,2,6,0,12,29
709,9/10/15,10,2,7,0,13,32
710,9/11/15,12,0,12,0,5,29
711,9/12/15,14,0,10,0,9,33
712,9/13/15,24,1,10,0,5,40
713,9/14/15,4,2,5,0,14,25
714,9/15/15,6,2,6,0,9,23
715,9/16/15,8,3,6,1,4,22
716,9/17/15,16,1,7,0,20,44
717,9/18/15,10,1,11,0,10,32
718,9/19/15,21,0,12,1,5,39
719,9/20/15,16,1,3,0,7,27
720,9/21/15,10,0,8,0,12,30
721,9/22/15,11,2,3,0,3,19
722,9/23/15,12,0,8,0,5,25
723,9/24/15,9,0,4,0,0,13
724,9/25/15,7,0,5,0,3,15
725,9/26/15,8,0,11,0,13,32
726,9/27/15,28,0,5,0,3,36
727,9/28/15,8,1,6,0,1,16
728,9/29/15,9,1,9,1,7,27
729,9/30/15,8,0,10,0,3,21
730,10/1/15,6,0,4,0,2,12
731,10/2/15,7,0,9,0,3,19
732,10/3/15,6,1,6,0,1,14
733,10/4/15,16,1,4,0,0,21
734,10/5/15,8,0,14,0,7,29
735,10/6/15,10,0,6,0,11,27
736,10/7/15,7,0,10,0,14,31
737,10/8/15,6,2,10,0,8,26
738,10/9/15,10,0,6,0,3,19
739,10/10/15,14,0,8,0,14,36
740,10/11/15,18,0,12,0,2,32
741,10/12/15,14,0,10,0,22,46
742,10/13/15,11,1,8,0,15,35
743,10/14/15,6,0,1,1,3,11
744,10/15/15,6,2,8,0,3,19
745,10/16/15,10,0,10,0,6,26
746,10/17/15,24,1,7,0,1,33
747,10/18/15,29,0,7,0,5,41
748,10/19/15,13,1,10,0,4,28
749,10/20/15,7,0,13,0,1,21
750,10/21/15,7,1,7,0,4,19
751,10/22/15,8,1,5,0,2,16
752,10/23/15,7,0,3,0,5,15
753,10/24/15,19,1,7,0,0,27
754,10/25/15,15,1,12,0,3,31
755,10/26/15,3,3,13,0,3,22
756,10/27/15,10,0,13,0,5,28
757,10/28/15,8,0,6,0,10,24
758,10/29/15,14,0,9,0,3,26
759,10/30/15,2,0,3,0,0,5
760,10/31/15,17,0,16,0,14,47
761,11/1/15,9,0,25,0,11,45
762,11/2/15,3,0,23,0,5,31
763,11/3/15,12,0,12,0,5,29
764,11/4/15,8,0,18,1,2,29
765,11/5/15,10,0,14,0,13,37
766,11/6/15,6,2,12,0,6,26
767,11/7/15,15,0,5,0,4,24
768,11/8/15,17,2,7,0,7,33
769,11/9/15,9,2,11,0,10,32
770,11/10/15,9,0,13,0,5,27
771,11/11/15,9,0,7,0,2,18
772,11/12/15,10,1,9,0,3,23
773,11/13/15,7,1,23,0,12,43
774,11/14/15,14,0,14,0,2,30
775,11/15/15,16,0,10,0,12,38
776,11/16/15,2,0,14,0,8,24
777,11/17/15,13,0,8,0,5,26
778,11/18/15,10,0,9,0,3,22
779,11/19/15,9,0,11,0,2,22
780,11/20/15,13,0,10,0,12,35
781,11/21/15,18,0,2,0,2,22
782,11/22/15,17,0,6,0,4,27
783,11/23/15,13,0,8,0,15,36
784,11/24/15,10,0,4,0,3,17
785,11/25/15,11,0,21,0,5,37
786,11/26/15,1,1,4,0,2,8
787,11/27/15,20,1,14,0,5,40
788,11/28/15,14,1,8,0,7,30
789,11/29/15,15,1,8,1,1,26
790,11/30/15,13,2,9,0,20,44
791,12/1/15,6,4,9,0,4,23
792,12/2/15,7,2,11,0,4,24
793,12/3/15,1,0,5,1,13,20
794,12/4/15,5,0,8,0,7,20
795,12/5/15,10,0,9,0,0,19
796,12/6/15,14,0,7,0,8,29
797,12/7/15,13,1,5,0,9,28
798,12/8/15,11,2,10,0,8,31
799,12/9/15,2,0,6,0,1,9
800,12/10/15,5,2,11,0,5,23
801,12/11/15,8,0,7,1,3,19
802,12/12/15,15,1,12,0,2,30
803,12/13/15,25,1,11,0,4,41
804,12/14/15,11,0,6,0,2,19
805,12/15/15,9,1,10,0,7,27
806,12/16/15,10,0,8,0,3,21
807,12/17/15,20,0,6,0,3,29
808,12/18/15,14,1,6,0,1,22
809,12/19/15,15,0,6,0,13,34
810,12/20/15,17,0,10,0,4,31
811,12/21/15,13,0,10,0,5,28
812,12/22/15,24,1,10,0,3,38
813,12/23/15,18,1,8,0,0,27
814,12/24/15,12,0,9,0,1,22
,12/25/15,,,,,,
815,12/26/15,20,0,15,1,7,43
816,12/27/15,11,0,8,0,13,32
817,12/28/15,10,0,12,0,8,30
818,12/29/15,15,0,9,0,2,26
819,12/30/15,5,5,12,0,3,25
820,12/31/15,15,0,8,0,5,28
821,1/1/16,1,0,4,0,7,12
822,1/2/16,12,0,11,0,8,31
823,1/3/16,12,0,10,1,1,24
824,1/4/16,9,0,14,0,13,36
825,1/5/16,13,0,8,0,8,29
826,1/6/16,8,1,17,0,12,38
827,1/7/16,9,1,8,0,11,29
828,1/8/16,9,0,6,0,3,18
829,1/9/16,19,0,2,0,3,24
830,1/10/16,16,0,13,0,4,33
831,1/11/16,13,1,6,0,0,20
832,1/12/16,15,0,13,0,6,34
833,1/13/16,10,0,10,1,6,27
834,1/14/16,8,0,9,0,1,18
835,1/15/16,15,0,5,0,3,23
836,1/16/16,18,2,4,0,20,44
837,1/17/16,16,2,11,1,9,39
838,1/18/16,18,0,7,0,15,40
839,1/19/16,5,0,12,0,8,25
840,1/20/16,13,0,6,0,7,26
841,1/21/16,12,0,4,0,8,24
842,1/22/16,12,0,8,0,8,28
843,1/23/16,17,1,6,0,7,31
844,1/24/16,20,0,6,0,1,27
845,1/25/16,10,0,5,0,20,35
846,1/26/16,8,1,12,0,1,22
847,1/27/16,7,1,8,0,5,21
848,1/28/16,10,0,5,0,6,21
849,1/29/16,4,0,9,0,8,21
850,1/30/16,13,0,9,0,1,23
851,1/31/16,12,1,6,0,8,27
852,2/1/16,8,1,9,0,2,20
853,2/2/16,7,0,6,0,16,29
854,2/3/16,7,1,9,0,3,20
855,2/4/16,12,1,6,0,1,20
856,2/5/16,11,1,2,1,8,23
857,2/6/16,22,0,6,0,3,31
858,2/7/16,15,0,9,0,9,33
859,2/8/16,14,0,7,0,4,25
860,2/9/16,8,0,3,1,2,14
861,2/10/16,12,0,4,0,4,20
862,2/11/16,16,0,4,0,4,24
863,2/12/16,12,2,13,0,2,29
864,2/13/16,32,0,7,0,0,39
865,2/14/16,22,0,16,0,1,39
866,2/15/16,24,1,7,0,15,47
867,2/16/16,6,2,14,0,10,32
868,2/17/16,0,0,6,0,4,10
869,2/18/16,16,3,4,0,0,23
870,2/19/16,10,0,7,0,4,21
871,2/20/16,16,1,11,0,3,31
872,2/21/16,16,0,9,0,8,33
873,2/22/16,9,0,11,1,7,28
874,2/23/16,15,0,7,0,1,23
875,2/24/16,14,1,13,0,5,33
876,2/25/16,10,2,13,0,2,27
877,2/26/16,11,0,11,1,2,25
878,2/27/16,20,0,5,0,1,26
879,2/28/16,16,0,10,2,16,44
880,2/29/16,13,0,11,0,6,30
881,3/1/16,9,1,10,0,15,35
882,3/2/16,14,4,9,0,7,34
883,3/3/16,11,0,8,0,13,32
884,3/4/16,8,0,6,0,0,14
885,3/5/16,24,0,11,0,0,35
886,3/6/16,14,2,3,0,11,30
887,3/7/16,7,0,14,0,9,30
888,3/8/16,17,3,8,0,7,35
889,3/9/16,11,0,12,0,1,24
890,3/10/16,4,1,7,0,3,15
891,3/11/16,9,0,7,0,6,22
892,3/12/16,15,0,10,0,1,26
893,3/13/16,13,0,9,0,2,24
894,3/14/16,12,1,19,0,6,38
895,3/15/16,14,1,5,0,4,24
896,3/16/16,13,0,9,0,2,24
897,3/17/16,16,1,4,0,5,26
898,3/18/16,8,0,7,0,4,19
899,3/19/16,8,1,7,0,7,23
900,3/20/16,19,2,12,0,13,46
901,3/21/16,12,0,7,0,4,23
902,3/22/16,7,3,5,0,11,26
903,3/23/16,6,4,10,1,3,24
904,3/24/16,15,0,10,0,4,29
905,3/25/16,12,0,9,0,1,22
906,3/26/16,30,2,4,0,7,43
907,3/27/16,10,1,16,0,8,35
908,3/28/16,11,0,11,0,10,32
909,3/29/16,18,0,13,0,2,33
910,3/30/16,7,0,7,0,3,17
911,3/31/16,3,0,11,1,2,17
912,4/1/16,8,0,10,0,2,20
913,4/2/16,17,0,3,0,6,26
914,4/3/16,20,1,9,0,0,30
915,4/4/16,13,0,10,0,5,28
916,4/5/16,14,1,8,0,4,27
917,4/6/16,8,1,8,0,6,23
918,4/7/16,14,0,5,0,7,26
919,4/8/16,8,0,7,0,1,16
920,4/9/16,17,0,11,0,4,32
921,4/10/16,12,0,6,0,5,23
922,4/11/16,12,1,15,0,9,37
923,4/12/16,6,0,12,0,1,19
924,4/13/16,3,0,6,0,3,12
925,4/14/16,13,1,5,0,1,20
926,4/15/16,10,0,11,0,6,27
927,4/16/16,20,0,4,0,5,29
928,4/17/16,14,0,4,0,9,27
929,4/18/16,10,0,9,0,33,52
930,4/19/16,5,2,10,0,1,18
931,4/20/16,10,1,12,1,2,26
932,4/21/16,8,0,15,0,3,26
933,4/22/16,10,0,13,1,0,24
934,4/23/16,11,0,11,0,1,23
935,4/24/16,14,0,10,0,2,26
936,4/25/16,7,1,7,0,14,29
937,4/26/16,11,0,11,0,5,27
938,4/27/16,11,0,11,0,4,26
939,4/28/16,11,1,8,0,2,22
940,4/29/16,10,0,9,0,3,22
941,4/30/16,17,4,9,0,2,32
942,5/1/16,17,0,13,0,1,31
943,5/2/16,8,0,12,0,3,23
944,5/3/16,12,0,12,0,3,27
945,5/4/16,13,1,12,0,4,30
946,5/5/16,7,1,7,0,1,16
947,5/6/16,8,2,13,0,2,25
948,5/7/16,24,0,9,0,6,39
949,5/8/16,15,0,12,1,5,33
950,5/9/16,17,1,12,0,13,43
951,5/10/16,12,1,7,1,7,28
952,5/11/16,4,1,13,1,9,28
953,5/12/16,11,0,11,0,3,25
954,5/13/16,7,1,9,0,3,20
955,5/14/16,18,0,13,0,4,35
956,5/15/16,18,1,9,0,3,31
957,5/16/16,10,1,8,0,11,30
958,5/17/16,12,0,8,0,5,25
959,5/18/16,11,0,20,1,3,35
960,5/19/16,5,0,12,1,21,39
961,5/20/16,9,2,13,0,2,26
962,5/21/16,23,0,4,0,21,48
963,5/22/16,27,2,3,0,8,40
964,5/23/16,13,0,15,0,13,41
965,5/24/16,19,0,13,0,3,35
966,5/25/16,12,1,6,2,7,28
967,5/26/16,14,3,9,1,8,35
968,5/27/16,11,0,8,0,14,33
969,5/28/16,16,0,15,0,3,34
970,5/29/16,20,0,5,0,1,26
971,5/30/16,18,0,2,0,13,33
972,5/31/16,11,1,7,0,12,31
973,6/1/16,3,0,9,0,9,21
974,6/2/16,11,1,18,1,5,36
975,6/3/16,14,0,5,1,9,29
976,6/4/16,21,1,6,2,10,40
977,6/5/16,22,1,8,0,2,33
978,6/6/16,21,0,6,1,2,30
979,6/7/16,8,2,8,0,6,24
980,6/8/16,3,0,6,0,7,16
981,6/9/16,16,0,8,0,8,32
982,6/10/16,20,1,10,0,9,40
983,6/11/16,27,4,4,0,2,37
984,6/12/16,18,0,3,0,1,22
985,6/13/16,10,2,2,0,3,17
986,6/14/16,16,0,6,0,2,24
987,6/15/16,8,0,4,0,0,12
988,6/16/16,17,2,4,0,2,25
989,6/17/16,10,0,4,0,8,22
990,6/18/16,25,0,8,0,5,38
991,6/19/16,26,1,4,0,2,33
992,6/20/16,23,0,8,0,6,37
993,6/21/16,11,0,10,0,14,35
994,6/22/16,14,3,14,0,1,32
995,6/23/16,6,0,8,0,4,18
996,6/24/16,8,0,6,0,4,18
997,6/25/16,17,0,7,0,5,29
998,6/26/16,21,0,8,0,9,38
999,6/27/16,9,1,7,0,2,19
1000,6/28/16,15,1,8,0,8,32
1001,6/29/16,10,0,12,0,6,28
1002,6/30/16,13,0,3,0,6,22
1003,7/1/16,5,0,8,0,4,17
1004,7/2/16,7,0,5,0,1,13
1005,7/3/16,15,1,5,0,2,23
1006,7/4/16,10,0,7,0,9,26
1007,7/5/16,17,0,8,0,16,41
1008,7/6/16,12,1,7,0,7,27
1009,7/7/16,17,0,6,0,3,26
1010,7/8/16,3,1,5,0,3,12
1011,7/9/16,21,0,8,0,3,32
1012,7/10/16,12,1,9,0,2,24
1013,7/11/16,9,1,8,0,5,23
1014,7/12/16,15,2,5,0,6,28
1015,7/13/16,13,0,7,0,6,26
1016,7/14/16,12,0,7,0,4,23
1017,7/15/16,3,0,11,0,6,20
1018,7/16/16,16,0,8,0,4,28
1019,7/17/16,13,0,2,0,9,24
1020,7/18/16,11,1,2,0,12,26
1021,7/19/16,9,0,4,0,10,23
1022,7/20/16,12,1,9,0,2,24
1023,7/21/16,29,1,8,0,1,39
1024,7/22/16,31,1,7,0,0,39
1025,7/23/16,31,0,5,0,0,36
1026,7/24/16,42,0,6,0,2,50
1027,7/25/16,19,0,8,0,6,33
1028,7/26/16,17,0,10,0,2,29
1029,7/27/16,14,0,8,0,2,24
1030,7/28/16,12,0,5,1,5,23
1031,7/29/16,7,0,11,0,6,24
1032,7/30/16,18,1,5,0,3,27
1033,7/31/16,29,0,4,0,2,35
1034,8/1/16,19,0,6,0,4,29
1035,8/2/16,12,0,2,1,1,16
1036,8/3/16,17,1,6,0,2,26
1037,8/4/16,9,0,8,0,3,20
1038,8/5/16,6,0,8,1,1,16
1039,8/6/16,8,1,4,0,2,15
1040,8/7/16,16,1,10,0,1,28
1041,8/8/16,14,1,12,0,1,28
1042,8/9/16,11,0,9,0,7,27
1043,8/10/16,12,0,7,0,2,21
1044,8/11/16,9,0,1,0,5,15
1045,8/12/16,10,0,3,0,6,19
1046,8/13/16,9,0,4,1,4,18
1047,8/14/16,7,1,6,0,2,16
1048,8/15/16,12,0,6,0,2,20
1049,8/16/16,17,1,10,0,6,34
1050,8/17/16,14,0,10,0,15,39
1051,8/18/16,20,1,6,0,2,29
1052,8/19/16,20,0,10,0,4,34
1053,8/20/16,18,0,5,1,2,26
1054,8/21/16,16,0,11,0,0,27
1055,8/22/16,10,0,10,0,10,30
1056,8/23/16,10,0,5,0,5,20
1057,8/24/16,22,0,4,0,3,29
1058,8/25/16,8,0,7,0,16,31
1059,8/26/16,7,0,9,0,13,29
1060,8/27/16,21,0,5,0,3,29
1061,8/28/16,18,1,8,0,4,31
1062,8/29/16,12,1,9,0,2,24
1063,8/30/16,11,0,6,0,3,20
1064,8/31/16,6,0,2,0,2,10
1065,9/1/16,15,1,6,0,4,26
1066,9/2/16,13,0,12,0,1,26
1067,9/3/16,19,0,5,0,1,25
1068,9/4/16,39,0,5,1,3,48
1069,9/5/16,12,0,7,0,3,22
1070,9/6/16,11,0,15,0,5,31
1071,9/7/16,13,0,7,0,1,21
1072,9/8/16,16,1,15,0,4,36
1073,9/9/16,11,0,10,0,11,32
1074,9/10/16,16,0,7,0,1,24
1075,9/11/16,20,1,6,0,3,30
1076,9/12/16,15,0,9,0,13,37
1077,9/13/16,11,1,12,0,8,32
1078,9/14/16,9,3,4,0,2,18
1079,9/15/16,7,0,4,0,6,17
1080,9/16/16,7,0,9,1,1,18
1081,9/17/16,15,0,5,0,5,25
1082,9/18/16,13,0,4,0,4,21
1083,9/19/16,10,0,13,0,2,25
1084,9/20/16,12,1,5,1,7,26
1085,9/21/16,18,1,8,0,7,34
1086,9/22/16,14,0,6,0,7,27
1087,9/23/16,12,3,7,0,7,29
1088,9/24/16,22,0,8,0,8,38
1089,9/25/16,17,0,7,0,3,27
1090,9/26/16,10,0,11,0,10,31
1091,9/27/16,2,0,6,0,6,14
1092,9/28/16,10,0,13,0,3,26
1093,9/29/16,7,0,3,0,13,23
1094,9/30/16,14,0,8,0,4,26
1095,10/1/16,26,0,10,0,5,41
1096,10/2/16,11,0,8,0,3,22
1097,10/3/16,12,0,15,0,6,33
1098,10/4/16,11,2,9,1,1,24
1099,10/5/16,15,0,8,0,2,25
1100,10/6/16,18,0,1,0,4,23
1101,10/7/16,25,0,4,0,1,30
1102,10/8/16,20,0,5,0,4,29
1103,10/9/16,22,1,9,0,2,34
1104,10/10/16,10,0,11,0,5,26
1105,10/11/16,7,0,8,1,2,18
1106,10/12/16,11,0,6,0,1,18
1107,10/13/16,4,0,8,0,5,17
1108,10/14/16,11,0,10,0,2,23
1109,10/15/16,14,1,9,0,2,26
1110,10/16/16,20,0,4,0,2,26
1111,10/17/16,8,0,12,1,7,28
1112,10/18/16,10,2,11,0,12,35
1113,10/19/16,10,0,3,0,10,23
1114,10/20/16,11,1,10,0,9,31
1115,10/21/16,7,2,6,0,3,18
1116,10/22/16,9,0,6,2,3,20
1117,10/23/16,20,0,4,0,7,31
1118,10/24/16,7,0,9,0,11,27
1119,10/25/16,8,1,8,1,3,21
1120,10/26/16,11,1,5,0,6,23
1121,10/27/16,8,0,3,0,6,17
1122,10/28/16,7,0,5,1,6,19
1123,10/29/16,13,0,4,0,3,20
1124,10/30/16,11,0,2,0,3,16
1125,10/31/16,12,0,6,0,4,22
1126,11/1/16,9,2,8,0,2,21
1127,11/2/16,9,0,7,1,6,23
1128,11/3/16,8,0,9,0,4,21
1129,11/4/16,20,1,8,0,14,43
1130,11/5/16,16,0,8,0,2,26
1131,11/6/16,16,0,12,0,6,34
1132,11/7/16,13,0,5,0,5,23
1133,11/8/16,12,0,5,0,8,25
1134,11/9/16,3,0,11,0,0,14
1135,11/10/16,10,1,6,0,6,23
1136,11/11/16,7,2,11,0,10,30
1137,11/12/16,18,0,12,0,2,32
1138,11/13/16,18,0,15,0,3,36
1139,11/14/16,10,1,12,0,13,36
1140,11/15/16,6,0,9,0,11,26
1141,11/16/16,6,0,6,0,1,13
1142,11/17/16,5,0,16,0,2,23
1143,11/18/16,15,0,18,0,1,34
1144,11/19/16,15,0,12,0,6,33
1145,11/20/16,13,0,11,1,2,27
1146,11/21/16,11,0,11,0,2,24
1147,11/22/16,10,1,9,0,5,25
1148,11/23/16,7,0,4,1,6,18
1149,11/24/16,0,0,2,0,0,2
1150,11/25/16,32,0,7,0,5,44
1151,11/26/16,36,0,16,0,12,64
1152,11/27/16,27,2,6,0,0,35
1153,11/28/16,19,1,10,0,6,36
1154,11/29/16,14,2,11,0,8,35
1155,11/30/16,9,1,6,0,7,23
1156,12/1/16,7,0,7,0,0,14
1157,12/2/16,7,0,3,0,2,12
1158,12/3/16,6,0,8,0,6,20
1159,12/4/16,15,0,8,0,4,27
1160,12/5/16,7,1,7,0,5,20
1161,12/6/16,6,2,10,0,3,21
1162,12/7/16,18,1,16,0,3,38
1163,12/8/16,14,1,13,0,2,30
1164,12/9/16,8,0,12,0,6,26
1165,12/10/16,22,0,8,1,8,39
1166,12/11/16,18,0,9,0,6,33
1167,12/12/16,10,1,8,0,18,37
1168,12/13/16,20,0,7,0,1,28
1169,12/14/16,11,1,7,0,4,23
1170,12/15/16,14,1,6,0,1,22
1171,12/16/16,10,1,6,0,1,18
1172,12/17/16,18,0,6,1,3,28
1173,12/18/16,21,0,5,0,7,33
1174,12/19/16,8,2,9,0,0,19
1175,12/20/16,21,0,7,1,6,35
1176,12/21/16,16,0,3,0,1,20
1177,12/22/16,13,1,0,0,13,27
1178,12/23/16,12,0,8,0,6,26
1179,12/24/16,21,0,4,0,0,25
1180,12/25/16,1,0,0,0,0,1
1181,12/26/16,14,0,6,0,3,23
1182,12/27/16,15,0,16,0,2,33
1183,12/28/16,10,2,7,0,5,24
1184,12/29/16,9,0,26,0,8,43
1185,12/30/16,25,0,4,1,9,39
1186,12/31/16,25,0,9,0,3,37
1187,1/1/17,2,0,7,1,0,10
1188,1/2/17,24,0,16,0,1,41
1189,1/3/17,15,0,11,0,3,29
1190,1/4/17,0,0,2,0,0,2
1191,1/5/17,9,1,9,0,10,29
1192,1/6/17,17,0,14,0,3,34
1193,1/7/17,17,0,13,0,3,33
1194,1/8/17,17,0,6,0,4,27
1195,1/9/17,10,1,9,0,2,22
1196,1/10/17,15,0,9,0,6,30
1197,1/11/17,7,0,5,1,2,15
1198,1/12/17,15,0,9,0,9,33
1199,1/13/17,13,0,10,0,3,26
1200,1/14/17,16,0,5,3,7,31
1201,1/15/17,13,0,12,0,11,36
1202,1/16/17,12,2,16,0,6,36
1203,1/17/17,9,0,5,0,4,18
1204,1/18/17,13,1,5,0,17,36
1205,1/19/17,8,0,8,0,6,22
1206,1/20/17,9,0,6,0,3,18
1207,1/21/17,5,0,6,0,1,12
1208,1/22/17,19,0,8,0,4,31
1209,1/23/17,15,1,12,0,5,33
1210,1/24/17,18,0,6,0,5,29
1211,1/25/17,9,0,11,0,2,22
1212,1/26/17,12,0,13,0,5,30
1213,1/27/17,8,0,5,0,4,17
1214,1/28/17,44,0,7,0,1,52
1215,1/29/17,50,0,4,1,2,57
1216,1/30/17,11,1,1,0,10,23
1217,1/31/17,19,0,3,0,2,24
1218,2/1/17,10,0,4,0,2,16
1219,2/2/17,12,0,11,0,2,25
1220,2/3/17,17,1,13,0,7,38
1221,2/4/17,16,0,10,0,4,30
1222,2/5/17,18,0,6,0,4,28
1223,2/6/17,12,1,13,0,9,35
1224,2/7/17,7,0,5,0,8,20
1225,2/8/17,13,0,12,0,6,31
1226,2/9/17,10,0,5,0,16,31
1227,2/10/17,29,0,15,0,4,48
1228,2/11/17,55,1,9,0,3,68
1229,2/12/17,51,0,3,0,0,54
1230,2/13/17,13,0,7,1,11,32
1231,2/14/17,21,0,12,0,14,47
1232,2/15/17,8,0,7,1,2,18
1233,2/16/17,8,0,8,1,4,21
1234,2/17/17,8,0,16,0,8,32
1235,2/18/17,10,0,8,0,0,18
1236,2/19/17,15,1,8,0,2,26
1237,2/20/17,15,1,9,0,7,32
1238,2/21/17,17,0,12,0,9,38
1239,2/22/17,13,2,8,0,1,24
1240,2/23/17,10,0,7,1,11,29
1241,2/24/17,15,0,9,0,4,28
1242,2/25/17,13,1,11,0,8,33
1243,2/26/17,24,0,12,0,1,37
1244,2/27/17,10,0,2,0,13,25
1245,2/28/17,13,0,3,0,7,23
1246,3/1/17,14,0,8,0,5,27
1247,3/2/17,16,0,13,0,6,35
1248,3/3/17,13,0,9,0,4,26
1249,3/4/17,15,1,13,0,1,30
1250,3/5/17,9,0,7,0,3,19
1251,3/6/17,8,0,14,0,7,29
1252,3/7/17,4,0,17,0,1,22
1253,3/8/17,10,0,13,0,6,29
1254,3/9/17,7,0,11,0,3,21
1255,3/10/17,5,0,6,0,10,21
1256,3/11/17,8,0,11,0,1,20
1257,3/12/17,9,0,7,0,3,19
1258,3/13/17,13,0,8,1,18,40
1259,3/14/17,8,0,9,0,10,27
1260,3/15/17,14,0,12,0,4,30
1261,3/16/17,7,0,14,0,7,28
1262,3/17/17,8,0,11,0,11,30
1263,3/18/17,12,0,9,2,4,27
1264,3/19/17,22,0,6,0,4,32
1265,3/20/17,13,1,6,0,5,25
1266,3/21/17,12,0,7,0,6,25
1267,3/22/17,5,0,6,0,3,14
1268,3/23/17,8,0,14,0,1,23
1269,3/24/17,6,0,4,0,16,26
1270,3/25/17,11,0,9,0,1,21
1271,3/26/17,16,1,8,1,1,27
1272,3/27/17,9,0,9,0,10,28
1273,3/28/17,12,0,11,0,19,42
1274,3/29/17,7,0,12,0,4,23
1275,3/30/17,11,0,7,0,7,25
1276,3/31/17,9,0,10,0,1,20
1277,4/1/17,13,0,7,0,3,23
1278,4/2/17,10,1,9,0,0,20
1279,4/3/17,16,0,5,0,10,31
1280,4/4/17,18,0,8,0,10,36
1281,4/5/17,8,0,13,0,3,24
1282,4/6/17,1,0,2,0,2,5
1283,4/7/17,11,0,6,0,4,21
1284,4/8/17,20,0,5,0,4,29
1285,4/9/17,22,0,4,0,2,28
1286,4/10/17,7,0,14,0,10,31
1287,4/11/17,15,0,9,0,14,38
1288,4/12/17,17,3,10,0,4,34
1289,4/13/17,21,0,9,0,2,32
1290,4/14/17,20,1,6,0,9,36
1291,4/15/17,31,0,10,0,1,42
1292,4/16/17,18,1,6,0,3,28
1293,4/17/17,14,0,6,0,8,28
1294,4/18/17,8,0,6,0,10,24
1295,4/19/17,10,0,7,0,9,26
1296,4/20/17,3,0,6,0,4,13
1297,4/21/17,6,0,7,0,2,15
1298,4/22/17,13,0,12,0,3,28
1299,4/23/17,11,0,7,0,6,24
1300,4/24/17,5,0,10,0,6,21
1301,4/25/17,7,0,9,0,4,20
1302,4/26/17,13,0,9,0,11,33
1303,4/27/17,9,1,6,0,7,23
1304,4/28/17,11,0,16,0,15,42
1305,4/29/17,2,0,3,1,1,7
1306,4/30/17,10,0,11,0,3,24
1307,5/1/17,7,2,7,1,4,21
1308,5/2/17,10,0,8,0,7,25
1309,5/3/17,21,0,8,0,16,45
1310,5/4/17,6,1,8,0,6,21
1311,5/5/17,8,0,9,0,8,25
1312,5/6/17,22,0,7,0,3,32
1313,5/7/17,16,0,3,1,2,22
1314,5/8/17,21,0,8,0,1,30
1315,5/9/17,23,0,17,0,5,45
1316,5/10/17,12,0,5,0,6,23
1317,5/11/17,12,0,13,0,2,27
1318,5/12/17,7,1,9,0,2,19
1319,5/13/17,11,0,9,0,0,20
1320,5/14/17,11,0,9,0,10,30
1321,5/15/17,5,0,6,0,12,23
1322,5/16/17,9,0,10,0,2,21
1323,5/17/17,10,1,8,0,8,27
1324,5/18/17,4,0,6,1,5,16
1325,5/19/17,15,0,8,0,21,44
1326,5/20/17,16,0,4,1,2,23
1327,5/21/17,12,1,5,0,2,20
1328,5/22/17,9,1,9,0,7,26
1329,5/23/17,12,1,4,0,4,21
1330,5/24/17,10,1,9,0,13,33
1331,5/25/17,9,0,13,0,7,29
1332,5/26/17,18,0,10,0,16,44
1333,5/27/17,35,0,7,0,0,42
1334,5/28/17,33,0,11,1,4,49
1335,5/29/17,39,0,7,0,2,48
1336,5/30/17,14,0,11,0,10,35
1337,5/31/17,10,0,9,0,13,32
1338,6/1/17,7,0,8,1,2,18
1339,6/2/17,5,1,7,0,9,22
1340,6/3/17,10,0,6,0,6,22
1341,6/4/17,14,1,12,0,1,28
1342,6/5/17,8,0,9,0,4,21
1343,6/6/17,21,0,9,0,6,36
1344,6/7/17,9,0,8,0,2,19
1345,6/8/17,7,0,10,0,4,21
1346,6/9/17,19,0,8,0,5,32
1347,6/10/17,21,0,5,0,0,26
1348,6/11/17,13,1,6,1,1,22
1349,6/12/17,20,0,9,0,2,31
1350,6/13/17,12,0,7,0,8,27
1351,6/14/17,6,0,6,0,1,13
1352,6/15/17,7,2,4,0,1,14
1353,6/16/17,12,0,7,0,4,23
1354,6/17/17,9,0,17,0,2,28
1355,6/18/17,17,1,3,0,1,22
1356,6/19/17,5,1,13,0,15,34
1357,6/20/17,12,0,10,0,12,34
1358,6/21/17,9,0,13,0,1,23
1359,6/22/17,12,0,4,0,7,23
1360,6/23/17,14,0,10,0,11,35
1361,6/24/17,21,0,5,1,4,31
1362,6/25/17,14,0,8,1,2,25
1363,6/26/17,13,0,3,0,12,28
1364,6/27/17,15,4,14,0,10,43
1365,6/28/17,3,0,12,0,4,19
1366,6/29/17,14,1,5,0,1,21
1367,6/30/17,8,0,9,0,3,20
1368,7/1/17,10,0,4,0,5,19
1369,7/2/17,19,0,14,0,4,37
1370,7/3/17,12,0,10,1,20,43
1371,7/4/17,13,1,5,0,13,32
1372,7/5/17,11,2,10,0,1,24
1373,7/6/17,12,0,15,1,9,37
1374,7/7/17,13,0,7,0,9,29
1375,7/8/17,14,0,9,0,1,24
1376,7/9/17,4,0,3,0,1,8
1377,7/10/17,16,1,11,0,5,33
1378,7/11/17,10,0,4,0,22,36
1379,7/12/17,17,0,6,0,9,32
1380,7/13/17,16,0,9,0,9,34
1381,7/14/17,14,0,8,0,7,29
1382,7/15/17,15,1,6,0,1,23
1383,7/16/17,11,0,4,0,1,16
1384,7/17/17,6,1,10,0,16,33
1385,7/18/17,19,0,8,0,9,36
1386,7/19/17,3,1,6,0,4,14
1387,7/20/17,8,0,5,0,4,17
1388,7/21/17,14,0,8,0,8,30
1389,7/22/17,11,1,5,0,6,23
1390,7/23/17,15,1,6,0,0,22
1391,7/24/17,14,1,10,1,4,30
1392,7/25/17,16,1,8,0,11,36
1393,7/26/17,11,0,5,0,3,19
1394,7/27/17,7,0,6,0,0,13
1395,7/28/17,13,0,7,0,6,26
1396,7/29/17,33,0,7,0,2,42
1397,7/30/17,18,0,4,0,5,27
1398,7/31/17,17,0,6,0,0,23
1399,8/1/17,12,0,10,0,13,35
1400,8/2/17,11,1,11,0,4,27
1401,8/3/17,10,0,10,0,3,23
1402,8/4/17,8,0,13,0,10,31
1403,8/5/17,13,0,5,0,5,23
1404,8/6/17,10,0,8,0,3,21
1405,8/7/17,12,0,5,0,12,29
1406,8/8/17,9,0,6,0,16,31
1407,8/9/17,5,0,4,0,1,10
1408,8/10/17,11,0,6,0,7,24
1409,8/11/17,8,0,5,0,6,19
1410,8/12/17,13,0,9,0,4,26
1411,8/13/17,10,0,9,0,2,21
1412,8/14/17,11,0,6,0,9,26
1413,8/15/17,12,0,5,0,12,29
1414,8/16/17,13,1,1,0,6,21
1415,8/17/17,15,0,15,1,16,47
1416,8/18/17,10,1,8,0,3,22
1417,8/19/17,79,0,1,0,1,81
1418,8/20/17,9,1,3,0,2,15
1419,8/21/17,9,0,8,0,2,19
1420,8/22/17,7,0,5,0,15,27
1421,8/23/17,18,1,5,0,5,29
1422,8/24/17,14,0,6,0,7,27
1423,8/25/17,9,0,6,0,4,19
1424,8/26/17,12,0,10,0,2,24
1425,8/27/17,8,0,7,0,4,19
1426,8/28/17,16,0,8,0,4,28
1427,8/29/17,11,0,10,0,1,22
1428,8/30/17,9,0,15,0,0,24
1429,8/31/17,13,0,11,0,3,27
1430,9/1/17,14,0,2,0,4,20
1431,9/2/17,21,1,8,0,1,31
1432,9/3/17,21,0,9,0,1,31
1433,9/4/17,18,0,17,0,14,49
1434,9/5/17,20,0,10,0,5,35
1435,9/6/17,12,0,12,0,4,28
1436,9/7/17,8,0,5,0,8,21
1437,9/8/17,6,0,12,0,1,19
1438,9/9/17,22,0,5,0,1,28
1439,9/10/17,15,0,8,0,1,24
1440,9/11/17,7,0,9,0,2,18
1441,9/12/17,18,0,5,1,5,29
1442,9/13/17,8,0,15,0,1,24
1443,9/14/17,3,0,8,1,7,19
1444,9/15/17,5,3,8,0,27,43
1445,9/16/17,27,0,11,0,3,41
1446,9/17/17,15,0,7,0,9,31
1447,9/18/17,5,0,5,0,8,18
1448,9/19/17,12,0,12,0,8,32
1449,9/20/17,11,0,5,0,6,22
1450,9/21/17,6,0,5,0,18,29
1451,9/22/17,6,0,9,0,8,23
1452,9/23/17,8,2,6,1,0,17
1453,9/24/17,15,1,12,0,5,33
1454,9/25/17,8,0,10,0,1,19
1455,9/26/17,9,0,5,0,13,27
1456,9/27/17,7,1,11,1,8,28
1457,9/28/17,6,1,6,0,12,25
1458,9/29/17,19,1,10,0,17,47
1459,9/30/17,15,1,6,0,0,22
1460,10/1/17,15,1,6,0,0,22
1461,10/2/17,15,1,15,0,10,41
1462,10/3/17,8,0,10,0,70,88
1463,10/4/17,11,1,16,0,29,57
1464,10/5/17,11,0,5,0,12,28
1465,10/6/17,12,0,10,0,12,34
1466,10/7/17,21,1,4,0,0,26
1467,10/8/17,27,0,7,0,2,36
1468,10/9/17,14,0,3,0,18,35
1469,10/10/17,12,1,9,0,4,26
1470,10/11/17,11,1,6,1,5,24
1471,10/12/17,12,0,8,1,3,24
1472,10/13/17,12,3,7,0,3,25
1473,10/14/17,9,0,12,0,4,25
1474,10/15/17,14,0,19,0,1,34
1475,10/16/17,11,0,8,0,12,31
1476,10/17/17,16,0,12,0,18,46
1477,10/18/17,10,0,8,0,1,19
1478,10/19/17,13,0,5,0,3,21
1479,10/20/17,9,0,7,0,7,23
1480,10/21/17,13,0,4,0,1,18
1481,10/22/17,12,0,10,0,1,23
1482,10/23/17,9,0,15,0,8,32
1483,10/24/17,9,0,11,0,4,24
1484,10/25/17,1,0,7,0,12,20
1485,10/26/17,14,0,2,0,8,24
1486,10/27/17,12,0,4,0,5,21
1487,10/28/17,29,0,11,0,2,42
1488,10/29/17,23,1,1,0,2,27
1489,10/30/17,24,1,6,0,6,37
1490,10/31/17,12,0,4,0,5,21
1491,11/1/17,20,0,9,0,3,32
1492,11/2/17,6,0,15,0,2,23
1493,11/3/17,6,1,4,0,12,23
1494,11/4/17,9,0,8,0,0,17
1495,11/5/17,6,0,10,0,1,17
1496,11/6/17,10,0,13,0,4,27
1497,11/7/17,9,0,12,0,1,22
1498,11/8/17,11,0,5,0,13,29
1499,11/9/17,8,0,9,0,8,25
1500,11/10/17,9,0,3,0,5,17
1501,11/11/17,6,0,5,0,5,16
1502,11/12/17,12,0,9,0,1,22
1503,11/13/17,13,1,14,0,1,29
1504,11/14/17,8,0,8,0,9,25
1505,11/15/17,8,0,9,0,4,21
1506,11/16/17,10,0,10,0,9,29
1507,11/17/17,9,0,4,0,20,33
1508,11/18/17,19,0,6,0,3,28
1509,11/19/17,10,0,8,0,3,21
1510,11/20/17,7,0,6,0,8,21
1511,11/21/17,11,1,10,0,5,27
1512,11/22/17,8,1,0,0,7,16
1513,11/23/17,1,1,5,0,0,7
1514,11/24/17,16,0,6,0,0,22
1515,11/25/17,15,0,5,0,1,21
1516,11/26/17,26,0,10,0,9,45
1517,11/27/17,14,0,7,0,1,22
1518,11/28/17,11,0,5,0,10,26
1519,11/29/17,4,1,7,0,6,18
1520,11/30/17,7,0,7,0,6,20
1521,12/1/17,11,0,7,0,15,33
1522,12/2/17,9,0,12,0,1,22
1523,12/3/17,11,0,5,0,2,18
1524,12/4/17,5,0,4,0,3,12
1525,12/5/17,2,1,11,0,2,16
1526,12/6/17,4,0,8,0,4,16
1527,12/7/17,6,0,7,0,4,17
1528,12/8/17,8,0,7,0,8,23
1529,12/9/17,24,0,11,0,12,47
1530,12/10/17,16,0,8,0,1,25
1531,12/11/17,21,0,5,0,3,29
1532,12/12/17,14,0,9,0,6,29
1533,12/13/17,9,0,10,0,8,27
1534,12/14/17,9,0,5,0,5,19
1535,12/15/17,12,1,12,0,4,29
1536,12/16/17,7,0,5,0,1,13
1537,12/17/17,16,0,7,0,0,23
1538,12/18/17,10,1,11,0,8,30
1539,12/19/17,8,0,7,0,0,15
1540,12/20/17,13,0,9,0,4,26
1541,12/21/17,15,0,7,0,16,38
1542,12/22/17,19,0,4,0,4,27
1543,12/23/17,18,0,10,0,8,36
1544,12/24/17,7,1,9,0,1,18
1545,12/25/17,0,0,2,0,0,2
1546,12/26/17,15,0,16,0,10,41
1547,12/27/17,16,0,10,0,2,28
1548,12/28/17,10,1,8,0,4,23
1549,12/29/17,16,2,6,1,2,27
1550,12/30/17,13,0,7,0,0,20
1551,12/31/17,22,0,6,0,4,32
1552,1/1/18,0,0,2,0,0,2
1553,1/2/18,6,0,10,0,3,19
1554,1/3/18,16,0,2,0,4,22
1555,1/4/18,19,1,15,0,4,39
1556,1/5/18,11,0,7,0,4,22
1557,1/6/18,12,0,7,0,0,19
1558,1/7/18,15,0,6,0,3,24
1559,1/8/18,14,2,11,1,1,29
1560,1/9/18,8,1,3,0,1,13
1561,1/10/18,12,0,9,0,6,27
1562,1/11/18,8,0,5,0,6,19
1563,1/12/18,14,0,9,0,4,27
1564,1/13/18,18,0,4,0,4,26
1565,1/14/18,34,0,8,0,8,50
1566,1/15/18,15,1,3,0,5,24
1567,1/16/18,0,0,5,0,0,5
1568,1/17/18,14,0,6,0,7,27
1569,1/18/18,13,0,7,1,9,30
1570,1/19/18,7,0,11,0,4,22
1571,1/20/18,14,0,15,0,0,29
1572,1/21/18,15,0,10,0,0,25
1573,1/22/18,13,0,14,0,5,32
1574,1/23/18,9,0,6,0,3,18
1575,1/24/18,8,0,15,0,13,36
1576,1/25/18,14,0,8,0,11,33
1577,1/26/18,9,0,8,0,2,19
1578,1/27/18,18,0,4,0,1,23
1579,1/28/18,17,0,8,0,1,26
1580,1/29/18,17,1,5,0,9,32
1581,1/30/18,5,0,6,0,12,23
1582,1/31/18,8,0,14,0,5,27
1583,2/1/18,17,1,8,0,2,28
1584,2/2/18,15,1,7,0,4,27
1585,2/3/18,23,1,7,1,3,35
1586,2/4/18,18,0,4,0,2,24
1587,2/5/18,10,0,6,1,3,20
1588,2/6/18,9,0,7,0,9,25
1589,2/7/18,7,0,15,0,0,22
1590,2/8/18,6,1,9,0,13,29
1591,2/9/18,16,0,8,0,5,29
1592,2/10/18,16,0,6,0,2,24
1593,2/11/18,13,1,15,0,0,29
1594,2/12/18,10,1,9,0,12,32
1595,2/13/18,15,0,14,0,3,32
1596,2/14/18,8,0,5,0,6,19
1597,2/15/18,11,0,4,0,9,24
1598,2/16/18,12,1,7,0,8,28
1599,2/17/18,10,0,7,0,3,20
1600,2/18/18,15,0,6,0,1,22
1601,2/19/18,16,0,8,0,6,30
1602,2/20/18,14,0,5,0,14,33
1603,2/21/18,8,1,6,0,5,20
1604,2/22/18,6,5,3,0,1,15
1605,2/23/18,13,0,5,0,4,22
1606,2/24/18,14,0,7,0,2,23
1607,2/25/18,13,2,9,0,1,25
1608,2/26/18,9,0,4,0,1,14
1609,2/27/18,9,0,4,0,11,24
1610,2/28/18,18,0,9,0,13,40
1611,3/1/18,14,1,8,0,5,28
1612,3/2/18,14,0,5,0,5,24
1613,3/3/18,15,0,8,0,12,35
1614,3/4/18,26,0,7,0,1,34
1615,3/5/18,13,0,11,0,1,25
1616,3/6/18,9,0,11,0,10,30
1617,3/7/18,0,0,7,0,0,7
1618,3/8/18,12,2,7,1,2,24
1619,3/9/18,7,0,9,0,7,23
1620,3/10/18,50,0,6,0,0,56
1621,3/11/18,31,0,7,0,1,39
1622,3/12/18,18,0,9,0,1,28
1623,3/13/18,8,0,7,0,5,20
1624,3/14/18,9,0,10,0,0,19
1625,3/15/18,7,0,11,1,5,24
1626,3/16/18,17,0,6,0,2,25
1627,3/17/18,42,0,8,0,0,50
1628,3/18/18,22,0,3,0,0,25
1629,3/19/18,9,2,5,0,3,19
1630,3/20/18,8,0,9,0,3,20
1631,3/21/18,8,0,10,0,13,31
1632,3/22/18,6,1,9,0,7,23
1633,3/23/18,7,1,9,0,2,19
1634,3/24/18,10,0,9,1,3,23
1635,3/25/18,22,0,4,0,0,26
1636,3/26/18,8,0,9,0,2,19
1637,3/27/18,11,0,10,0,4,25
1638,3/28/18,13,0,8,0,4,25
1639,3/29/18,16,1,14,0,2,33
1640,3/30/18,22,1,9,0,13,45
1641,3/31/18,13,1,10,0,2,26
1642,4/1/18,18,1,3,0,8,30
1643,4/2/18,6,0,6,0,10,22
1644,4/3/18,11,0,11,0,11,33
1645,4/4/18,15,0,5,0,13,33
1646,4/5/18,16,1,15,0,6,38
1647,4/6/18,20,0,6,0,12,38
1648,4/7/18,10,0,6,0,4,20
1649,4/8/18,17,0,7,0,4,28
1650,4/9/18,6,0,3,0,1,10
1651,4/10/18,17,0,9,0,7,33
1652,4/11/18,12,0,9,0,3,24
1653,4/12/18,2,0,12,0,6,20
1654,4/13/18,12,1,10,0,3,26
1655,4/14/18,16,0,10,0,6,32
1656,4/15/18,14,0,11,0,1,26
1657,4/16/18,14,0,8,0,13,35
1658,4/17/18,10,0,13,0,7,30
1659,4/18/18,3,0,10,0,7,20
1660,4/19/18,8,2,6,0,0,16
1661,4/20/18,12,1,7,0,7,27
1662,4/21/18,19,0,7,0,3,29
1663,4/22/18,17,0,1,0,1,19
1664,4/23/18,6,0,8,0,2,16
1665,4/24/18,8,0,9,0,5,22
1666,4/25/18,14,0,14,0,8,36
1667,4/26/18,13,0,11,1,3,28
1668,4/27/18,10,0,14,0,8,32
1669,4/28/18,10,0,4,0,3,17
1670,4/29/18,15,0,13,0,1,29
1671,4/30/18,15,1,13,0,7,36
1672,5/1/18,14,0,3,0,2,19
1673,5/2/18,12,3,4,1,8,28
1674,5/3/18,5,0,7,0,17,29
1675,5/4/18,16,0,8,0,3,27
1676,5/5/18,11,0,9,0,0,20
1677,5/6/18,34,0,8,0,0,42
1678,5/7/18,9,0,11,0,8,28
1679,5/8/18,7,0,7,0,14,28
1680,5/9/18,14,0,3,0,5,22
1681,5/10/18,16,0,10,0,6,32
1682,5/11/18,10,0,10,0,5,25
1683,5/12/18,10,0,10,0,15,35
1684,5/13/18,16,0,7,0,2,25
1685,5/14/18,11,1,2,0,7,21
1686,5/15/18,9,0,4,0,2,15
1687,5/16/18,15,1,10,0,10,36
1688,5/17/18,9,0,4,0,1,14
1689,5/18/18,8,0,6,0,1,15
1690,5/19/18,15,0,6,0,3,24
1691,5/20/18,11,0,3,0,5,19
1692,5/21/18,10,0,9,0,14,33
1693,5/22/18,14,0,8,0,16,38
1694,5/23/18,4,0,9,0,2,15
1695,5/24/18,5,0,9,1,8,23
1696,5/25/18,11,1,4,1,10,27
1697,5/26/18,17,0,10,0,2,29
1698,5/27/18,27,1,11,0,1,40
1699,5/28/18,36,0,6,0,6,48
1700,5/29/18,18,0,12,1,15,46
1701,5/30/18,18,0,7,0,0,25
1702,5/31/18,11,0,8,0,6,25
1703,6/1/18,12,0,4,0,5,21
1704,6/2/18,18,1,7,0,3,29
1705,6/3/18,20,0,9,0,1,30
1706,6/4/18,6,0,9,0,5,20
1707,6/5/18,16,1,6,0,4,27
1708,6/6/18,17,0,9,0,1,27
1709,6/7/18,8,0,5,0,15,28
1710,6/8/18,5,1,7,1,4,18
1711,6/9/18,17,0,3,0,3,23
1712,6/10/18,17,0,9,0,1,27
1713,6/11/18,21,0,10,0,3,34
1714,6/12/18,11,0,11,0,9,31
1715,6/13/18,7,0,6,0,7,20
1716,6/14/18,8,0,5,0,7,20
1717,6/15/18,11,0,2,0,16,29
1718,6/16/18,9,0,5,0,3,17
1719,6/17/18,7,0,9,0,1,17
1720,6/18/18,11,0,5,0,11,27
1721,6/19/18,10,0,9,0,7,26
1722,6/20/18,5,0,3,0,7,15
1723,6/21/18,6,1,3,0,5,15
1724,6/22/18,13,0,7,0,15,35
1725,6/23/18,25,0,6,1,2,34
1726,6/24/18,11,2,4,0,1,18
1727,6/25/18,19,0,5,0,5,29
1728,6/26/18,20,0,11,0,13,44
1729,6/27/18,22,0,9,0,5,36
1730,6/28/18,13,0,6,0,5,24
1731,6/29/18,15,0,7,0,5,27
1732,6/30/18,14,0,5,0,2,21
1733,7/1/18,23,0,5,0,0,28
1734,7/2/18,18,0,7,1,9,35
1735,7/3/18,13,1,6,0,1,21
1736,7/4/18,8,0,5,0,1,14
1737,7/5/18,10,0,7,0,20,37
1738,7/6/18,11,0,11,2,13,37
1739,7/7/18,17,0,11,0,1,29
1740,7/8/18,18,1,11,1,1,32
1741,7/9/18,15,0,10,0,7,32
1742,7/10/18,19,0,15,0,13,47
1743,7/11/18,8,0,13,1,4,26
1744,7/12/18,10,0,4,1,9,24
1745,7/13/18,14,0,7,0,9,30
1746,7/14/18,26,1,2,0,2,31
1747,7/15/18,9,0,14,1,4,28
1748,7/16/18,21,0,5,1,0,27
1749,7/17/18,13,1,4,0,7,25
1750,7/18/18,10,0,7,0,11,28
1751,7/19/18,6,0,8,1,9,24
1752,7/20/18,6,0,2,0,1,9
1753,7/21/18,16,0,5,0,5,26
1754,7/22/18,14,0,3,0,7,24
1755,7/23/18,11,0,9,0,6,26
1756,7/24/18,7,0,6,0,16,29
1757,7/25/18,7,0,9,0,3,19
1758,7/26/18,14,0,6,0,9,29
1759,7/27/18,9,0,5,0,10,24
1760,7/28/18,23,0,11,0,1,35
1761,7/29/18,27,0,4,0,0,31
1762,7/30/18,17,0,1,0,14,32
1763,7/31/18,10,0,2,0,6,18
1764,8/1/18,8,0,5,0,2,15
1765,8/2/18,6,0,9,0,12,27
1766,8/3/18,8,0,6,0,8,22
1767,8/4/18,13,0,6,1,0,20
1768,8/5/18,15,0,5,0,1,21
1769,8/6/18,12,0,11,0,13,36
1770,8/7/18,4,0,7,0,12,23
1771,8/8/18,15,0,2,0,10,27
1772,8/9/18,9,0,10,0,5,24
1773,8/10/18,12,1,6,0,5,24
1774,8/11/18,13,0,7,0,1,21
1775,8/12/18,36,0,5,0,16,57
1776,8/13/18,15,0,4,0,7,26
1777,8/14/18,16,0,12,0,28,56
1778,8/15/18,18,0,7,0,7,32
1779,8/16/18,11,0,6,0,6,23
1780,8/17/18,16,0,7,2,10,35
1781,8/18/18,66,0,4,0,1,71
1782,8/19/18,31,0,4,0,1,36
1783,8/20/18,16,0,2,0,3,21
1784,8/21/18,18,0,5,0,5,28
1785,8/22/18,17,1,13,0,2,33
1786,8/23/18,14,0,10,0,5,29
1787,8/24/18,21,0,6,0,4,31
1788,8/25/18,14,0,9,0,0,23
1789,8/26/18,11,0,9,0,7,27
1790,8/27/18,11,0,7,0,2,20
1791,8/28/18,14,1,1,1,1,18
1792,8/29/18,6,0,4,0,2,12
1793,8/30/18,5,1,8,0,1,15
1794,8/31/18,10,0,11,0,0,21
1795,9/1/18,12,0,9,0,4,25
1796,9/2/18,14,0,7,1,2,24
1797,9/3/18,24,1,11,0,5,41
1798,9/4/18,11,1,4,0,7,23
1799,9/5/18,8,0,12,0,7,27
1800,9/6/18,10,1,6,0,13,30
1801,9/7/18,7,0,13,0,5,25
1802,9/8/18,18,0,13,0,5,36
1803,9/9/18,13,0,14,2,1,30
1804,9/10/18,7,0,5,0,1,13
1805,9/11/18,12,0,8,0,20,40
1806,9/12/18,9,1,7,0,15,32
1807,9/13/18,11,0,11,0,14,36
1808,9/14/18,15,1,11,0,7,34
1809,9/15/18,16,0,6,0,1,23
1810,9/16/18,7,0,8,0,0,15
1811,9/17/18,22,1,9,0,2,34
1812,9/18/18,18,0,7,0,21,46
1813,9/19/18,17,1,3,0,2,23
1814,9/20/18,11,0,8,0,5,24
1815,9/21/18,14,0,10,0,10,34
1816,9/22/18,17,0,14,0,6,37
1817,9/23/18,10,1,8,0,2,21
1818,9/24/18,13,0,11,0,10,34
1819,9/25/18,11,0,11,0,13,35
1820,9/26/18,8,0,12,1,10,31
1821,9/27/18,8,0,4,0,3,15
1822,9/28/18,6,0,13,0,13,32
1823,9/29/18,14,0,7,0,5,26
1824,9/30/18,16,0,3,0,2,21
1825,10/1/18,10,0,9,0,10,29
1826,10/2/18,7,0,5,0,5,17
1827,10/3/18,5,0,10,1,4,20
1828,10/4/18,4,0,6,1,4,15
1829,10/5/18,25,0,6,0,2,33
1830,10/6/18,18,0,11,0,1,30
1831,10/7/18,24,0,6,0,1,31
1832,10/8/18,21,0,4,0,14,39
1833,10/9/18,17,1,4,0,11,33
1834,10/10/18,15,0,10,0,2,27
1835,10/11/18,7,0,9,0,5,21
1836,10/12/18,9,0,15,0,4,28
1837,10/13/18,15,0,12,1,5,33
1838,10/14/18,18,0,4,0,3,25
1839,10/15/18,16,0,11,0,7,34
1840,10/16/18,17,0,6,0,10,33
1841,10/17/18,17,0,6,0,7,30
1842,10/18/18,13,1,5,0,2,21
1843,10/19/18,13,0,5,0,8,26
1844,10/20/18,20,0,4,0,4,28
1845,10/21/18,7,0,9,0,6,22
1846,10/22/18,18,0,14,0,4,36
1847,10/23/18,22,0,14,0,2,38
1848,10/24/18,12,0,12,0,22,46
1849,10/25/18,8,0,10,0,4,22
1850,10/26/18,7,0,9,0,15,31
1851,10/27/18,16,0,3,0,13,32
1852,10/28/18,9,0,3,0,3,15
1853,10/29/18,10,0,4,0,5,19
1854,10/30/18,6,0,10,0,10,26
1855,10/31/18,7,0,9,0,4,20
1856,11/1/18,2,0,6,0,12,20
1857,11/2/18,6,0,12,0,8,26
1858,11/3/18,8,0,7,0,4,19
1859,11/4/18,6,0,11,0,8,25
1860,11/5/18,6,0,9,0,3,18
1861,11/6/18,5,0,5,0,7,17
1862,11/7/18,3,0,7,1,11,22
1863,11/8/18,6,0,6,0,5,17
1864,11/9/18,5,0,7,0,6,18
1865,11/10/18,7,1,10,0,2,20
1866,11/11/18,6,0,8,0,2,16
1867,11/12/18,1,0,15,0,9,25
1868,11/13/18,7,0,13,0,12,32
1869,11/14/18,1,0,8,0,14,23
1870,11/15/18,3,0,11,0,3,17
1871,11/16/18,6,0,9,0,7,22
1872,11/17/18,10,0,12,0,4,26
1873,11/18/18,2,0,6,0,1,9
1874,11/19/18,6,0,6,0,1,13
1875,11/20/18,2,0,5,0,11,18
1876,11/21/18,0,0,4,0,5,9
1877,11/22/18,0,0,3,0,0,3
1878,11/23/18,19,0,7,0,4,30
1879,11/24/18,9,0,14,0,2,25
1880,11/25/18,8,1,5,0,4,18
1881,11/26/18,8,1,7,0,15,31
1882,11/27/18,6,0,7,0,8,21
1883,11/28/18,6,0,10,1,4,21
1884,11/29/18,7,0,2,0,14,23
1885,11/30/18,13,0,3,0,3,19
1886,12/1/18,2,0,2,0,2,6
1887,12/2/18,7,0,10,0,2,19
1888,12/3/18,6,0,8,0,5,19
1889,12/4/18,17,0,9,0,14,40
1890,12/5/18,8,0,9,0,5,22
1891,12/6/18,17,0,5,0,15,37
1892,12/7/18,12,1,4,0,4,21
1893,12/8/18,14,0,7,2,0,23
1894,12/9/18,9,0,4,0,2,15
1895,12/10/18,15,0,12,0,2,29
1896,12/11/18,19,0,17,0,9,45
1897,12/12/18,19,0,8,0,6,33
1898,12/13/18,16,0,8,0,7,31
1899,12/14/18,31,0,14,0,17,62
1900,12/15/18,24,0,15,0,2,41
1901,12/16/18,26,0,12,0,14,52
1902,12/17/18,24,0,7,0,5,36
1903,12/18/18,21,0,5,0,2,28
1904,12/19/18,11,0,7,1,3,22
1905,12/20/18,25,0,11,0,0,36
1906,12/21/18,17,0,16,0,2,35
1907,12/22/18,18,0,8,0,1,27
1908,12/23/18,22,0,7,0,2,31
1909,12/24/18,12,0,8,0,3,23
1910,12/25/18,1,0,1,0,1,3
1911,12/26/18,19,0,3,0,5,27
1912,12/27/18,30,0,12,0,2,44
1913,12/28/18,19,0,4,0,10,33
1914,12/29/18,13,1,14,1,5,34
1915,12/30/18,21,0,5,0,1,27
1916,12/31/18,13,0,5,0,8,26
1917,1/1/19,1,0,4,0,0,5
1918,1/2/19,19,0,13,0,2,34
1919,1/3/19,20,0,9,0,7,36
1920,1/4/19,22,0,10,0,1,33
1921,1/5/19,18,0,10,0,3,31
1922,1/6/19,15,0,5,1,3,24
1923,1/7/19,21,0,9,0,6,36
1924,1/8/19,12,1,9,0,21,43
1925,1/9/19,14,1,11,1,3,30
1926,1/10/19,15,0,7,0,1,23
1927,1/11/19,26,0,11,0,2,39
1928,1/12/19,20,0,8,0,2,30
1929,1/13/19,17,0,7,0,9,33
1930,1/14/19,15,0,13,0,3,31
1931,1/15/19,13,1,7,0,8,29
1932,1/16/19,21,0,5,0,10,36
1933,1/17/19,16,0,1,0,7,24
1934,1/18/19,17,0,2,0,8,27
1935,1/19/19,32,0,10,0,3,45
1936,1/20/19,20,0,10,0,0,30
1937,1/21/19,24,0,13,0,9,46
1938,1/22/19,22,1,6,0,1,30
1939,1/23/19,22,0,10,0,14,46
1940,1/24/19,16,1,5,0,3,25
1941,1/25/19,17,0,2,0,3,22
1942,1/26/19,23,0,13,0,0,36
1943,1/27/19,19,0,5,0,1,25
1944,1/28/19,18,0,3,0,5,26
1945,1/29/19,12,2,8,0,10,32
1946,1/30/19,14,0,9,0,7,30
1947,1/31/19,8,2,10,0,9,29
1948,2/1/19,11,0,11,0,4,26
1949,2/2/19,13,0,7,1,3,24
1950,2/3/19,20,0,4,0,3,27
1951,2/4/19,9,1,6,1,1,18
1952,2/5/19,8,0,9,0,5,22
1953,2/6/19,15,0,8,0,9,32
1954,2/7/19,14,0,5,0,8,27
1955,2/8/19,9,0,7,0,2,18
1956,2/9/19,20,0,8,0,5,33
1957,2/10/19,18,0,5,0,3,26
1958,2/11/19,22,0,8,0,1,31
1959,2/12/19,18,0,9,0,13,40
1960,2/13/19,18,0,10,0,8,36
1961,2/14/19,21,0,8,0,5,34
1962,2/15/19,17,0,11,1,7,36
1963,2/16/19,21,0,7,0,1,29
1964,2/17/19,12,0,5,0,1,18
1965,2/18/19,14,0,12,0,7,33
1966,2/19/19,13,0,6,0,11,30
1967,2/20/19,16,2,5,0,2,25
1968,2/21/19,11,1,5,0,3,20
1969,2/22/19,14,2,9,0,5,30
1970,2/23/19,13,0,7,0,1,21
1971,2/24/19,17,0,8,1,4,30
1972,2/25/19,18,1,8,0,6,33
1973,2/26/19,9,0,8,0,10,27
1974,2/27/19,11,0,8,0,14,33
1975,2/28/19,10,0,10,0,2,22
1976,3/1/19,11,0,8,0,6,25
1977,3/2/19,11,1,8,0,2,22
1978,3/3/19,24,0,7,0,2,33
1979,3/4/19,15,0,12,0,5,32
1980,3/5/19,3,0,8,0,12,23
1981,3/6/19,9,0,7,4,3,23
1982,3/7/19,12,1,9,1,7,30
1983,3/8/19,23,1,10,0,9,43
1984,3/9/19,32,0,7,0,11,50
1985,3/10/19,21,0,14,0,2,37
1986,3/11/19,15,0,10,0,7,32
1987,3/12/19,21,0,9,0,8,38
1988,3/13/19,10,2,5,0,6,23
1989,3/14/19,9,0,2,0,5,16
1990,3/15/19,10,0,10,2,9,31
1991,3/16/19,27,0,16,1,0,44
1992,3/17/19,9,0,6,0,0,15
1993,3/18/19,19,0,6,0,6,31
1994,3/19/19,18,0,6,0,5,29
1995,3/20/19,11,0,9,0,21,41
1996,3/21/19,13,0,6,0,7,26
1997,3/22/19,19,0,5,0,26,50
1998,3/23/19,24,0,5,0,1,30
1999,3/24/19,10,1,6,0,3,20
2000,3/25/19,16,1,10,0,14,41
2001,3/26/19,23,0,13,2,7,45
2002,3/27/19,16,0,8,0,17,41
2003,3/28/19,13,0,6,1,1,21
2004,3/29/19,12,0,7,0,8,27
2005,3/30/19,17,0,7,1,2,27
2006,3/31/19,19,0,11,0,2,32
2007,4/1/19,12,1,5,0,4,22
2008,4/2/19,17,2,9,0,11,39
2009,4/3/19,15,0,9,1,11,36
2010,4/4/19,13,1,9,0,4,27
2011,4/5/19,14,1,5,0,0,20
2012,4/6/19,10,0,8,0,7,25
2013,4/7/19,17,0,5,0,7,29
2014,4/8/19,7,0,18,0,6,31
2015,4/9/19,8,0,5,0,8,21
2016,4/10/19,15,1,11,0,20,47
2017,4/11/19,8,0,16,1,3,28
2018,4/12/19,20,0,12,0,13,45
2019,4/13/19,36,0,9,0,0,45
2020,4/14/19,19,1,11,0,3,34
2021,4/15/19,12,0,11,0,25,48
2022,4/16/19,16,0,4,0,6,26
2023,4/17/19,6,0,8,0,8,22
2024,4/18/19,6,0,14,0,15,35
2025,4/19/19,13,1,8,0,4,26
2026,4/20/19,12,1,8,0,1,22
2027,4/21/19,15,1,3,0,1,20
2028,4/22/19,9,0,7,0,4,20
2029,4/23/19,20,0,10,0,9,39
2030,4/24/19,15,0,7,0,10,32
2031,4/25/19,6,0,11,0,7,24
2032,4/26/19,17,0,12,1,11,41
2033,4/27/19,17,0,7,0,0,24
2034,4/28/19,16,0,7,0,1,24
2035,4/29/19,4,0,8,0,8,20
2036,4/30/19,20,2,4,0,18,44
2037,5/1/19,9,0,9,1,6,25
2038,5/2/19,9,1,4,1,3,18
2039,5/3/19,8,0,12,0,1,21
2040,5/4/19,10,1,7,0,9,27
2041,5/5/19,24,0,8,0,2,34
2042,5/6/19,8,0,20,0,5,33
2043,5/7/19,4,0,17,0,8,29
2044,5/8/19,12,0,15,0,6,33
2045,5/9/19,10,0,9,0,9,28
2046,5/10/19,14,0,9,0,2,25
2047,5/11/19,18,0,9,0,6,33
2048,5/12/19,42,0,13,0,2,57
2049,5/13/19,18,2,4,1,15,40
2050,5/14/19,23,1,7,1,12,44
2051,5/15/19,23,0,11,0,5,39
2052,5/16/19,16,3,7,0,13,39
2053,5/17/19,5,1,4,1,1,12
2054,5/18/19,10,1,14,0,3,28
2055,5/19/19,11,0,5,0,3,19
2056,5/20/19,11,0,6,0,7,24
2057,5/21/19,11,0,10,0,3,24
2058,5/22/19,11,0,7,1,10,29
2059,5/23/19,14,1,5,0,4,24
2060,5/24/19,8,0,5,0,6,19
2061,5/25/19,23,0,10,1,3,37
2062,5/26/19,16,0,11,0,6,33
2063,5/27/19,12,2,3,0,7,24
2064,5/28/19,15,0,11,0,14,40
2065,5/29/19,14,0,8,0,17,39
2066,5/30/19,12,0,5,0,4,21
2067,5/31/19,14,0,9,1,8,32
2068,6/1/19,13,0,10,0,7,30
2069,6/2/19,19,0,5,2,2,28
2070,6/3/19,20,0,14,0,13,47
2071,6/4/19,21,1,10,0,2,34
2072,6/5/19,8,1,8,0,13,30
2073,6/6/19,12,0,9,0,6,27
2074,6/7/19,13,1,5,0,20,39
2075,6/8/19,22,1,6,0,9,38
2076,6/9/19,20,1,4,3,3,31
2077,6/10/19,16,1,14,2,5,38
2078,6/11/19,21,0,7,0,9,37
2079,6/12/19,16,1,9,1,9,36
2080,6/13/19,16,0,5,1,17,39
2081,6/14/19,16,3,6,0,9,34
2082,6/15/19,16,0,8,0,6,30
2083,6/16/19,30,1,8,2,4,45
2084,6/17/19,14,0,6,3,2,25
2085,6/18/19,13,0,6,0,14,33
2086,6/19/19,13,2,7,0,16,38
2087,6/20/19,16,0,11,1,6,34
2088,6/21/19,13,0,10,0,3,26
2089,6/22/19,14,0,9,1,1,25
2090,6/23/19,13,0,6,0,4,23
2091,6/24/19,7,0,11,1,4,23
2092,6/25/19,6,0,8,0,19,33
2093,6/26/19,11,0,6,0,12,29
2094,6/27/19,17,0,8,0,38,63
2095,6/28/19,17,0,7,0,38,62
2096,6/29/19,32,1,3,0,7,43
2097,6/30/19,32,0,6,0,4,42
2098,7/1/19,18,2,8,0,1,29
2099,7/2/19,15,0,3,1,12,31
2100,7/3/19,18,0,9,1,7,35
2101,7/4/19,8,0,1,0,0,9
2102,7/5/19,19,0,15,0,16,50
2103,7/6/19,23,1,5,0,3,32
2104,7/7/19,23,1,10,1,1,36
2105,7/8/19,11,0,11,0,8,30
2106,7/9/19,13,0,11,0,15,39
2107,7/10/19,15,0,10,1,20,46
2108,7/11/19,9,0,7,0,5,21
2109,7/12/19,16,0,4,0,4,24
2110,7/13/19,5,1,5,0,14,25
2111,7/14/19,13,1,4,0,1,19
2112,7/15/19,13,0,9,0,6,28
2113,7/16/19,18,1,19,0,6,44
2114,7/17/19,19,1,9,0,19,48
2115,7/18/19,9,0,6,0,9,24
2116,7/19/19,4,2,25,0,9,40
2117,7/20/19,22,0,10,0,7,39
2118,7/21/19,15,0,7,1,0,23
2119,7/22/19,8,0,13,0,4,25
2120,7/23/19,17,0,6,0,22,45
2121,7/24/19,18,1,6,0,14,39
2122,7/25/19,14,2,8,0,2,26
2123,7/26/19,10,1,9,0,3,23
2124,7/27/19,14,0,6,0,2,22
2125,7/28/19,18,1,12,0,3,34
2126,7/29/19,14,0,4,0,1,19
2127,7/30/19,11,1,3,1,12,28
2128,7/31/19,13,1,3,0,5,22
2129,8/1/19,9,0,6,0,6,21
2130,8/2/19,10,0,12,0,1,23
2131,8/3/19,10,1,7,0,14,32
2132,8/4/19,17,0,11,0,5,33
2133,8/5/19,11,0,6,0,13,30
2134,8/6/19,14,1,6,0,7,28
2135,8/7/19,15,0,9,0,8,32
2136,8/8/19,16,0,9,0,12,37
2137,8/9/19,17,1,5,0,6,29
2138,8/10/19,22,0,2,1,1,26
2139,8/11/19,23,0,11,2,2,38
2140,8/12/19,13,0,5,1,7,26
2141,8/13/19,16,0,4,0,13,33
2142,8/14/19,13,0,5,3,9,30
2143,8/15/19,18,0,4,0,4,26
2144,8/16/19,16,0,8,3,9,36
2145,8/17/19,60,0,9,0,0,69
2146,8/18/19,25,0,5,0,0,30
2147,8/19/19,28,0,11,0,5,44
2148,8/20/19,14,0,2,0,1,17
2149,8/21/19,14,0,10,0,12,36
2150,8/22/19,16,0,5,1,11,33
2151,8/23/19,18,3,7,0,9,37
2152,8/24/19,14,0,3,0,3,20
2153,8/25/19,24,0,8,0,1,33
2154,8/26/19,9,0,6,0,2,17
2155,8/27/19,17,0,6,0,12,35
2156,8/28/19,19,1,8,0,5,33
2157,8/29/19,8,1,9,0,16,34
2158,8/30/19,24,0,4,0,2,30
2159,8/31/19,13,1,3,0,11,28
2160,9/1/19,20,0,4,0,2,26
2161,9/2/19,9,2,6,0,7,24
2162,9/3/19,10,1,5,0,14,30
2163,9/4/19,7,0,14,1,7,29
2164,9/5/19,12,0,6,0,2,20
2165,9/6/19,15,2,4,0,13,34
2166,9/7/19,18,0,6,0,6,30
2167,9/8/19,15,0,12,0,2,29
2168,9/9/19,17,1,6,1,9,34
2169,9/10/19,11,0,18,0,16,45
2170,9/11/19,8,0,8,1,6,23
2171,9/12/19,14,0,9,1,3,27
2172,9/13/19,16,0,8,1,5,30
2173,9/14/19,23,0,6,0,0,29
2174,9/15/19,22,0,7,0,2,31
2175,9/16/19,18,2,5,0,10,35
2176,9/17/19,17,0,8,0,18,43
2177,9/18/19,10,0,2,0,8,20
2178,9/19/19,12,1,4,0,6,23
2179,9/20/19,15,0,6,0,5,26
2180,9/21/19,17,0,5,0,23,45
2181,9/22/19,14,1,6,0,1,22
2182,9/23/19,15,0,12,0,3,30
2183,9/24/19,9,0,7,0,8,24
2184,9/25/19,16,1,8,0,15,40
2185,9/26/19,13,0,7,0,12,32
2186,9/27/19,13,0,8,0,13,34
2187,9/28/19,22,0,3,0,2,27
2188,9/29/19,24,0,8,0,6,38
2189,9/30/19,16,1,4,0,8,29
2190,10/1/19,16,1,6,2,4,29
2191,10/2/19,9,0,3,0,20,32
2192,10/3/19,13,0,7,0,1,21
2193,10/4/19,12,0,6,0,6,24
2194,10/5/19,14,0,8,0,7,29
2195,10/6/19,15,0,15,1,3,34
2196,10/7/19,21,0,8,0,0,29
2197,10/8/19,14,0,5,0,13,32
2198,10/9/19,15,1,4,0,16,36
2199,10/10/19,7,1,4,0,9,21
2200,10/11/19,5,0,6,0,4,15
2201,10/12/19,10,0,11,0,1,22
2202,10/13/19,23,0,10,0,2,35
2203,10/14/19,14,1,14,0,9,38
2204,10/15/19,16,0,16,0,16,48
2205,10/16/19,11,0,7,0,4,22
2206,10/17/19,11,0,8,0,6,25
2207,10/18/19,9,0,7,0,7,23
2208,10/19/19,16,0,2,1,1,20
2209,10/20/19,16,0,9,0,0,25
2210,10/21/19,8,0,6,0,2,16
2211,10/22/19,9,1,2,1,19,32
2212,10/23/19,8,0,5,0,22,35
2213,10/24/19,7,0,4,1,7,19
2214,10/25/19,20,1,8,0,5,34
2215,10/26/19,21,0,9,0,13,43
2216,10/27/19,24,0,8,0,1,33
2217,10/28/19,20,0,8,0,6,34
2218,10/29/19,19,0,8,0,6,33
2219,10/30/19,18,0,6,0,12,36
2220,10/31/19,19,0,9,0,5,33
2221,11/1/19,13,0,1,0,2,16
2222,11/2/19,13,0,9,0,2,24
2223,11/3/19,17,0,17,0,2,36
2224,11/4/19,20,0,3,0,5,28
2225,11/5/19,12,0,4,0,13,29
2226,11/6/19,9,1,4,0,12,26
2227,11/7/19,10,0,6,0,5,21
2228,11/8/19,15,0,8,0,3,26
2229,11/9/19,20,0,5,0,5,30
2230,11/10/19,15,1,2,0,3,21
2231,11/11/19,17,2,5,0,3,27
2232,11/12/19,12,2,4,0,14,32
2233,11/13/19,14,0,7,0,0,21
2234,11/14/19,10,0,7,0,13,30
2235,11/15/19,5,0,10,0,12,27
2236,11/16/19,10,0,14,0,3,27
2237,11/17/19,12,0,10,0,1,23
2238,11/18/19,15,0,9,0,17,41
2239,11/19/19,20,0,10,0,7,37
2240,11/20/19,7,0,10,0,6,23
2241,11/21/19,11,1,10,0,12,34
2242,11/22/19,12,0,8,0,2,22
2243,11/23/19,9,0,6,0,0,15
2244,11/24/19,15,1,7,0,6,29
2245,11/25/19,11,0,6,0,27,44
2246,11/26/19,21,0,4,0,4,29
2247,11/27/19,20,2,5,0,1,28
,11/28/19,,,,,,
2248,11/29/19,43,1,9,0,4,57
2249,11/30/19,26,0,2,0,5,33
2250,12/1/19,25,1,5,0,1,32
2251,12/2/19,22,0,1,0,3,26
2252,12/3/19,27,0,7,0,16,50
2253,12/4/19,19,0,2,0,18,39
2254,12/5/19,13,0,11,0,2,26
2255,12/6/19,23,0,5,0,2,30
2256,12/7/19,17,0,4,0,1,22
2257,12/8/19,22,0,8,0,7,37
2258,12/9/19,24,0,1,0,4,29
2259,12/10/19,21,0,9,0,0,30
2260,12/11/19,13,0,5,0,4,22
2261,12/12/19,22,0,10,0,6,38
2262,12/13/19,14,0,8,0,5,27
2263,12/14/19,10,0,7,0,0,17
2264,12/15/19,12,0,4,0,1,17
2265,12/16/19,7,0,7,0,13,27
2266,12/17/19,17,0,14,0,10,41
2267,12/18/19,11,0,9,0,3,23
2268,12/19/19,24,0,13,0,4,41
2269,12/20/19,15,0,6,1,1,23
2270,12/21/19,21,0,5,0,0,26
2271,12/22/19,19,0,6,0,6,31
2272,12/23/19,19,0,10,0,2,31
2273,12/24/19,0,0,1,0,0,1
,12/25/19,,,,,,
2274,12/26/19,22,0,5,1,9,37
2275,12/27/19,12,0,7,0,7,26
2276,12/28/19,18,0,2,0,0,20
2277,12/29/19,8,1,7,0,5,21
2278,12/30/19,18,1,8,2,15,44
2279,12/31/19,26,0,9,1,8,44
2280,1/1/20,0,0,1,0,0,1
2281,1/2/20,18,0,12,1,16,47
2282,1/3/20,14,0,20,0,10,44
2283,1/4/20,14,1,11,0,5,31
2284,1/5/20,19,0,6,0,2,27
2285,1/6/20,21,0,10,0,3,34
2286,1/7/20,15,0,5,0,4,24
2287,1/8/20,23,0,13,1,10,47
2288,1/9/20,11,0,2,0,9,22
2289,1/10/20,12,0,3,0,17,32
2290,1/11/20,17,1,9,0,2,29
2291,1/12/20,16,0,9,0,1,26
2292,1/13/20,12,1,5,0,3,21
2293,1/14/20,13,1,4,0,16,34
2294,1/15/20,7,0,4,0,9,20
2295,1/16/20,7,3,3,0,2,15
2296,1/17/20,15,0,8,0,2,25
2297,1/18/20,26,1,7,0,1,35
2298,1/19/20,17,0,12,0,3,32
2299,1/20/20,0,1,0,0,0,1
2300,1/21/20,16,0,12,0,5,33
2301,1/22/20,13,1,6,0,15,35
2302,1/23/20,7,0,6,0,12,25
2303,1/24/20,13,0,7,0,0,20
2304,1/25/20,19,0,6,0,5,30
2305,1/26/20,14,1,6,0,3,24
2306,1/27/20,20,0,4,0,0,24
2307,1/28/20,11,2,10,0,10,33
2308,1/29/20,16,1,13,0,2,32
2309,1/30/20,7,1,7,0,12,27
2310,1/31/20,21,0,4,0,1,26
2311,2/1/20,15,0,10,0,0,25
2312,2/2/20,18,0,6,0,5,29
2313,2/3/20,13,1,3,0,1,18
2314,2/4/20,17,1,6,0,10,34
2315,2/5/20,10,0,4,0,7,21
2316,2/6/20,7,0,5,0,5,17
2317,2/7/20,17,1,6,0,4,28
2318,2/8/20,11,0,4,0,4,19
2319,2/9/20,9,0,4,0,5,18
2320,2/10/20,16,0,11,0,4,31
2321,2/11/20,17,0,8,0,4,29
2322,2/12/20,0,0,0,0,16,16
2323,2/13/20,18,0,4,0,4,26
2324,2/14/20,25,2,7,1,8,43
2325,2/15/20,28,0,6,0,1,35
2326,2/16/20,25,0,3,0,6,34
,2/17/20,,,,,,
2327,2/18/20,22,1,15,0,17,55
2328,2/19/20,19,1,5,0,17,42
2329,2/20/20,9,0,9,1,11,30
2330,2/21/20,8,0,2,0,10,20
2331,2/22/20,11,1,2,0,0,14
2332,2/23/20,3,1,7,0,1,12
2333,2/24/20,12,0,6,0,1,19
2334,2/25/20,16,0,5,1,29,51
2335,2/26/20,7,1,19,0,0,27
2336,2/27/20,22,1,4,1,7,35
2337,2/28/20,14,0,6,0,3,23
2338,2/29/20,23,1,8,0,4,36
2339,3/1/20,18,0,2,0,1,21
2340,3/2/20,13,0,7,1,8,29
2341,3/3/20,12,1,5,0,7,25
2342,3/4/20,10,0,5,1,20,36
2343,3/5/20,22,0,1,2,2,27
2344,3/6/20,10,1,10,0,8,29
2345,3/7/20,18,0,3,0,2,23
2346,3/8/20,14,0,2,0,4,20
2347,3/9/20,15,0,10,0,0,25
2348,3/10/20,17,2,8,1,6,34
2349,3/11/20,12,0,6,0,2,20
2350,3/12/20,12,0,3,1,21,37
2351,3/13/20,13,1,13,0,2,29
2352,3/14/20,24,0,6,0,1,31
2353,3/15/20,27,1,6,0,2,36
2354,3/16/20,9,0,5,0,6,20
2355,3/17/20,6,0,6,1,17,30
2356,3/18/20,2,0,3,0,7,12
2357,3/19/20,0,0,2,0,3,5
2358,3/20/20,0,0,1,0,10,11
2359,3/21/20,3,0,0,0,0,3
2360,3/22/20,0,0,4,1,0,5
2361,3/23/20,0,0,2,0,2,4
2362,3/24/20,0,1,23,0,15,39
2363,3/25/20,6,0,1,0,6,13
2364,3/26/20,4,0,3,0,2,9
2365,3/27/20,1,0,2,0,1,4
2366,3/28/20,5,1,5,0,0,11
2367,3/29/20,1,1,6,0,0,8
2368,3/30/20,0,1,0,0,1,2
2369,3/31/20,15,0,1,0,0,16
2370,4/1/20,5,0,3,0,0,8
2371,4/2/20,8,0,2,1,0,11
2372,4/3/20,2,0,1,0,3,6
2373,4/4/20,10,0,5,0,1,16
2374,4/5/20,3,0,5,0,2,10
2375,4/6/20,2,0,2,0,0,4
2376,4/7/20,17,0,3,0,0,20
2377,4/8/20,5,0,0,0,3,8
2378,4/9/20,4,0,4,0,1,9
2379,4/10/20,3,0,3,0,1,7
2380,4/11/20,2,1,1,0,1,5
,4/12/20,,,,,,
2381,4/13/20,1,0,6,0,3,10
2382,4/14/20,3,1,2,0,5,11
2383,4/15/20,11,1,2,0,0,14
2384,4/16/20,13,0,4,0,2,19
2385,4/17/20,0,0,1,0,1,2
2386,4/18/20,5,0,1,0,2,8
2387,4/19/20,0,3,0,0,2,5
2388,4/20/20,2,0,1,0,0,3
2389,4/21/20,10,0,3,0,5,18
2390,4/22/20,2,0,1,0,1,4
2391,4/23/20,2,0,0,0,1,3
2392,4/24/20,4,0,1,0,1,6
2393,4/25/20,0,0,2,0,0,2
2394,4/26/20,4,0,1,0,0,5
2395,4/27/20,1,1,1,0,2,5
2396,4/28/20,3,0,3,0,1,7
2397,4/29/20,7,0,2,0,2,11
2398,4/30/20,3,0,1,0,1,5
2399,5/1/20,2,0,4,0,1,7
2400,5/2/20,6,0,0,0,3,9
2401,5/3/20,0,0,0,0,2,2
2402,5/4/20,3,0,1,0,0,4
2403,5/5/20,4,0,2,0,4,10
2404,5/6/20,6,0,3,0,1,10
2405,5/7/20,11,0,5,1,1,18
2406,5/8/20,6,0,1,0,2,9
2407,5/9/20,5,0,0,0,4,9
2408,5/10/20,0,0,1,0,1,2
2409,5/11/20,2,0,0,0,2,4
2410,5/12/20,11,0,3,0,2,16
2411,5/13/20,7,0,4,0,1,12
2412,5/14/20,7,0,0,0,0,7
2413,5/15/20,6,0,3,0,0,9
2414,5/16/20,7,0,2,0,5,14
2415,5/17/20,3,0,2,0,2,7
2416,5/18/20,5,0,0,0,1,6
2417,5/19/20,5,0,2,0,0,7
2418,5/20/20,7,0,3,0,0,10
2419,5/21/20,1,0,0,0,2,3
2420,5/22/20,5,0,1,0,1,7
2421,5/23/20,0,0,0,0,3,3
2422,5/24/20,4,0,7,0,1,12
,5/25/20,,,,,,
2423,5/26/20,7,1,5,0,3,16
2424,5/27/20,9,1,8,0,6,24
2425,5/28/20,4,0,1,0,2,7
2426,5/29/20,4,0,3,0,0,7
2427,5/30/20,3,0,3,2,3,11
2428,5/31/20,3,0,1,0,0,4
2429,6/1/20,1,0,8,0,2,11
2430,6/2/20,14,0,2,0,3,19
2431,6/3/20,8,0,8,0,10,26
2432,6/4/20,4,0,0,0,2,6
2433,6/5/20,4,0,5,0,1,10
2434,6/6/20,6,0,2,0,2,10
2435,6/7/20,3,0,1,0,1,5
2436,6/8/20,8,0,4,0,7,19
2437,6/9/20,11,0,2,0,2,15
2438,6/10/20,6,1,2,1,5,15
2439,6/11/20,5,1,1,0,4,11
2440,6/12/20,3,1,0,0,6,10
2441,6/13/20,2,0,1,0,2,5
2442,6/14/20,3,0,4,0,0,7
2443,6/15/20,10,0,3,0,4,17
2444,6/16/20,6,0,9,0,3,18
2445,6/17/20,6,1,5,0,1,13
2446,6/18/20,5,1,2,0,0,8
2447,6/19/20,5,0,1,0,3,9
2448,6/20/20,4,0,2,0,2,8
2449,6/21/20,4,0,0,0,1,5
2450,6/22/20,9,0,2,0,8,19
2451,6/23/20,11,0,0,0,12,23
2452,6/24/20,6,0,1,0,0,7
2453,6/25/20,4,0,1,0,4,9
2454,6/26/20,8,0,4,0,0,12
2455,6/27/20,2,0,0,0,0,2
2456,6/28/20,3,0,4,0,0,7
2457,6/29/20,5,0,4,1,1,11
2458,6/30/20,6,1,4,0,1,12
2459,7/1/20,6,0,8,0,4,18
2460,7/2/20,6,0,1,0,1,8
2461,7/3/20,0,1,2,0,1,4
2462,7/4/20,5,0,0,1,2,8
2463,7/5/20,2,0,6,0,0,8
2464,7/6/20,6,0,0,1,2,9
2465,7/7/20,10,4,3,0,6,23
2466,7/8/20,6,0,1,0,1,8
2467,7/9/20,4,0,1,0,5,10
2468,7/10/20,4,0,1,0,3,8
2469,7/11/20,6,0,1,0,0,7
2470,7/12/20,4,1,2,0,2,9
2471,7/13/20,5,0,6,0,4,15
2472,7/14/20,5,0,2,0,15,22
2473,7/15/20,5,1,4,1,4,15
2474,7/16/20,6,0,2,0,4,12
2475,7/17/20,11,0,3,0,0,14
2476,7/18/20,3,0,7,0,4,14
2477,7/19/20,2,0,0,0,0,2
2478,7/20/20,5,0,5,1,4,15
2479,7/21/20,6,1,0,0,0,7
2480,7/22/20,1,1,1,0,12,15
2481,7/23/20,5,0,0,0,2,7
2482,7/24/20,0,0,4,0,2,6
2483,7/25/20,3,0,0,0,0,3
2484,7/26/20,6,0,0,0,0,6
2485,7/27/20,3,0,10,0,4,17
2486,7/28/20,19,0,2,0,3,24
2487,7/29/20,5,0,0,0,7,12
2488,7/30/20,4,0,2,0,3,9
2489,7/31/20,6,0,3,0,1,10
2490,8/1/20,6,0,3,0,5,14
2491,8/2/20,4,0,4,0,4,12
2492,8/3/20,4,0,1,0,5,10
2493,8/4/20,7,0,3,1,3,14
2494,8/5/20,6,0,1,0,6,13
2495,8/6/20,15,0,5,0,5,25
2496,8/7/20,6,0,3,0,4,13
2497,8/8/20,7,0,2,0,4,13
2498,8/9/20,0,0,0,0,2,2
2499,8/10/20,5,0,0,0,4,9
2500,8/11/20,22,0,4,0,8,34
2501,8/12/20,9,0,2,1,2,14
2502,8/13/20,8,0,3,0,1,12
2503,8/14/20,6,0,3,1,2,12
2504,8/15/20,3,0,0,0,1,4
2505,8/16/20,5,0,2,0,1,8
2506,8/17/20,8,0,4,0,2,14
2507,8/18/20,11,0,1,0,0,12
2508,8/19/20,5,0,4,0,8,17
2509,8/20/20,8,0,0,0,1,9
2510,8/21/20,3,0,3,0,1,7
2511,8/22/20,8,1,1,0,2,12
2512,8/23/20,1,0,1,0,2,4
2513,8/24/20,8,0,1,0,0,9
2514,8/25/20,7,0,6,0,8,21
2515,8/26/20,9,0,4,0,7,20
2516,8/27/20,3,0,3,0,3,9
2517,8/28/20,11,0,3,0,16,30
2518,8/29/20,5,0,2,0,4,11
2519,8/30/20,1,1,4,0,1,7
2520,8/31/20,7,2,3,0,0,12
2521,9/1/20,7,0,4,0,7,18
2522,9/2/20,8,0,0,0,0,8
2523,9/3/20,4,0,2,0,0,6
2524,9/4/20,3,0,5,0,0,8
2525,9/5/20,5,0,8,0,5,18
2526,9/6/20,2,0,2,0,0,4
2527,9/7/20,0,0,1,0,0,1
2528,9/8/20,14,0,3,0,6,23
2529,9/9/20,9,0,3,0,1,13
2530,9/10/20,7,1,3,0,3,14
2531,9/11/20,5,0,1,0,3,9
2532,9/12/20,16,0,2,0,2,20
2533,9/13/20,1,0,1,0,0,2
2534,9/14/20,16,0,13,0,10,39
2535,9/15/20,8,0,1,0,8,17
2536,9/16/20,7,0,2,0,0,9
2537,9/17/20,7,1,1,0,5,14
2538,9/18/20,8,0,5,0,1,14
2539,9/19/20,4,0,4,0,1,9
2540,9/20/20,2,0,4,0,2,8
2541,9/21/20,9,0,1,0,1,11
2542,9/22/20,16,0,6,1,6,29
2543,9/23/20,12,0,6,0,0,18
2544,9/24/20,9,1,2,0,1,13
2545,9/25/20,9,2,1,0,1,13
2546,9/26/20,17,1,5,0,1,24
2547,9/27/20,0,0,3,0,1,4
2548,9/28/20,12,0,3,0,2,17
2549,9/29/20,12,0,1,0,7,20
2550,9/30/20,3,1,2,0,5,11
2551,10/1/20,13,0,3,0,0,16
2552,10/2/20,2,0,6,0,0,8
2553,10/3/20,3,1,1,0,0,5
2554,10/4/20,0,0,3,0,5,8
2555,10/5/20,5,0,13,0,8,26
2556,10/6/20,13,0,3,0,8,24
2557,10/7/20,3,0,5,0,0,8
2558,10/8/20,11,0,1,0,2,14
2559,10/9/20,8,0,11,0,3,22
2560,10/10/20,9,0,1,0,1,11
2561,10/11/20,1,0,1,0,2,4
2562,10/12/20,2,0,0,0,2,4
2563,10/13/20,16,0,7,0,2,25
2564,10/14/20,5,2,3,0,1,11
2565,10/15/20,5,0,4,0,3,12
2566,10/16/20,12,0,0,0,2,14
2567,10/17/20,2,0,6,0,3,11
2568,10/18/20,1,0,2,0,0,3
2569,10/19/20,8,0,0,0,1,9
2570,10/20/20,15,0,1,0,10,26
2571,10/21/20,4,0,2,0,0,6
2572,10/22/20,8,1,2,0,1,12
2573,10/23/20,14,0,2,1,0,17
2574,10/24/20,5,0,1,0,0,6
2575,10/25/20,3,0,3,0,3,9
2576,10/26/20,6,0,3,0,1,10
2577,10/27/20,11,1,3,0,9,24
2578,10/28/20,6,0,4,0,7,17
2579,10/29/20,3,0,5,0,2,10
2580,10/30/20,7,0,5,0,3,15
2581,10/31/20,9,1,2,0,1,13
2582,11/1/20,1,0,1,0,1,3
2583,11/2/20,9,0,3,0,1,13
2584,11/3/20,5,0,3,0,8,16
2585,11/4/20,4,1,2,0,3,10
2586,11/5/20,4,0,3,1,2,10
2587,11/6/20,7,1,3,2,4,17
2588,11/7/20,6,0,2,0,1,9
2589,11/8/20,4,0,2,0,9,15
2590,11/9/20,6,0,6,1,0,13
2591,11/10/20,8,1,1,0,8,18
,11/11/20,,,,,,
2592,11/12/20,10,0,10,0,4,24
2593,11/13/20,7,0,3,0,18,28
2594,11/14/20,8,1,1,1,1,12
2595,11/15/20,4,1,3,0,2,10
2596,11/16/20,4,0,4,1,3,12
2597,11/17/20,6,1,1,0,6,14
2598,11/18/20,4,0,2,0,2,8
2599,11/19/20,3,1,5,0,2,11
2600,11/20/20,4,0,3,0,1,8
2601,11/21/20,10,0,2,1,4,17
2602,11/22/20,3,0,3,0,0,6
2603,11/23/20,10,0,5,1,1,17
2604,11/24/20,9,2,5,0,11,27
2605,11/25/20,5,0,7,0,1,13
2606,11/26/20,0,0,0,0,2,2
2607,11/27/20,0,0,1,0,0,1
2608,11/28/20,11,0,1,0,0,12
2609,11/29/20,4,1,1,0,3,9
2610,11/30/20,13,0,1,0,4,18
2611,12/1/20,9,0,4,0,7,20
2612,12/2/20,8,0,3,0,8,19
2613,12/3/20,12,1,3,0,14,30
2614,12/4/20,11,0,5,0,25,41
2615,12/5/20,10,0,2,0,1,13
2616,12/6/20,3,0,0,0,1,4
2617,12/7/20,10,1,6,0,4,21
2618,12/8/20,13,0,4,0,13,30
2619,12/9/20,10,1,5,0,2,18
2620,12/10/20,7,0,6,0,3,16
2621,12/11/20,7,0,3,1,4,15
2622,12/12/20,5,1,1,1,0,8
2623,12/13/20,2,1,2,0,3,8
2624,12/14/20,12,1,4,0,3,20
2625,12/15/20,14,0,5,1,0,20
2626,12/16/20,5,0,4,0,5,14
2627,12/17/20,5,0,3,0,9,17
2628,12/18/20,11,0,3,0,7,21
2629,12/19/20,12,0,6,0,0,18
2630,12/20/20,4,0,0,0,0,4
2631,12/21/20,11,0,3,0,7,21
2632,12/22/20,14,0,2,0,2,18
2633,12/23/20,5,0,1,0,3,9
,12/24/20,,,,,,
,12/25/20,,,,,,
2634,12/26/20,6,0,5,0,1,12
2635,12/27/20,2,0,1,0,0,3
2636,12/28/20,13,2,3,0,3,21
2637,12/29/20,4,0,3,0,5,12
2638,12/30/20,7,0,2,0,0,9
2639,12/31/20,8,0,2,0,3,13
,1/1/21,,,,,,
2640,1/2/21,5,0,9,0,8,22
2641,1/3/21,4,0,2,0,3,9
2642,1/4/21,2,0,1,0,1,4
2643,1/5/21,5,2,2,2,3,14
2644,1/6/21,14,0,5,0,1,20
2645,1/7/21,8,0,5,0,6,19
2646,1/8/21,7,1,4,0,3,15
2647,1/9/21,6,2,0,0,0,8
2648,1/10/21,2,0,0,0,1,3
2649,1/11/21,7,0,2,0,6,15
2650,1/12/21,4,0,1,1,5,11
2651,1/13/21,5,0,5,0,0,10
2652,1/14/21,7,0,3,0,1,11
2653,1/15/21,10,0,3,0,6,19
2654,1/16/21,4,1,2,0,2,9
2655,1/17/21,4,0,3,0,1,8
,1/18/21,,,,,,
2656,1/19/21,11,0,2,0,3,16
2657,1/20/21,7,0,0,0,3,10
2658,1/21/21,8,0,4,0,4,16
2659,1/22/21,7,0,2,0,4,13
2660,1/23/21,9,0,4,0,5,18
2661,1/24/21,0,0,1,1,0,2
2662,1/25/21,3,0,3,0,3,9
2663,1/26/21,7,0,6,0,3,16
2664,1/27/21,6,0,7,2,7,22
2665,1/28/21,5,0,4,0,9,18
2666,1/29/21,8,0,3,0,4,15
2667,1/30/21,14,1,3,0,3,21
2668,1/31/21,2,0,2,1,0,5
2669,2/1/21,7,0,6,0,0,13
2670,2/2/21,5,0,4,1,7,17
2671,2/3/21,8,0,3,0,2,13
2672,2/4/21,14,0,6,0,1,21
2673,2/5/21,9,0,2,0,2,13
2674,2/6/21,4,0,4,0,2,10
2675,2/7/21,5,1,1,0,2,9
2676,2/8/21,7,0,2,0,0,9
2677,2/9/21,10,0,5,0,8,23
2678,2/10/21,5,0,4,0,0,9
2679,2/11/21,5,0,3,0,3,11
2680,2/12/21,7,0,0,1,6,14
2681,2/13/21,12,0,0,1,0,13
2682,2/14/21,0,1,0,0,0,1
,2/15/21,,,,,,
,2/16/21,,,,,,
,2/17/21,,,,,,
2683,2/18/21,4,0,1,0,0,5
2684,2/19/21,1,0,2,0,0,3
2685,2/20/21,5,0,2,1,0,8
2686,2/21/21,8,0,0,0,0,8
2687,2/22/21,10,0,1,0,0,11
2688,2/23/21,7,0,4,0,7,18
2689,2/24/21,4,0,4,0,0,8
2690,2/25/21,4,0,0,0,6,10
2691,2/26/21,10,0,3,0,2,15
2692,2/27/21,8,0,1,0,4,13
2693,2/28/21,5,0,1,0,2,8
2694,3/1/21,7,0,3,0,0,10
2695,3/2/21,14,1,7,1,8,31
2696,3/3/21,10,0,1,1,0,12
2697,3/4/21,10,0,4,0,7,21
2698,3/5/21,2,0,1,0,4,7
2699,3/6/21,7,2,5,0,2,16
2700,3/7/21,2,0,1,0,0,3
2701,3/8/21,1,0,5,0,4,10
2702,3/9/21,7,0,2,0,6,15
2703,3/10/21,3,0,3,1,2,9
2704,3/11/21,3,1,1,1,1,7
2705,3/12/21,11,0,3,0,9,23
2706,3/13/21,30,0,0,0,1,31
2707,3/14/21,1,0,3,0,0,4
2708,3/15/21,9,0,2,0,4,15
2709,3/16/21,8,0,5,0,8,21
2710,3/17/21,4,0,4,0,0,8
2711,3/18/21,6,0,3,0,4,13
2712,3/19/21,7,0,3,0,2,12
2713,3/20/21,6,1,1,0,2,10
2714,3/21/21,3,0,0,0,3,6
2715,3/22/21,6,0,1,0,2,9
2716,3/23/21,13,0,5,0,3,21
2717,3/24/21,6,0,1,0,1,8
2718,3/25/21,2,1,2,0,4,9
2719,3/26/21,8,0,5,0,2,15
2720,3/27/21,3,0,2,0,10,15
2721,3/28/21,5,0,3,0,4,12
2722,3/29/21,14,0,5,0,2,21
2723,3/30/21,2,0,5,1,3,11
2724,3/31/21,9,1,2,0,2,14
2725,4/1/21,11,1,1,1,2,16
2726,4/2/21,9,0,7,0,3,19
2727,4/3/21,15,0,1,0,2,18
2728,4/4/21,5,0,0,0,5,10
2729,4/5/21,9,0,4,0,0,13
2730,4/6/21,6,0,1,0,6,13
2731,4/7/21,6,0,3,0,1,10
2732,4/8/21,9,0,1,0,4,14
2733,4/9/21,7,1,2,0,1,11
2734,4/10/21,5,0,1,0,1,7
2735,4/11/21,4,0,5,0,4,13
2736,4/12/21,4,0,4,0,3,11
2737,4/13/21,9,0,0,0,3,12
2738,4/14/21,8,0,2,0,1,11
2739,4/15/21,6,0,0,1,0,7
2740,4/16/21,8,0,4,0,11,23
2741,4/17/21,4,0,1,0,10,15
2742,4/18/21,5,1,1,0,2,9
2743,4/19/21,11,1,8,0,3,23
2744,4/20/21,8,1,7,0,4,20
2745,4/21/21,7,0,0,0,1,8
2746,4/22/21,5,0,7,2,0,14
2747,4/23/21,10,0,4,0,2,16
2748,4/24/21,2,0,2,0,4,8
2749,4/25/21,5,0,0,0,0,5
2750,4/26/21,11,1,4,0,3,19
2751,4/27/21,5,0,3,0,5,13
2752,4/28/21,8,0,3,0,0,11
2753,4/29/21,13,0,3,0,0,16
2754,4/30/21,11,0,4,0,13,28
2755,5/1/21,21,0,5,0,2,28
2756,5/2/21,3,0,1,0,3,7
2757,5/3/21,10,0,4,0,2,16
2758,5/4/21,9,0,5,0,4,18
2759,5/5/21,21,0,2,0,9,32
2760,5/6/21,15,0,1,0,3,19
2761,5/7/21,16,0,4,0,2,22
2762,5/8/21,19,0,3,0,0,22
2763,5/9/21,16,0,3,0,5,24
2764,5/10/21,4,0,7,0,3,14
2765,5/11/21,14,0,1,0,8,23
2766,5/12/21,7,0,1,0,0,8
2767,5/13/21,9,1,3,0,2,15
2768,5/14/21,9,1,2,0,4,16
2769,5/15/21,10,0,2,0,0,12
2770,5/16/21,5,0,6,0,2,13
2771,5/17/21,8,0,2,1,2,13
2772,5/18/21,15,0,3,0,7,25
2773,5/19/21,3,0,2,1,1,7
2774,5/20/21,8,1,6,0,7,22
2775,5/21/21,9,0,2,0,3,14
2776,5/22/21,7,0,2,0,2,11
2777,5/23/21,4,0,2,0,0,6
2778,5/24/21,5,0,3,0,3,11
2779,5/25/21,12,0,4,1,3,20
2780,5/26/21,11,0,2,0,0,13
2781,5/27/21,8,0,6,1,0,15
2782,5/28/21,9,0,2,0,4,15
2783,5/29/21,3,0,5,0,2,10
2784,5/30/21,5,0,1,0,0,6
2785,5/31/21,0,1,0,0,3,4
2786,6/1/21,10,1,5,0,7,23
2787,6/2/21,8,0,3,0,5,16
2788,6/3/21,14,0,4,0,2,20
2789,6/4/21,3,2,3,0,6,14
2790,6/5/21,18,0,2,0,2,22
2791,6/6/21,10,0,2,0,0,12
2792,6/7/21,17,0,4,0,4,25
2793,6/8/21,20,0,2,0,4,26
2794,6/9/21,9,1,4,0,4,18
2795,6/10/21,11,0,2,0,1,14
2796,6/11/21,7,0,3,0,2,12
2797,6/12/21,8,1,2,2,6,19
2798,6/13/21,8,0,1,0,0,9
2799,6/14/21,11,0,5,0,0,16
2800,6/15/21,11,0,6,1,4,22
2801,6/16/21,14,0,3,2,3,22
2802,6/17/21,18,1,3,1,5,28
2803,6/18/21,0,1,0,0,1,2
2804,6/19/21,9,0,6,1,0,16
2805,6/20/21,4,4,1,0,3,12
2806,6/21/21,17,0,3,0,19,39
2807,6/22/21,14,0,5,1,1,21
2808,6/23/21,13,0,4,1,2,20
2809,6/24/21,8,0,3,0,2,13
2810,6/25/21,18,0,1,0,11,30
2811,6/26/21,18,1,3,1,4,27
2812,6/27/21,2,0,1,0,2,5
2813,6/28/21,22,2,2,0,10,36
2814,6/29/21,15,0,4,1,4,24
2815,6/30/21,21,1,0,1,7,30
2816,7/1/21,20,0,2,0,1,23
2817,7/2/21,10,1,2,0,14,27
2818,7/3/21,11,0,3,0,1,15
2819,7/4/21,7,0,4,0,0,11
2820,7/5/21,0,0,0,0,2,2
2821,7/6/21,26,0,13,0,4,43
2822,7/7/21,13,0,5,0,6,24
2823,7/8/21,7,1,7,0,3,18
2824,7/9/21,4,0,3,0,1,8
2825,7/10/21,15,0,4,0,11,30
2826,7/11/21,9,0,1,0,1,11
2827,7/12/21,14,1,2,0,5,22
2828,7/13/21,7,0,6,0,2,15
2829,7/14/21,14,1,7,0,7,29
2830,7/15/21,25,1,2,0,0,28
2831,7/16/21,16,0,0,0,4,20
2832,7/17/21,11,1,2,0,2,16
2833,7/18/21,7,0,4,1,0,12
2834,7/19/21,21,0,5,0,1,27
2835,7/20/21,21,0,4,0,7,32
2836,7/21/21,11,1,3,0,2,17
2837,7/22/21,9,0,5,0,1,15
2838,7/23/21,12,2,1,0,0,15
2839,7/24/21,8,0,7,0,4,19
2840,7/25/21,26,1,3,0,7,37
2841,7/26/21,15,0,5,1,8,29
2842,7/27/21,18,1,2,1,3,25
2843,7/28/21,6,0,0,0,0,6
2844,7/29/21,11,0,4,0,4,19
2845,7/30/21,11,0,4,0,10,25
2846,7/31/21,12,0,0,0,0,12
2847,8/1/21,5,0,1,0,0,6
2848,8/2/21,18,1,11,0,3,33
2849,8/3/21,17,0,3,0,6,26
2850,8/4/21,14,0,3,0,0,17
2851,8/5/21,8,0,7,0,2,17
2852,8/6/21,22,0,5,0,15,42
2853,8/7/21,4,0,1,1,1,7
2854,8/8/21,3,1,3,0,1,8
2855,8/9/21,7,0,5,0,1,13
2856,8/10/21,14,0,2,0,4,20
2857,8/11/21,12,1,2,0,4,19
2858,8/12/21,8,0,4,0,1,13
2859,8/13/21,12,0,1,0,0,13
2860,8/14/21,16,0,2,0,11,29
2861,8/15/21,8,0,1,0,1,10
2862,8/16/21,14,0,4,0,0,18
2863,8/17/21,14,0,6,0,3,23
2864,8/18/21,18,0,0,0,2,20
2865,8/19/21,15,0,4,0,3,22
2866,8/20/21,12,0,6,0,3,21
2867,8/21/21,10,0,4,0,1,15
2868,8/22/21,20,0,0,1,3,24
2869,8/23/21,21,0,4,0,1,26
2870,8/24/21,8,2,6,0,7,23
2871,8/25/21,10,0,3,0,0,13
2872,8/26/21,12,0,6,2,5,25
2873,8/27/21,14,0,2,0,7,23
2874,8/28/21,11,0,4,0,9,24
2875,8/29/21,6,0,2,0,1,9
2876,8/30/21,15,0,4,2,1,22
2877,8/31/21,8,0,1,0,8,17
2878,9/1/21,12,0,1,0,2,15
2879,9/2/21,11,0,3,0,0,14
2880,9/3/21,6,0,6,0,8,20
2881,9/4/21,13,0,0,0,3,16
2882,9/5/21,11,1,1,1,9,23
,9/6/21,,,,,,
2883,9/7/21,15,0,3,0,5,23
2884,9/8/21,15,0,3,0,1,19
2885,9/9/21,9,1,3,0,15,28
2886,9/10/21,9,0,1,0,1,11
2887,9/11/21,21,0,2,0,0,23
2888,9/12/21,8,0,3,0,0,11
2889,9/13/21,22,0,6,0,6,34
2890,9/14/21,13,0,2,0,4,19
2891,9/15/21,11,0,3,0,0,14
2892,9/16/21,14,1,5,0,10,30
2893,9/17/21,10,0,3,0,6,19
2894,9/18/21,33,0,1,0,1,35
2895,9/19/21,9,0,4,0,2,15
2896,9/20/21,22,0,2,0,3,27
2897,9/21/21,17,0,5,0,1,23
2898,9/22/21,8,0,7,0,6,21
2899,9/23/21,21,0,0,1,1,23
2900,9/24/21,13,2,8,0,2,25
2901,9/25/21,9,0,3,0,4,16
2902,9/26/21,7,0,4,0,1,12
2903,9/27/21,18,0,8,0,4,30
2904,9/28/21,8,2,1,0,30,41
2905,9/29/21,16,1,3,0,6,26
2906,9/30/21,9,0,3,0,1,13
2907,10/1/21,13,0,1,0,3,17
2908,10/2/21,9,1,2,0,0,12
2909,10/3/21,8,0,3,0,1,12
2910,10/4/21,18,1,11,0,2,32
2911,10/5/21,20,0,3,0,0,23
2912,10/6/21,8,0,4,1,1,14
2913,10/7/21,7,0,2,1,5,15
2914,10/8/21,11,0,2,0,26,39
2915,10/9/21,15,0,2,0,1,18
2916,10/10/21,5,0,4,0,1,10
2917,10/11/21,11,0,4,0,9,24
2918,10/12/21,15,0,3,1,1,20
2919,10/13/21,11,0,4,0,3,18
2920,10/14/21,7,0,2,0,5,14
2921,10/15/21,7,0,5,0,6,18
2922,10/16/21,3,0,6,0,0,9
2923,10/17/21,4,1,2,0,1,8
2924,10/18/21,19,0,8,0,5,32
2925,10/19/21,17,0,4,0,1,22
2926,10/20/21,15,0,5,0,0,20
2927,10/21/21,5,0,5,2,2,14
2928,10/22/21,3,0,6,0,26,35
2929,10/23/21,12,0,3,0,1,16
2930,10/24/21,7,0,0,0,3,10
2931,10/25/21,14,0,6,0,5,25
2932,10/26/21,21,0,4,2,0,27
2933,10/27/21,9,0,2,1,0,12
2934,10/28/21,3,1,6,0,5,15
2935,10/29/21,9,0,2,0,1,12
2936,10/30/21,6,0,5,0,2,13
2937,10/31/21,2,0,4,1,1,8
2938,11/1/21,18,0,8,0,19,45
2939,11/2/21,5,0,3,0,3,11
2940,11/3/21,6,0,1,0,1,8
2941,11/4/21,8,0,6,0,3,17
2942,11/5/21,9,0,4,0,29,42
2943,11/6/21,7,0,4,0,1,12
2944,11/7/21,14,0,2,0,1,17
2945,11/8/21,16,1,3,0,0,20
2946,11/9/21,7,0,6,0,2,15
2947,11/10/21,8,0,5,1,5,19
2948,11/11/21,1,0,0,0,0,1
2949,11/12/21,9,0,5,0,8,22
2950,11/13/21,15,0,3,2,24,44
2951,11/14/21,9,0,5,0,0,14
2952,11/15/21,14,1,3,0,12,30
2953,11/16/21,8,0,1,0,4,13
2954,11/17/21,9,1,3,0,1,14
2955,11/18/21,9,0,3,0,0,12
2956,11/19/21,11,0,3,0,23,37
2957,11/20/21,13,1,3,0,1,18
2958,11/21/21,8,1,0,1,2,12
2959,11/22/21,10,0,3,0,1,14
2960,11/23/21,13,0,3,0,0,16
2961,11/24/21,12,1,7,0,4,24
,11/25/21,,,,,,
2962,11/26/21,0,0,2,0,1,3
2963,11/27/21,17,0,11,0,2,30
2964,11/28/21,6,0,1,0,3,10
2965,11/29/21,19,0,5,0,8,32
2966,11/30/21,7,0,5,0,3,15
2967,12/1/21,16,0,6,0,6,28
2968,12/2/21,8,0,5,0,2,15
2969,12/3/21,7,0,6,1,1,15
2970,12/4/21,12,0,4,0,2,18
2971,12/5/21,11,0,3,0,1,15
2972,12/6/21,10,0,12,0,6,28
2973,12/7/21,11,0,1,0,2,14
2974,12/8/21,12,0,2,0,3,17
2975,12/9/21,10,0,0,0,4,14
2976,12/10/21,6,0,9,0,25,40
2977,12/11/21,13,0,9,0,5,27
2978,12/12/21,3,0,3,0,1,7
2979,12/13/21,12,0,2,0,3,17
2980,12/14/21,12,1,3,0,0,16
2981,12/15/21,10,0,4,0,2,16
2982,12/16/21,5,1,2,0,17,25
2983,12/17/21,9,0,2,1,4,16
2984,12/18/21,8,1,3,0,1,13
2985,12/19/21,19,0,3,0,3,25
2986,12/20/21,24,1,5,0,8,38
2987,12/21/21,18,1,11,0,2,32
2988,12/22/21,18,0,1,0,9,28
2989,12/23/21,18,0,3,0,4,25
2990,12/24/21,0,0,0,0,1,1
,12/25/21,,,,,,
2991,12/26/21,6,1,3,0,3,13
2992,12/27/21,10,1,6,0,4,21
2993,12/28/21,10,0,3,0,0,13
2994,12/29/21,18,3,10,0,5,36
2995,12/30/21,7,0,4,1,6,18
2996,12/31/21,13,0,6,0,6,25
2997,1/1/22,0,0,0,0,4,4
2998,1/2/22,7,0,4,1,2,14
2999,1/3/22,21,0,6,0,3,30
3000,1/4/22,15,0,1,1,3,20
3001,1/5/22,8,1,4,2,4,19
3002,1/6/22,15,2,1,0,5,23
3003,1/7/22,14,0,12,0,35,61
3004,1/8/22,15,0,1,0,2,18
3005,1/9/22,7,1,2,0,0,10
3006,1/10/22,5,0,5,0,1,11
3007,1/11/22,12,1,2,0,2,17
3008,1/12/22,18,0,4,0,8,30
3009,1/13/22,10,1,1,0,7,19
3010,1/14/22,22,0,4,0,5,31
3011,1/15/22,6,0,2,0,8,16
3012,1/16/22,10,0,3,0,2,15
3013,1/17/22,0,1,0,0,2,3
3014,1/18/22,30,0,7,0,3,40
3015,1/19/22,10,0,3,0,9,22
3016,1/20/22,11,0,2,0,3,16
3017,1/21/22,16,0,4,0,2,22
3018,1/22/22,8,0,6,0,0,14
3019,1/23/22,0,0,0,0,2,2
3020,1/24/22,17,0,6,0,8,31
3021,1/25/22,16,0,3,0,2,21
3022,1/26/22,13,1,5,0,11,30
3023,1/27/22,10,0,4,0,1,15
3024,1/28/22,2,0,1,0,2,5
3025,1/29/22,15,0,3,0,4,22
3026,1/30/22,0,0,1,0,0,1
3027,1/31/22,9,0,3,0,6,18
3028,2/1/22,6,0,5,0,2,13
3029,2/2/22,18,0,4,0,27,49
3030,2/3/22,1,0,0,1,2,4
,2/4/22,,,,,,
3031,2/5/22,13,1,8,0,0,22
3032,2/6/22,0,0,1,0,0,1
3033,2/7/22,8,0,6,0,4,18
3034,2/8/22,17,1,4,0,2,24
3035,2/9/22,7,4,1,0,12,24
3036,2/10/22,16,0,6,0,37,59
3037,2/11/22,17,0,5,0,2,24
3038,2/12/22,29,0,4,0,2,35
3039,2/13/22,0,0,0,0,3,3
3040,2/14/22,16,1,2,0,0,19
3041,2/15/22,18,0,9,0,3,30
3042,2/16/22,9,0,0,0,4,13
3043,2/17/22,5,0,8,1,2,16
3044,2/18/22,9,0,8,0,4,21
3045,2/19/22,13,0,0,0,0,13
,2/20/22,,,,,,
,2/21/22,,,,,,
3046,2/22/22,14,0,11,0,9,34
3047,2/23/22,4,1,12,0,4,21
3048,2/24/22,6,1,9,0,1,17
3049,2/25/22,8,0,3,0,26,37
3050,2/26/22,12,0,2,0,2,16
3051,2/27/22,0,0,0,0,1,1
3052,2/28/22,18,0,3,0,1,22
3053,3/1/22,12,0,1,0,6,19
3054,3/2/22,8,0,2,0,10,20
3055,3/3/22,12,1,6,0,3,22
3056,3/4/22,7,0,5,0,1,13
3057,3/5/22,13,0,4,1,2,20
3058,3/6/22,0,0,1,0,1,2
3059,3/7/22,14,0,7,1,2,24
3060,3/8/22,10,0,4,0,4,18
3061,3/9/22,10,0,4,0,5,19
3062,3/10/22,7,0,3,0,0,10
3063,3/11/22,6,0,7,0,11,24
3064,3/12/22,21,0,3,0,3,27
3065,3/13/22,1,0,0,0,1,2
3066,3/14/22,18,1,7,0,24,50
3067,3/15/22,11,0,9,0,1,21
3068,3/16/22,10,0,4,1,1,16
3069,3/17/22,7,0,5,0,0,12
3070,3/18/22,11,0,1,0,5,17
3071,3/19/22,6,0,2,0,16,24
,3/20/22,,,,,,
3072,3/21/22,4,0,5,0,0,9
3073,3/22/22,10,1,2,0,1,14
3074,3/23/22,9,0,1,0,15,25
3075,3/24/22,10,1,4,0,0,15
3076,3/25/22,13,1,2,0,5,21
3077,3/26/22,15,1,1,0,1,18
3078,3/27/22,0,0,1,0,0,1
3079,3/28/22,10,0,6,0,8,24
3080,3/29/22,8,0,5,1,1,15
3081,3/30/22,8,0,6,0,7,21
3082,3/31/22,12,1,3,0,0,16
3083,4/1/22,11,0,2,0,2,15
3084,4/2/22,19,0,7,0,0,26
3085,4/3/22,0,1,0,0,0,1
3086,4/4/22,9,0,7,0,1,17
3087,4/5/22,9,0,0,0,7,16
3088,4/6/22,10,0,9,0,35,54
3089,4/7/22,6,0,3,0,6,15
3090,4/8/22,9,0,3,0,5,17
3091,4/9/22,21,0,4,0,3,28
3092,4/10/22,0,0,0,0,7,7
3093,4/11/22,8,1,8,0,1,18
3094,4/12/22,15,0,3,0,8,26
3095,4/13/22,15,0,8,0,5,28
3096,4/14/22,8,0,0,0,4,12
3097,4/15/22,10,0,7,0,3,20
3098,4/16/22,12,0,2,0,3,17
3099,4/17/22,0,0,2,0,12,14
3100,4/18/22,12,0,7,0,1,20
3101,4/19/22,10,1,4,0,15,30
3102,4/20/22,8,0,2,0,1,11
3103,4/21/22,10,0,5,0,12,27
3104,4/22/22,8,0,9,0,6,23
3105,4/23/22,13,0,3,1,0,17
,4/24/22,,,,,,
3106,4/25/22,6,0,2,0,1,9
3107,4/26/22,12,0,2,0,9,23
3108,4/27/22,9,2,4,0,21,36
3109,4/28/22,8,1,0,0,2,11
3110,4/29/22,6,0,5,0,30,41
3111,4/30/22,17,0,1,0,6,24
3112,5/1/22,0,1,0,0,4,5
3113,5/2/22,7,2,2,0,6,17
3114,5/3/22,16,0,4,0,5,25
3115,5/4/22,2,0,2,0,0,4
3116,5/5/22,4,1,4,0,0,9
3117,5/6/22,9,0,3,0,13,25
3118,5/7/22,11,0,4,0,1,16
,5/8/22,,,,,,
3119,5/9/22,9,0,3,0,23,35
3120,5/10/22,10,0,6,0,4,20
3121,5/11/22,7,1,3,0,2,13
3122,5/12/22,5,0,13,1,10,29
3123,5/13/22,8,1,4,0,1,14
3124,5/14/22,10,0,1,0,1,12
,5/15/22,,,,,,
3125,5/16/22,8,1,4,0,11,24
3126,5/17/22,5,1,4,0,0,10
3127,5/18/22,8,0,4,0,1,13
3128,5/19/22,5,0,3,0,2,10
3129,5/20/22,12,1,4,0,30,47
3130,5/21/22,7,0,2,0,0,9
3131,5/22/22,0,0,1,0,0,1
3132,5/23/22,16,3,3,0,4,26
3133,5/24/22,12,0,1,0,27,40
3134,5/25/22,6,0,7,0,10,23
3135,5/26/22,12,0,6,0,6,24
3136,5/27/22,9,1,4,0,8,22
3137,5/28/22,11,0,1,0,1,13
3138,5/29/22,0,0,1,0,0,1
3139,5/30/22,0,0,1,0,0,1
3140,5/31/22,20,1,5,0,5,31
3141,6/1/22,7,0,6,0,10,23
3142,6/2/22,4,0,2,0,5,11
3143,6/3/22,15,0,6,0,7,28
3144,6/4/22,9,1,3,0,24,37
3145,6/5/22,0,1,2,0,0,3
3146,6/6/22,11,0,2,0,0,13
3147,6/7/22,9,0,2,0,8,19
3148,6/8/22,6,0,1,0,43,50
3149,6/9/22,2,0,2,1,0,5
3150,6/10/22,6,6,1,0,0,13
3151,6/11/22,11,1,0,0,1,13
3152,6/12/22,0,0,0,0,2,2
3153,6/13/22,7,0,1,0,5,13
3154,6/14/22,10,0,3,0,1,14
3155,6/15/22,2,0,4,0,3,9
3156,6/16/22,6,0,3,0,11,20
3157,6/17/22,9,0,4,0,4,17
3158,6/18/22,9,0,0,0,1,10
3159,6/19/22,5,1,0,0,0,6
3160,6/20/22,16,1,3,2,3,25
3161,6/21/22,10,1,5,0,5,21
3162,6/22/22,6,0,4,0,0,10
3163,6/23/22,18,1,4,0,22,45
3164,6/24/22,14,0,2,0,30,46
3165,6/25/22,8,0,0,0,7,15
3166,6/26/22,0,0,0,0,1,1
3167,6/27/22,15,0,2,0,3,20
3168,6/28/22,9,0,5,0,20,34
3169,6/29/22,6,0,1,0,5,12
3170,6/30/22,13,0,3,0,0,16
3171,7/1/22,15,0,1,0,2,18
3172,7/2/22,6,0,1,1,1,9
3173,7/3/22,0,0,4,0,0,4
3174,7/4/22,0,0,0,0,2,2
3175,7/5/22,13,0,2,0,5,20
3176,7/6/22,13,0,1,0,1,15
3177,7/7/22,12,0,4,0,9,25
3178,7/8/22,8,0,1,1,3,13
3179,7/9/22,12,0,4,0,0,16
3180,7/10/22,1,0,1,1,0,3
3181,7/11/22,13,0,2,0,1,16
3182,7/12/22,14,1,6,6,2,29
3183,7/13/22,9,0,2,0,5,16
3184,7/14/22,15,1,5,0,10,31
3185,7/15/22,14,0,10,0,2,26
3186,7/16/22,6,0,4,0,3,13
3187,7/17/22,21,0,2,2,0,25
3188,7/18/22,14,1,4,1,2,22
3189,7/19/22,7,0,1,0,11,19
3190,7/20/22,7,0,3,1,33,44
3191,7/21/22,7,0,1,0,6,14
3192,7/22/22,12,0,2,0,3,17
3193,7/23/22,13,0,2,2,11,28
3194,7/24/22,5,0,0,0,0,5
3195,7/25/22,21,1,4,3,2,31
3196,7/26/22,7,0,2,0,41,50
3197,7/27/22,13,0,1,0,3,17
3198,7/28/22,8,1,8,0,0,17
3199,7/29/22,20,2,1,0,3,26
3200,7/30/22,8,0,4,0,0,12
,7/31/22,,,,,,
3201,8/1/22,18,0,2,0,2,22
3202,8/2/22,13,1,1,0,0,15
3203,8/3/22,6,0,3,0,10,19
3204,8/4/22,11,0,6,0,2,19
3205,8/5/22,13,0,2,1,16,32
3206,8/6/22,6,0,4,0,2,12
3207,8/7/22,1,0,0,0,0,1
3208,8/8/22,18,2,8,0,2,30
3209,8/9/22,18,0,0,0,1,19
3210,8/10/22,17,0,3,0,8,28
3211,8/11/22,9,0,3,0,6,18
3212,8/12/22,11,0,5,0,30,46
3213,8/13/22,11,1,5,0,2,19
3214,8/14/22,0,1,0,0,0,1
3215,8/15/22,14,0,2,0,2,18
3216,8/16/22,11,0,4,0,2,17
3217,8/17/22,11,0,4,0,4,19
3218,8/18/22,11,0,7,0,8,26
3219,8/19/22,13,0,2,0,0,15
3220,8/20/22,15,1,3,0,1,20
3221,8/21/22,0,0,1,0,0,1
3222,8/22/22,17,2,2,0,5,26
3223,8/23/22,7,0,3,0,1,11
3224,8/24/22,14,1,5,0,17,37
3225,8/25/22,10,0,2,0,14,26
3226,8/26/22,12,1,5,0,3,21
3227,8/27/22,32,0,0,1,0,33
3228,8/28/22,0,0,1,0,0,1
3229,8/29/22,19,0,3,0,0,22
3230,8/30/22,23,1,2,0,1,27
3231,8/31/22,18,0,0,1,21,40
3232,9/1/22,11,1,6,0,5,23
3233,9/2/22,12,0,2,0,1,15
3234,9/3/22,12,0,4,0,1,17
,9/4/22,,,,,,
3235,9/5/22,0,0,1,0,3,4
3236,9/6/22,13,0,4,0,1,18
3237,9/7/22,8,2,4,0,5,19
3238,9/8/22,9,0,6,0,1,16
3239,9/9/22,14,2,4,0,17,37
3240,9/10/22,10,0,5,0,1,16
3241,9/11/22,0,0,1,0,0,1
3242,9/12/22,22,0,2,0,0,24
3243,9/13/22,22,0,3,0,2,27
3244,9/14/22,14,0,4,0,7,25
3245,9/15/22,21,1,0,1,2,25
3246,9/16/22,10,0,4,0,19,33
3247,9/17/22,17,0,2,0,1,20
,9/18/22,,,,,,
3248,9/19/22,33,0,4,0,1,38
3249,9/20/22,13,0,4,0,0,17
3250,9/21/22,10,0,5,0,6,21
3251,9/22/22,12,0,2,0,8,22
3252,9/23/22,13,0,3,0,11,27
3253,9/24/22,5,0,0,0,0,5
3254,9/25/22,7,0,2,0,1,10
3255,9/26/22,20,0,2,0,2,24
3256,9/27/22,14,0,2,0,0,16
3257,9/28/22,11,0,1,0,3,15
3258,9/29/22,14,0,1,1,2,18
3259,9/30/22,8,0,5,0,16,29
3260,10/1/22,7,0,0,0,2,9
3261,10/2/22,2,0,1,0,0,3
3262,10/3/22,11,0,3,0,1,15
3263,10/4/22,7,0,1,0,0,8
3264,10/5/22,11,0,1,0,3,15
3265,10/6/22,8,0,8,1,1,18
3266,10/7/22,8,0,4,1,2,15
3267,10/8/22,6,0,1,0,3,10
3268,10/9/22,12,0,3,0,3,18
3269,10/10/22,11,0,0,1,30,42
3270,10/11/22,10,1,4,0,1,16
3271,10/12/22,1,0,5,0,1,7
3272,10/13/22,4,0,3,0,7,14
3273,10/14/22,8,0,4,0,3,15
3274,10/15/22,3,0,1,0,2,6
3275,10/16/22,2,1,1,0,4,8
3276,10/17/22,9,0,2,0,0,11
3277,10/18/22,10,0,0,0,1,11
3278,10/19/22,7,0,5,0,5,17
3279,10/20/22,4,0,0,0,6,10
3280,10/21/22,9,1,0,0,15,25
3281,10/22/22,7,0,1,0,0,8
3282,10/23/22,1,0,5,0,0,6
3283,10/24/22,10,0,2,0,6,18
3284,10/25/22,11,0,5,0,6,22
3285,10/26/22,4,0,10,0,18,32
3286,10/27/22,3,0,1,0,2,6
3287,10/28/22,10,0,5,1,6,22
3288,10/29/22,3,0,4,2,2,11
3289,10/30/22,2,0,3,0,2,7
3290,10/31/22,8,0,1,0,7,16
3291,11/1/22,10,1,3,0,1,15
3292,11/2/22,7,0,4,0,0,11
3293,11/3/22,2,0,2,0,2,6
3294,11/4/22,6,1,2,0,35,44
3295,11/5/22,9,0,3,0,3,15
3296,11/6/22,6,0,2,0,8,16
3297,11/7/22,13,0,1,0,0,14
3298,11/8/22,4,0,4,0,3,11
3299,11/9/22,8,0,2,0,1,11
3300,11/10/22,4,1,3,0,1,9
3301,11/11/22,0,0,0,0,1,1
3302,11/12/22,11,0,2,0,2,15
3303,11/13/22,3,0,0,0,2,5
3304,11/14/22,10,0,2,0,2,14
3305,11/15/22,11,0,2,0,4,17
3306,11/16/22,8,0,1,0,8,17
3307,11/17/22,10,0,6,0,3,19
3308,11/18/22,8,0,4,0,3,15
3309,11/19/22,7,0,2,0,4,13
3310,11/20/22,5,0,1,0,1,7
3311,11/21/22,8,0,0,0,6,14
3312,11/22/22,8,0,6,0,1,15
3313,11/23/22,11,0,1,0,1,13
,11/24/22,,,,,,
3314,11/25/22,14,0,2,0,3,19
3315,11/26/22,9,0,0,0,5,14
3316,11/27/22,5,0,0,0,0,5
3317,11/28/22,8,0,4,0,5,17
3318,11/29/22,13,1,0,1,2,17
3319,11/30/22,7,0,3,0,3,13
3320,12/1/22,8,0,2,0,1,11
3321,12/2/22,7,1,2,0,3,13
3322,12/3/22,7,0,4,0,1,12
3323,12/4/22,6,0,2,0,2,10
3324,12/5/22,12,0,1,0,3,16
3325,12/6/22,12,2,1,0,1,16
3326,12/7/22,7,0,2,1,2,12
3327,12/8/22,1,0,0,1,0,2
3328,12/9/22,6,0,1,0,1,8
3329,12/10/22,6,0,12,2,4,24
3330,12/11/22,5,0,2,0,0,7
3331,12/12/22,9,0,5,0,2,16
3332,12/13/22,16,1,3,0,4,24
3333,12/14/22,5,0,2,0,2,9
3334,12/15/22,9,0,6,0,3,18
3335,12/16/22,11,1,2,0,3,17
3336,12/17/22,15,0,2,0,2,19
3337,12/18/22,11,0,3,0,0,14
3338,12/19/22,12,0,2,0,2,16
3339,12/20/22,17,1,0,0,4,22
3340,12/21/22,13,1,1,0,2,17
3341,12/22/22,12,0,4,0,9,25
3342,12/23/22,4,0,5,0,1,10
,12/24/22,,,,,,
3343,12/25/22,0,0,0,0,1,1
3344,12/26/22,0,0,0,0,1,1
3345,12/27/22,15,0,1,0,2,18
3346,12/28/22,19,1,3,0,0,23
3347,12/29/22,15,0,2,0,2,19
3348,12/30/22,14,0,1,0,3,18
3349,12/31/22,12,1,1,0,3,17
3350,1/1/23,0,0,2,0,0,2
3351,1/2/23,1,0,0,0,0,1
3352,1/3/23,17,0,3,0,3,23
3353,1/4/23,12,0,2,0,3,17
3354,1/5/23,15,0,3,0,4,22
3355,1/6/23,11,0,5,0,1,17
3356,1/7/23,14,0,0,1,3,18
3357,1/8/23,5,0,3,0,2,10
3358,1/9/23,8,0,5,0,6,19
3359,1/10/23,14,0,1,0,2,17
3360,1/11/23,11,0,2,0,6,19
3361,1/12/23,5,0,1,0,2,8
3362,1/13/23,10,0,7,0,5,22
3363,1/14/23,9,0,1,1,2,13
3364,1/15/23,20,0,0,0,4,24
3365,1/16/23,0,0,0,0,1,1
3366,1/17/23,17,0,2,0,4,23
3367,1/18/23,14,1,2,0,2,19
3368,1/19/23,18,0,11,0,17,46
3369,1/20/23,8,0,1,0,11,20
3370,1/21/23,16,0,1,0,0,17
3371,1/22/23,5,0,2,0,0,7
3372,1/23/23,7,0,0,0,3,10
3373,1/24/23,9,1,2,0,3,15
3374,1/25/23,4,0,0,0,8,12
3375,1/26/23,6,0,1,0,1,8
3376,1/27/23,7,1,3,0,5,16
3377,1/28/23,9,0,3,0,4,16
3378,1/29/23,8,0,1,0,0,9
3379,1/30/23,10,0,0,1,5,16
3380,1/31/23,3,0,2,0,0,5
,2/1/23,,,,,,
,2/2/23,,,,,,
3381,2/3/23,13,0,4,0,4,21
3382,2/4/23,12,0,4,0,0,16
3383,2/5/23,7,0,4,0,2,13
3384,2/6/23,15,0,1,0,9,25
3385,2/7/23,16,0,8,0,2,26
3386,2/8/23,10,1,0,0,2,13
3387,2/9/23,8,0,2,0,2,12
3388,2/10/23,9,0,0,1,10,20
3389,2/11/23,30,0,1,0,0,31
3390,2/12/23,6,0,0,0,6,12
3391,2/13/23,12,0,0,0,9,21
3392,2/14/23,15,1,1,0,1,18
3393,2/15/23,9,1,2,0,1,13
3394,2/16/23,14,0,6,0,8,28
3395,2/17/23,13,0,3,0,0,16
3396,2/18/23,8,0,1,0,1,10
3397,2/19/23,13,0,0,0,2,15
3398,2/20/23,0,0,1,0,0,1
3399,2/21/23,12,1,2,0,15,30
3400,2/22/23,10,0,0,0,1,11
3401,2/23/23,3,1,1,1,1,7
3402,2/24/23,7,1,2,0,5,15
3403,2/25/23,10,0,2,0,1,13
3404,2/26/23,9,1,4,0,0,14
3405,2/27/23,18,0,1,0,11,30
3406,2/28/23,11,0,1,0,0,12
3407,3/1/23,10,0,2,1,3,16
3408,3/2/23,12,0,2,0,0,14
3409,3/3/23,8,0,4,0,7,19
3410,3/4/23,23,1,1,0,2,27
3411,3/5/23,8,0,1,0,5,14
3412,3/6/23,9,1,0,0,2,12
3413,3/7/23,11,0,5,0,1,17
3414,3/8/23,13,0,4,0,2,19
3415,3/9/23,10,0,4,0,2,16
3416,3/10/23,12,0,6,0,7,25
3417,3/11/23,13,0,0,0,0,13
3418,3/12/23,15,0,2,0,1,18
3419,3/13/23,14,0,2,0,2,18
3420,3/14/23,14,0,5,0,1,20
3421,3/15/23,19,1,2,0,8,30
3422,3/16/23,12,0,3,0,3,18
3423,3/17/23,13,0,3,2,6,24
3424,3/18/23,11,0,2,2,3,18
3425,3/19/23,5,0,2,0,2,9
3426,3/20/23,11,0,3,0,2,16
3427,3/21/23,7,0,4,0,1,12
3428,3/22/23,7,0,2,1,5,15
3429,3/23/23,9,0,6,0,3,18
3430,3/24/23,1,0,3,0,3,7
3431,3/25/23,13,0,4,0,4,21
3432,3/26/23,6,0,1,0,7,14
3433,3/27/23,17,0,1,0,2,20
3434,3/28/23,11,0,0,0,3,14
3435,3/29/23,5,1,10,0,4,20
3436,3/30/23,8,0,1,0,9,18
3437,3/31/23,7,0,3,0,2,12
3438,4/1/23,16,0,1,1,4,22
3439,4/2/23,14,0,1,0,1,16
3440,4/3/23,11,0,1,0,1,13
3441,4/4/23,10,0,0,0,1,11
3442,4/5/23,10,0,1,0,2,13
3443,4/6/23,5,1,3,0,7,16
3444,4/7/23,10,0,1,0,5,16
3445,4/8/23,11,0,5,3,4,23
3446,4/9/23,3,1,1,0,6,11
3447,4/10/23,14,1,2,0,4,21
3448,4/11/23,4,0,0,1,3,8
3449,4/12/23,5,3,4,0,8,20
3450,4/13/23,4,0,7,0,4,15
3451,4/14/23,12,0,8,0,5,25
3452,4/15/23,14,0,2,0,6,22
3453,4/16/23,9,1,4,0,0,14
3454,4/17/23,13,0,2,0,1,16
3455,4/18/23,9,0,3,1,2,15
3456,4/19/23,3,0,0,0,0,3
3457,4/20/23,3,0,3,1,2,9
3458,4/21/23,7,0,8,0,3,18
3459,4/22/23,18,0,1,0,1,20
3460,4/23/23,8,0,1,1,1,11
3461,4/24/23,11,0,1,0,2,14
3462,4/25/23,8,0,2,2,3,15
3463,4/26/23,9,0,1,0,5,15
3464,4/27/23,7,0,2,0,4,13
3465,4/28/23,4,0,3,1,5,13
3466,4/29/23,9,1,4,0,4,18
3467,4/30/23,4,1,5,0,2,12
3468,5/1/23,14,0,6,2,2,24
3469,5/2/23,8,0,2,1,0,11
3470,5/3/23,5,0,2,0,1,8
3471,5/4/23,5,1,3,1,2,12
3472,5/5/23,8,0,1,0,6,15
3473,5/6/23,9,0,1,0,3,13
3474,5/7/23,11,0,1,0,8,20
3475,5/8/23,18,0,2,0,8,28
3476,5/9/23,7,0,5,0,2,14
3477,5/10/23,5,1,4,0,1,11
3478,5/11/23,9,0,7,0,7,23
3479,5/12/23,11,0,6,0,14,31
3480,5/13/23,10,0,2,0,1,13
3481,5/14/23,14,1,1,0,1,17
3482,5/15/23,10,0,2,0,5,17
3483,5/16/23,7,0,3,0,9,19
3484,5/17/23,10,2,1,0,4,17
3485,5/18/23,3,0,2,0,18,23
3486,5/19/23,1,0,2,0,1,4
3487,5/20/23,4,0,1,0,3,8
3488,5/21/23,6,0,3,0,6,15
3489,5/22/23,16,0,3,1,0,20
3490,5/23/23,15,1,3,0,2,21
3491,5/24/23,5,0,5,0,2,12
3492,5/25/23,6,0,0,0,2,8
3493,5/26/23,10,0,2,0,5,17
3494,5/27/23,6,2,0,0,3,11
3495,5/28/23,8,0,4,0,3,15
3496,5/29/23,0,0,0,0,2,2
3497,5/30/23,15,0,3,0,11,29
3498,5/31/23,6,0,2,0,3,11
3499,6/1/23,12,0,3,0,5,20
3500,6/2/23,13,0,2,1,6,22
3501,6/3/23,6,0,3,0,1,10
3502,6/4/23,4,0,3,0,3,10
3503,6/5/23,14,0,7,0,12,33
3504,6/6/23,11,0,1,0,2,14
3505,6/7/23,9,0,5,1,7,22
3506,6/8/23,10,0,3,0,2,15
3507,6/9/23,6,0,0,0,4,10
3508,6/10/23,5,0,1,1,15,22
3509,6/11/23,7,1,1,0,1,10
3510,6/12/23,10,0,3,0,11,24
3511,6/13/23,9,0,3,0,3,15
3512,6/14/23,9,1,4,0,7,21
3513,6/15/23,2,0,3,0,0,5
3514,6/16/23,7,0,2,1,5,15
3515,6/17/23,2,0,4,0,0,6
3516,6/18/23,5,0,3,0,0,8
3517,6/19/23,0,0,0,0,1,1
3518,6/20/23,10,0,1,0,0,11
3519,6/21/23,10,2,1,0,8,21
3520,6/22/23,3,0,3,0,20,26
3521,6/23/23,8,0,1,0,0,9
3522,6/24/23,8,0,1,0,5,14
3523,6/25/23,7,0,0,0,3,10
3524,6/26/23,10,1,2,0,5,18
3525,6/27/23,8,0,4,0,2,14
3526,6/28/23,5,0,3,0,5,13
3527,6/29/23,11,0,5,0,1,17
3528,6/30/23,11,0,1,0,3,15
3529,7/1/23,3,0,0,0,1,4
3530,7/2/23,3,0,1,0,0,4
3531,7/3/23,8,0,1,0,4,13
3532,7/4/23,0,1,1,0,0,2
3533,7/5/23,13,0,0,0,4,17
3534,7/6/23,5,0,7,0,1,13
3535,7/7/23,7,0,6,1,0,14
3536,7/8/23,9,0,1,1,0,11
3537,7/9/23,5,1,5,0,0,11
3538,7/10/23,11,0,1,0,8,20
3539,7/11/23,14,0,1,0,0,15
3540,7/12/23,4,0,4,0,4,12
3541,7/13/23,2,0,0,0,2,4
3542,7/14/23,10,0,0,0,1,11
3543,7/15/23,8,0,1,0,1,10
3544,7/16/23,8,0,2,0,6,16
3545,7/17/23,6,0,0,0,3,9
3546,7/18/23,6,2,1,0,0,9
3547,7/19/23,12,1,1,0,4,18
3548,7/20/23,11,0,2,0,1,14
3549,7/21/23,10,0,1,0,1,12
3550,7/22/23,8,0,1,1,3,13
3551,7/23/23,3,0,0,0,3,6
3552,7/24/23,9,1,2,0,6,18
3553,7/25/23,7,0,1,1,0,9
3554,7/26/23,4,1,4,0,2,11
3555,7/27/23,9,0,0,0,5,14
3556,7/28/23,7,1,3,0,2,13
3557,7/29/23,4,0,1,0,1,6
3558,7/30/23,3,0,0,0,1,4
3559,7/31/23,10,0,3,0,5,18
3560,8/1/23,13,1,6,0,3,23
3561,8/2/23,6,2,3,0,1,12
3562,8/3/23,6,0,2,0,0,8
3563,8/4/23,7,0,3,0,1,11
3564,8/5/23,10,0,0,0,2,12
3565,8/6/23,7,0,5,1,4,17
3566,8/7/23,15,0,3,0,3,21
3567,8/8/23,6,0,0,1,7,14
3568,8/9/23,4,0,4,0,2,10
3569,8/10/23,11,1,1,0,11,24
3570,8/11/23,9,0,2,1,4,16
3571,8/12/23,4,0,3,0,4,11
3572,8/13/23,6,0,1,0,3,10
3573,8/14/23,9,0,3,0,6,18
3574,8/15/23,6,0,3,0,3,12
3575,8/16/23,10,0,0,1,0,11
3576,8/17/23,11,1,2,0,2,16
3577,8/18/23,1,0,2,1,6,10
3578,8/19/23,7,0,3,0,1,11
3579,8/20/23,8,0,2,0,0,10
3580,8/21/23,7,0,0,0,0,7
3581,8/22/23,7,0,3,0,0,10
3582,8/23/23,6,0,1,0,2,9
3583,8/24/23,1,0,1,0,2,4
3584,8/25/23,9,0,1,2,1,13
3585,8/26/23,24,0,2,0,3,29
3586,8/27/23,6,0,2,0,0,8
3587,8/28/23,8,0,3,0,0,11
3588,8/29/23,7,1,0,0,1,9
3589,8/30/23,5,1,5,0,3,14
3590,8/31/23,3,2,3,0,1,9
3591,9/1/23,7,0,2,0,4,13
3592,9/2/23,7,0,0,0,1,8
3593,9/3/23,8,0,0,0,2,10
,9/4/23,,,,,,
3594,9/5/23,10,0,4,0,2,16
3595,9/6/23,10,0,0,0,2,12
3596,9/7/23,9,0,1,0,3,13
3597,9/8/23,4,0,1,0,2,7
3598,9/9/23,6,0,0,0,1,7
3599,9/10/23,3,0,2,0,0,5
3600,9/11/23,8,0,1,0,3,12
3601,9/12/23,16,0,1,0,0,17
3602,9/13/23,2,0,3,0,2,7
3603,9/14/23,8,0,3,0,0,11
3604,9/15/23,4,0,1,1,2,8
3605,9/16/23,3,1,1,0,0,5
3606,9/17/23,2,0,0,0,1,3
3607,9/18/23,9,0,2,0,2,13
3608,9/19/23,8,0,4,0,1,13
3609,9/20/23,6,1,1,0,1,9
3610,9/21/23,4,0,2,0,0,6
3611,9/22/23,5,0,1,0,12,18
3612,9/23/23,5,0,2,0,1,8
3613,9/24/23,7,0,2,1,0,10
3614,9/25/23,6,0,2,0,1,9
3615,9/26/23,9,1,3,0,1,14
3616,9/27/23,11,1,3,0,3,18
3617,9/28/23,6,0,0,0,2,8
3618,9/29/23,9,1,7,0,1,18
3619,9/30/23,1,1,0,0,0,2
3620,10/1/23,4,0,0,0,1,5
3621,10/2/23,12,0,4,0,0,16
3622,10/3/23,4,2,3,0,3,12
3623,10/4/23,4,1,2,1,9,17
3624,10/5/23,3,0,1,0,0,4
3625,10/6/23,7,1,2,0,0,10
3626,10/7/23,11,0,0,1,0,12
3627,10/8/23,5,0,3,0,0,8
3628,10/9/23,8,0,0,0,11,19
3629,10/10/23,11,0,1,0,4,16
3630,10/11/23,10,0,1,0,3,14
3631,10/12/23,7,0,4,0,0,11
3632,10/13/23,7,0,0,0,3,10
3633,10/14/23,5,0,1,0,4,10
3634,10/15/23,5,0,2,0,2,9
3635,10/16/23,6,2,1,1,0,10
3636,10/17/23,7,0,2,0,1,10
3637,10/18/23,7,0,2,0,8,17
3638,10/19/23,5,0,1,0,2,8
3639,10/20/23,12,0,1,0,7,20
3640,10/21/23,8,0,1,1,10,20
3641,10/22/23,8,0,1,0,1,10
3642,10/23/23,11,0,2,0,0,13
3643,10/24/23,2,1,1,0,3,7
3644,10/25/23,5,1,1,1,7,15
3645,10/26/23,17,1,4,0,4,26
3646,10/27/23,6,0,6,0,9,21
3647,10/28/23,4,0,3,0,0,7
3648,10/29/23,2,0,0,0,1,3
3649,10/30/23,8,0,1,1,1,11
3650,10/31/23,13,0,0,0,6,19
3651,11/1/23,9,0,2,0,1,12
3652,11/2/23,11,0,1,0,0,12
3653,11/3/23,1,0,2,0,0,3
3654,11/4/23,1,0,3,0,0,4
3655,11/5/23,11,1,4,0,0,16
3656,11/6/23,13,0,1,0,2,16
3657,11/7/23,5,0,1,0,2,8
3658,11/8/23,11,0,0,1,16,28
3659,11/9/23,10,1,12,0,2,25
3660,11/10/23,0,2,0,0,1,3
3661,11/11/23,9,0,1,1,1,12
3662,11/12/23,6,0,0,0,1,7
3663,11/13/23,8,0,1,2,3,14
3664,11/14/23,10,0,2,0,0,12
3665,11/15/23,11,0,2,1,6,20
3666,11/16/23,11,0,0,0,2,13
3667,11/17/23,10,1,1,0,0,12
3668,11/18/23,2,0,0,0,5,7
3669,11/19/23,10,0,1,0,0,11
3670,11/20/23,12,0,1,0,0,13
3671,11/21/23,17,0,4,0,5,26
3672,11/22/23,25,0,2,0,2,29
,11/23/23,,,,,,
3673,11/24/23,0,0,0,0,1,1
3674,11/25/23,14,0,3,0,0,17
3675,11/26/23,10,0,1,0,0,11
3676,11/27/23,12,0,1,0,0,13
3677,11/28/23,9,0,7,0,1,17
3678,11/29/23,6,0,2,0,2,10
3679,11/30/23,7,1,4,1,1,14
3680,12/1/23,15,0,2,0,2,19
3681,12/2/23,6,0,4,0,0,10
3682,12/3/23,5,0,0,0,0,5
3683,12/4/23,11,0,2,0,0,13
3684,12/5/23,11,0,2,0,2,15
3685,12/6/23,14,0,4,0,4,22
3686,12/7/23,9,0,1,0,2,12
3687,12/8/23,12,0,0,0,2,14
3688,12/9/23,3,0,3,0,1,7
3689,12/10/23,4,0,0,0,1,5
3690,12/11/23,12,0,3,0,0,15
3691,12/12/23,10,0,3,0,2,15
3692,12/13/23,12,0,2,0,0,14
3693,12/14/23,11,0,3,0,7,21
3694,12/15/23,10,1,0,0,11,22
3695,12/16/23,10,0,1,0,1,12
3696,12/17/23,5,0,2,0,1,8
3697,12/18/23,9,0,1,0,0,10
3698,12/19/23,10,0,4,1,4,19
3699,12/20/23,15,0,2,0,0,17
3700,12/21/23,12,0,1,0,1,14
3701,12/22/23,9,0,2,1,14,26
3702,12/23/23,1,0,2,0,1,4
3703,12/24/23,4,1,1,0,0,6
3704,12/25/23,0,1,0,0,0,1
3705,12/26/23,0,0,0,0,4,4
3706,12/27/23,7,0,5,0,3,15
3707,12/28/23,21,1,0,0,1,23
3708,12/29/23,8,0,2,0,5,15
3709,12/30/23,8,0,1,0,0,9
3710,12/31/23,1,0,3,0,0,4
,1/1/24,,,,,,
3711,1/2/24,19,0,7,0,1,27
3712,1/3/24,11,0,1,0,3,15
3713,1/4/24,14,0,5,1,3,23
3714,1/5/24,24,0,3,0,2,29
3715,1/6/24,6,0,2,0,0,8
3716,1/7/24,3,0,2,0,1,6
3717,1/8/24,13,1,2,0,2,18
3718,1/9/24,10,1,3,0,2,16
3719,1/10/24,9,0,1,0,3,13
3720,1/11/24,12,0,4,0,3,19
3721,1/12/24,16,0,1,0,0,17
3722,1/13/24,7,0,5,0,4,16
3723,1/14/24,10,0,2,0,0,12
,1/15/24,,,,,,
3724,1/16/24,27,1,3,0,3,34
3725,1/17/24,8,0,5,0,2,15
3726,1/18/24,14,0,4,0,1,19
3727,1/19/24,15,1,3,0,6,25
3728,1/20/24,7,2,3,1,3,16
3729,1/21/24,21,0,0,0,1,22
3730,1/22/24,7,1,0,0,8,16
3731,1/23/24,12,0,1,0,0,13
3732,1/24/24,8,0,1,1,1,11
3733,1/25/24,8,1,1,0,0,10
3734,1/26/24,2,0,0,0,1,3
3735,1/27/24,11,0,0,0,1,12
3736,1/28/24,20,0,2,0,0,22
3737,1/29/24,23,2,2,0,4,31
3738,1/30/24,13,0,4,0,1,18
3739,1/31/24,10,0,0,0,2,12
3740,2/1/24,9,0,4,0,1,14
3741,2/2/24,10,0,2,0,3,15
3742,2/3/24,9,0,0,0,2,11
3743,2/4/24,12,1,4,0,2,19
3744,2/5/24,13,1,3,0,0,17
3745,2/6/24,7,0,2,0,0,9
3746,2/7/24,10,0,5,0,2,17
3747,2/8/24,16,0,4,0,8,28
3748,2/9/24,14,0,3,0,3,20
3749,2/10/24,17,0,0,0,2,19
3750,2/11/24,6,0,0,0,3,9
3751,2/12/24,18,0,4,0,3,25
3752,2/13/24,15,0,7,0,2,24
3753,2/14/24,10,0,3,0,4,17
3754,2/15/24,9,0,1,0,3,13
3755,2/16/24,11,0,2,0,2,15
3756,2/17/24,8,0,5,0,0,13
3757,2/18/24,10,2,2,1,6,21
3758,2/19/24,0,0,0,0,2,2
3759,2/20/24,18,1,3,0,1,23
3760,2/21/24,10,0,3,2,8,23
3761,2/22/24,13,0,2,0,0,15
3762,2/23/24,11,1,3,0,1,16
3763,2/24/24,10,0,1,0,0,11
3764,2/25/24,12,0,4,0,0,16
3765,2/26/24,17,0,1,1,0,19
3766,2/27/24,14,0,3,0,2,19
3767,2/28/24,8,0,0,0,5,13
3768,2/29/24,15,1,4,0,1,21
3769,3/1/24,10,2,1,0,1,14
3770,3/2/24,6,1,4,0,7,18
3771,3/3/24,11,0,0,0,1,12
3772,3/4/24,7,1,8,1,5,22
3773,3/5/24,15,0,6,0,8,29
3774,3/6/24,8,0,2,0,2,12
3775,3/7/24,12,0,4,0,2,18
3776,3/8/24,15,0,3,0,1,19
3777,3/9/24,6,0,3,0,1,10
3778,3/10/24,3,0,0,1,0,4
3779,3/11/24,14,0,2,0,2,18
3780,3/12/24,18,0,1,0,5,24
3781,3/13/24,8,0,8,0,2,18
3782,3/14/24,6,0,5,0,1,12
3783,3/15/24,8,0,2,0,1,11
3784,3/16/24,7,0,0,0,0,7
3785,3/17/24,4,0,4,0,2,10
3786,3/18/24,10,0,0,0,1,11
3787,3/19/24,7,1,5,0,0,13
3788,3/20/24,10,0,2,0,2,14
3789,3/21/24,14,0,1,0,1,16
3790,3/22/24,9,1,3,1,0,14
3791,3/23/24,13,1,1,0,4,19
3792,3/24/24,13,0,0,0,1,14
3793,3/25/24,22,1,2,0,4,29
3794,3/26/24,12,0,2,0,3,17
3795,3/27/24,4,0,3,0,0,7
3796,3/28/24,11,0,3,0,14,28
3797,3/29/24,4,1,1,0,1,7
3798,3/30/24,16,0,3,0,6,25
3799,3/31/24,4,0,0,1,2,7
3800,4/1/24,13,0,1,0,1,15
3801,4/2/24,12,0,2,0,2,16
3802,4/3/24,9,0,3,0,0,12
3803,4/4/24,4,1,4,0,1,10
3804,4/5/24,5,0,2,0,3,10
3805,4/6/24,6,0,1,0,1,8
3806,4/7/24,13,0,1,0,1,15
3807,4/8/24,3,0,3,1,0,7
3808,4/9/24,15,0,13,0,3,31
3809,4/10/24,14,0,0,0,6,20
3810,4/11/24,7,0,0,0,0,7
3811,4/12/24,4,0,2,0,5,11
3812,4/13/24,12,0,1,0,3,16
3813,4/14/24,10,0,1,0,4,15
3814,4/15/24,13,0,4,0,2,19
3815,4/16/24,9,1,2,0,2,14
3816,4/17/24,10,0,4,0,3,17
3817,4/18/24,9,0,6,0,1,16
3818,4/19/24,8,0,0,0,2,10
3819,4/20/24,9,1,4,0,3,17
3820,4/21/24,1,0,0,0,1,2
3821,4/22/24,4,0,2,0,0,6
3822,4/23/24,12,0,2,1,7,22
3823,4/24/24,7,0,1,1,6,15
3824,4/25/24,21,3,4,0,9,37
3825,4/26/24,14,0,3,0,1,18
3826,4/27/24,7,0,5,0,2,14
3827,4/28/24,7,0,1,0,2,10
3828,4/29/24,3,0,2,0,13,18
3829,4/30/24,11,0,1,0,4,16
3830,5/1/24,2,0,2,0,0,4
3831,5/2/24,9,0,2,0,2,13
3832,5/3/24,12,0,2,1,5,20
3833,5/4/24,6,0,3,0,1,10
3834,5/5/24,5,0,3,0,3,11
3835,5/6/24,20,1,6,0,4,31
3836,5/7/24,9,0,5,0,1,15
3837,5/8/24,5,2,3,0,1,11
3838,5/9/24,19,0,3,0,3,25
3839,5/10/24,5,0,1,0,1,7
3840,5/11/24,19,1,1,0,0,21
3841,5/12/24,5,0,1,0,0,6
3842,5/13/24,8,0,2,0,6,16
3843,5/14/24,5,0,1,0,4,10
3844,5/15/24,10,1,4,2,3,20
3845,5/16/24,11,1,1,0,8,21
3846,5/17/24,7,0,1,0,5,13
3847,5/18/24,3,0,1,0,0,4