DateTime,Stray_Abandoned,Euthanasia_Req,Public_Assist,Owner_Surrender,Other,TotalIntakes,Adopt,Euth,RTO,Unintended,Other,TotalOutcomes,Temp_max,Temp_min,Austin Unemployment Rate,Inflation Rate,National Unemployment Rate
10/1/13,30,1,2,9,0,42,6,7,11,0,5,29,91,66,5.1,1,7.2
10/2/13,20,0,4,4,0,28,12,2,9,0,10,33,92,75,5.1,1,7.2
10/3/13,19,0,4,3,0,26,7,0,6,0,5,18,93,76,5.1,1,7.2
10/4/13,24,0,0,6,0,30,6,3,9,0,5,23,92,73,5.1,1,7.2
10/5/13,27,0,4,8,0,39,22,2,6,0,8,38,90,62,5.1,1,7.2
10/6/13,15,1,3,6,0,25,18,1,9,0,4,32,82,55,5.1,1,7.2
10/7/13,13,0,2,3,0,18,14,2,6,0,8,30,85,55,5.1,1,7.2
10/8/13,32,0,3,7,0,42,6,0,9,0,1,16,85,53,5.1,1,7.2
10/9/13,27,0,1,1,0,29,11,2,3,0,5,21,85,55,5.1,1,7.2
10/10/13,23,1,2,4,0,30,9,4,5,1,21,40,86,63,5.1,1,7.2
10/11/13,29,0,2,2,0,33,10,2,5,0,16,33,88,72,5.1,1,7.2
10/12/13,26,0,3,7,0,36,21,3,18,0,6,48,92,70,5.1,1,7.2
10/13/13,23,0,0,3,0,26,35,0,4,0,4,43,76,67,5.1,1,7.2
10/14/13,30,1,1,4,0,36,7,3,9,0,19,38,78,72,5.1,1,7.2
10/15/13,33,2,2,16,0,53,11,5,10,0,24,50,85,58,5.1,1,7.2
10/16/13,38,0,2,4,0,44,8,0,7,0,20,35,62,54,5.1,1,7.2
10/17/13,22,0,1,3,0,26,11,1,6,0,1,19,75,54,5.1,1,7.2
10/18/13,14,0,3,6,0,23,7,4,14,0,6,31,72,55,5.1,1,7.2
10/19/13,21,1,1,4,0,27,17,0,2,0,3,22,68,48,5.1,1,7.2
10/20/13,19,0,2,5,0,26,17,1,9,0,12,39,75,44,5.1,1,7.2
10/21/13,29,0,0,4,0,33,14,1,9,0,8,32,81,59,5.1,1,7.2
10/22/13,20,0,2,5,0,27,7,3,7,1,3,21,77,54,5.1,1,7.2
10/23/13,21,0,2,6,0,29,6,0,6,0,7,19,82,54,5.1,1,7.2
10/24/13,17,1,2,9,0,29,15,6,10,0,15,46,82,53,5.1,1,7.2
10/25/13,21,0,1,6,0,28,4,2,7,1,8,22,79,54,5.1,1,7.2
10/26/13,23,0,5,6,0,34,13,0,5,0,3,21,81,62,5.1,1,7.2
10/27/13,26,0,0,5,0,31,14,1,6,0,4,25,75,64,5.1,1,7.2
10/28/13,23,1,0,7,0,31,2,6,9,1,20,38,82,66,5.1,1,7.2
10/29/13,19,0,7,7,0,33,12,3,5,0,11,31,84,71,5.1,1,7.2
10/30/13,19,0,3,7,0,29,6,3,5,0,9,23,84,72,5.1,1,7.2
10/31/13,13,0,2,7,0,22,17,3,7,0,1,28,82,54,5.1,1,7.2
11/1/13,21,0,4,15,0,40,18,1,9,0,8,36,84,51,4.7,1.2,6.9
11/2/13,23,0,2,3,0,28,18,0,5,0,5,28,75,49,4.7,1.2,6.9
11/3/13,16,0,1,5,0,22,30,3,4,0,5,42,69,46,4.7,1.2,6.9
11/4/13,14,0,0,15,0,29,11,3,8,0,20,42,67,60,4.7,1.2,6.9
11/5/13,24,0,2,4,0,30,7,1,11,0,2,21,80,66,4.7,1.2,6.9
11/6/13,23,0,2,5,0,30,3,1,7,0,6,17,72,52,4.7,1.2,6.9
11/7/13,25,0,3,2,0,30,8,2,12,0,11,33,65,42,4.7,1.2,6.9
11/8/13,25,0,4,7,0,36,4,2,9,0,12,27,66,50,4.7,1.2,6.9
11/9/13,27,0,1,5,0,33,17,0,13,0,8,38,70,54,4.7,1.2,6.9
11/10/13,20,0,1,1,0,22,24,4,5,0,3,36,71,60,4.7,1.2,6.9
11/11/13,10,0,0,5,0,15,16,2,11,0,7,36,77,53,4.7,1.2,6.9
11/12/13,28,0,3,6,0,37,6,1,7,0,1,15,61,44,4.7,1.2,6.9
11/13/13,12,0,2,3,0,17,4,1,7,0,5,17,57,34,4.7,1.2,6.9
11/14/13,20,1,2,6,0,29,8,1,4,0,3,16,63,33,4.7,1.2,6.9
11/15/13,21,0,0,7,0,28,8,5,4,0,14,31,78,51,4.7,1.2,6.9
11/16/13,18,0,4,4,0,26,11,3,13,0,8,35,81,63,4.7,1.2,6.9
11/17/13,21,0,2,11,0,34,8,0,8,0,13,29,90,67,4.7,1.2,6.9
11/18/13,18,0,0,3,0,21,5,0,3,0,1,9,80,62,4.7,1.2,6.9
11/19/13,17,0,1,6,0,24,10,2,11,0,8,31,72,57,4.7,1.2,6.9
11/20/13,18,0,0,3,0,21,4,1,7,0,7,19,71,59,4.7,1.2,6.9
11/21/13,18,0,1,2,0,21,7,5,5,0,6,23,81,67,4.7,1.2,6.9
11/22/13,17,0,4,3,0,24,7,2,8,0,6,23,74,36,4.7,1.2,6.9
11/23/13,18,0,0,6,0,24,13,2,12,0,6,33,43,36,4.7,1.2,6.9
11/24/13,19,0,1,4,0,24,9,1,7,0,4,21,43,35,4.7,1.2,6.9
11/25/13,37,0,0,6,0,43,9,0,6,0,10,25,40,35,4.7,1.2,6.9
11/26/13,19,0,5,10,0,34,5,5,5,0,9,24,54,38,4.7,1.2,6.9
11/27/13,31,0,1,6,0,38,9,1,8,0,9,27,52,33,4.7,1.2,6.9
11/28/13,6,0,0,1,0,7,5,1,2,0,2,10,57,32,4.7,1.2,6.9
11/29/13,24,0,1,1,0,26,6,3,7,0,16,32,63,34,4.7,1.2,6.9
11/30/13,21,0,1,2,0,24,34,0,4,0,11,49,67,51,4.7,1.2,6.9
12/1/13,7,0,2,2,0,11,23,0,6,1,6,36,73,53,4.4,1.5,6.7
12/2/13,30,0,0,6,0,36,7,4,13,1,3,28,83,55,4.4,1.5,6.7
12/3/13,23,0,0,2,0,25,11,0,5,0,6,22,85,49,4.4,1.5,6.7
12/4/13,20,1,23,3,0,47,12,2,3,0,8,25,75,56,4.4,1.5,6.7
12/5/13,17,0,7,4,0,28,9,5,4,0,5,23,68,34,4.4,1.5,6.7
12/6/13,17,0,3,7,0,27,9,5,4,0,17,35,38,30,4.4,1.5,6.7
12/7/13,17,0,1,4,0,22,14,1,3,0,1,19,31,27,4.4,1.5,6.7
12/8/13,13,0,0,12,0,25,16,1,4,1,6,28,47,28,4.4,1.5,6.7
12/9/13,24,0,2,6,0,32,10,0,8,0,13,31,40,35,4.4,1.5,6.7
12/10/13,14,0,0,5,0,19,8,1,5,0,5,19,48,29,4.4,1.5,6.7
12/11/13,15,1,1,6,0,23,6,5,9,0,2,22,60,30,4.4,1.5,6.7
12/12/13,25,0,6,3,0,34,10,3,4,0,10,27,54,32,4.4,1.5,6.7
12/13/13,10,1,1,5,0,17,12,1,6,0,12,31,51,45,4.4,1.5,6.7
12/14/13,29,0,2,6,0,37,16,2,9,0,4,31,51,40,4.4,1.5,6.7
12/15/13,18,0,3,3,0,24,12,2,7,0,6,27,62,34,4.4,1.5,6.7
12/16/13,15,1,0,13,0,29,13,1,6,0,3,23,69,34,4.4,1.5,6.7
12/17/13,33,0,0,6,0,39,10,0,12,0,1,23,74,36,4.4,1.5,6.7
12/18/13,13,0,0,5,0,18,15,1,7,0,8,31,72,39,4.4,1.5,6.7
12/19/13,18,0,2,3,0,23,11,3,8,0,8,30,78,55,4.4,1.5,6.7
12/20/13,19,0,4,6,0,29,15,0,9,0,8,32,74,67,4.4,1.5,6.7
12/21/13,28,2,2,4,0,36,24,3,12,0,7,46,74,45,4.4,1.5,6.7
12/22/13,9,0,3,13,0,25,15,0,14,0,1,30,56,39,4.4,1.5,6.7
12/23/13,17,1,1,12,0,31,20,4,15,0,2,41,58,32,4.4,1.5,6.7
12/24/13,12,1,7,4,0,24,25,2,3,0,7,37,61,31,4.4,1.5,6.7
12/25/13,4,0,2,0,0,6,0,1,0,0,1,2,58,41,4.4,1.5,6.7
12/26/13,32,1,4,1,0,38,13,2,12,0,3,30,57,39,4.4,1.5,6.7
12/27/13,19,0,1,2,0,22,11,7,5,0,6,29,60,45,4.4,1.5,6.7
12/28/13,21,0,0,5,0,26,25,0,6,0,13,44,62,40,4.4,1.5,6.7
12/29/13,26,0,3,5,0,34,12,1,7,0,7,27,64,36,4.4,1.5,6.7
12/30/13,21,0,1,8,0,30,11,3,8,1,4,27,44,35,4.4,1.5,6.7
12/31/13,27,0,2,6,0,35,10,1,15,0,9,35,55,36,4.4,1.5,6.7
1/1/14,32,0,2,5,0,39,20,2,8,0,10,40,69,39,4.7,1.6,6.6
1/2/14,32,0,0,2,0,34,11,1,8,0,5,25,55,33,4.7,1.6,6.6
1/3/14,26,0,0,3,0,29,13,1,16,1,11,42,58,28,4.7,1.6,6.6
1/4/14,29,0,2,7,0,38,17,1,4,0,2,24,71,42,4.7,1.6,6.6
1/5/14,15,0,1,4,0,20,28,0,13,0,14,55,59,34,4.7,1.6,6.6
1/6/14,12,1,0,9,0,22,10,3,9,0,4,26,36,22,4.7,1.6,6.6
1/7/14,21,0,2,5,0,28,12,2,4,0,9,27,48,22,4.7,1.6,6.6
1/8/14,18,0,3,10,0,31,6,4,9,0,5,24,53,40,4.7,1.6,6.6
1/9/14,29,1,0,6,0,36,7,2,6,0,6,21,70,53,4.7,1.6,6.6
1/10/14,17,0,1,3,0,21,13,3,7,0,11,34,72,57,4.7,1.6,6.6
1/11/14,34,0,0,3,0,37,13,1,6,0,5,25,75,48,4.7,1.6,6.6
1/12/14,18,0,0,5,0,23,12,0,8,0,11,31,67,46,4.7,1.6,6.6
1/13/14,27,0,0,9,0,36,11,1,12,0,1,25,71,43,4.7,1.6,6.6
1/14/14,28,0,0,7,0,35,7,1,12,0,3,23,76,37,4.7,1.6,6.6
1/15/14,17,0,2,11,0,30,12,0,12,0,4,28,64,40,4.7,1.6,6.6
1/16/14,14,0,3,5,0,22,6,1,19,0,7,33,72,40,4.7,1.6,6.6
1/17/14,21,0,5,0,0,26,7,3,7,0,11,28,64,43,4.7,1.6,6.6
1/18/14,21,0,4,13,0,38,19,2,4,0,5,30,70,37,4.7,1.6,6.6
1/19/14,16,0,2,4,0,22,13,0,6,0,10,29,72,45,4.7,1.6,6.6
1/20/14,19,0,3,4,0,26,15,2,3,0,13,33,82,46,4.7,1.6,6.6
1/21/14,27,0,1,5,0,33,9,1,5,0,3,18,63,38,4.7,1.6,6.6
1/22/14,12,0,4,5,0,21,13,2,7,1,4,27,70,37,4.7,1.6,6.6
1/23/14,17,1,2,1,0,21,10,1,8,1,7,27,56,27,4.7,1.6,6.6
1/24/14,8,1,4,9,0,22,4,2,5,0,5,16,40,26,4.7,1.6,6.6
1/25/14,21,1,4,8,0,34,13,1,11,0,7,32,70,26,4.7,1.6,6.6
1/26/14,9,1,2,5,0,17,14,2,3,0,11,30,76,43,4.7,1.6,6.6
1/27/14,22,0,6,12,0,40,9,1,5,0,2,17,60,34,4.7,1.6,6.6
1/28/14,10,0,2,6,0,18,5,1,11,1,2,20,39,27,4.7,1.6,6.6
1/29/14,15,0,1,2,0,18,15,0,7,0,10,32,49,27,4.7,1.6,6.6
1/30/14,25,0,1,5,0,31,9,1,7,0,3,20,65,31,4.7,1.6,6.6
1/31/14,20,0,5,4,0,29,6,3,6,0,3,18,80,55,4.7,1.6,6.6
2/1/14,14,0,0,6,0,20,25,1,8,0,0,34,76,55,4.7,1.1,6.7
2/2/14,22,0,0,8,0,30,16,3,10,0,6,35,55,35,4.7,1.1,6.7
2/3/14,11,2,0,3,0,16,14,4,11,1,5,35,46,34,4.7,1.1,6.7
2/4/14,18,0,4,3,0,25,10,1,8,0,12,31,64,42,4.7,1.1,6.7
2/5/14,28,0,2,9,0,39,3,1,8,0,3,15,48,31,4.7,1.1,6.7
2/6/14,25,0,2,6,0,33,10,3,5,0,4,22,32,26,4.7,1.1,6.7
2/7/14,10,0,2,2,0,14,5,0,7,0,14,26,38,29,4.7,1.1,6.7
2/8/14,22,0,1,7,0,30,13,0,7,0,3,23,65,37,4.7,1.1,6.7
2/9/14,19,0,0,9,0,28,15,0,5,0,5,25,76,41,4.7,1.1,6.7
2/10/14,24,0,3,5,0,32,7,2,9,0,11,29,60,35,4.7,1.1,6.7
2/11/14,13,0,0,5,0,18,12,1,11,0,5,29,36,33,4.7,1.1,6.7
2/12/14,30,0,2,3,0,35,4,3,6,0,3,16,57,33,4.7,1.1,6.7
2/13/14,16,0,4,7,0,27,6,2,16,0,15,39,69,32,4.7,1.1,6.7
2/14/14,18,0,2,2,0,22,11,2,5,0,7,25,86,47,4.7,1.1,6.7
2/15/14,14,0,3,6,0,23,16,4,4,0,3,27,76,42,4.7,1.1,6.7
2/16/14,13,0,3,5,0,21,26,1,2,0,11,40,76,59,4.7,1.1,6.7
2/17/14,19,0,2,6,0,27,14,0,9,0,8,31,81,58,4.7,1.1,6.7
2/18/14,19,0,5,3,0,27,11,0,8,0,2,21,82,55,4.7,1.1,6.7
2/19/14,23,0,52,7,0,82,12,0,12,0,9,33,82,63,4.7,1.1,6.7
2/20/14,18,0,3,9,0,30,3,2,9,0,8,22,83,57,4.7,1.1,6.7
2/21/14,18,0,1,7,0,26,12,1,7,0,4,24,72,41,4.7,1.1,6.7
2/22/14,22,2,0,13,0,37,16,2,5,0,7,30,77,48,4.7,1.1,6.7
2/23/14,15,0,3,9,0,27,20,1,8,0,2,31,86,62,4.7,1.1,6.7
2/24/14,23,0,3,4,0,30,15,2,10,0,10,37,76,55,4.7,1.1,6.7
2/25/14,18,0,1,6,0,25,17,6,13,0,2,38,71,52,4.7,1.1,6.7
2/26/14,18,1,2,7,0,28,11,3,6,1,1,22,52,36,4.7,1.1,6.7
2/27/14,24,1,5,10,0,40,6,0,6,0,3,15,59,31,4.7,1.1,6.7
2/28/14,17,0,3,6,0,26,10,2,4,0,3,19,80,44,4.7,1.1,6.7
3/1/14,17,0,0,5,0,22,18,0,6,0,5,29,82,53,4.5,1.5,6.7
3/2/14,14,0,2,3,0,19,14,3,8,1,7,33,73,28,4.5,1.5,6.7
3/3/14,15,0,0,4,0,19,6,2,4,0,11,23,47,24,4.5,1.5,6.7
3/4/14,25,0,0,3,0,28,13,0,6,0,5,24,50,30,4.5,1.5,6.7
3/5/14,24,1,2,8,0,35,11,1,6,0,1,19,53,38,4.5,1.5,6.7
3/6/14,18,0,4,4,0,26,9,0,7,0,2,18,65,43,4.5,1.5,6.7
3/7/14,22,0,4,5,0,31,9,5,10,0,5,29,67,39,4.5,1.5,6.7
3/8/14,20,0,1,3,0,24,19,2,10,0,4,35,59,44,4.5,1.5,6.7
3/9/14,16,0,2,4,0,22,18,1,7,0,9,35,58,39,4.5,1.5,6.7
3/10/14,23,0,3,7,0,33,13,2,9,1,7,32,71,50,4.5,1.5,6.7
3/11/14,17,0,1,9,0,27,11,4,7,0,6,28,83,56,4.5,1.5,6.7
3/12/14,33,0,2,4,0,39,6,2,6,0,3,17,70,49,4.5,1.5,6.7
3/13/14,34,1,2,4,0,41,17,1,13,0,16,47,68,37,4.5,1.5,6.7
3/14/14,19,0,5,11,0,35,14,1,9,0,13,37,75,49,4.5,1.5,6.7
3/15/14,29,0,1,8,0,38,14,2,6,0,10,32,74,62,4.5,1.5,6.7
3/16/14,32,0,2,5,0,39,15,2,13,0,11,41,64,48,4.5,1.5,6.7
3/17/14,16,1,4,6,0,27,9,2,14,0,11,36,68,41,4.5,1.5,6.7
3/18/14,15,2,4,8,0,29,11,1,11,0,8,31,83,47,4.5,1.5,6.7
3/19/14,27,0,4,3,0,34,8,4,8,0,2,22,72,51,4.5,1.5,6.7
3/20/14,14,1,3,6,0,24,11,3,10,0,4,28,76,42,4.5,1.5,6.7
3/21/14,24,0,4,5,0,33,9,4,9,0,8,30,80,54,4.5,1.5,6.7
3/22/14,19,0,2,6,0,27,17,1,11,0,4,33,77,61,4.5,1.5,6.7
3/23/14,17,0,1,7,0,25,19,0,11,0,17,47,61,47,4.5,1.5,6.7
3/24/14,9,0,2,4,0,15,6,3,5,0,3,17,66,50,4.5,1.5,6.7
3/25/14,24,0,1,8,0,33,11,2,9,0,2,24,69,44,4.5,1.5,6.7
3/26/14,38,0,1,3,0,42,8,2,7,0,4,21,66,54,4.5,1.5,6.7
3/27/14,9,0,7,3,0,19,7,4,12,0,5,28,82,61,4.5,1.5,6.7
3/28/14,14,0,2,5,0,21,9,1,7,0,4,21,89,63,4.5,1.5,6.7
3/29/14,19,0,1,10,0,30,18,0,8,0,6,32,77,51,4.5,1.5,6.7
3/30/14,26,0,1,2,0,29,31,1,12,0,7,51,79,45,4.5,1.5,6.7
3/31/14,21,0,2,6,0,29,8,3,4,0,2,17,85,60,4.5,1.5,6.7
4/1/14,26,0,2,1,0,29,3,4,14,0,3,24,86,66,3.9,2,6.2
4/2/14,25,0,3,13,0,41,7,1,13,0,4,25,82,70,3.9,2,6.2
4/3/14,15,0,2,5,0,22,16,2,8,0,15,41,82,71,3.9,2,6.2
4/4/14,18,0,3,6,0,27,6,0,13,0,2,21,74,54,3.9,2,6.2
4/5/14,27,0,7,8,0,42,18,3,10,1,12,44,65,54,3.9,2,6.2
4/6/14,25,0,1,7,0,33,19,0,14,0,3,36,61,52,3.9,2,6.2
4/7/14,21,0,1,6,0,28,10,1,10,1,6,28,72,52,3.9,2,6.2
4/8/14,30,1,3,0,0,34,12,1,9,0,4,26,77,50,3.9,2,6.2
4/9/14,15,0,3,2,0,20,9,0,12,0,8,29,84,45,3.9,2,6.2
4/10/14,9,0,1,5,0,15,13,4,5,0,6,28,87,57,3.9,2,6.2
4/11/14,23,0,2,8,0,33,8,0,6,0,4,18,85,61,3.9,2,6.2
4/12/14,19,0,7,7,0,33,12,0,8,0,3,23,85,65,3.9,2,6.2
4/13/14,15,0,1,3,0,19,12,0,8,0,4,24,78,68,3.9,2,6.2
4/14/14,37,0,3,3,0,43,4,3,6,0,6,19,73,43,3.9,2,6.2
4/15/14,26,0,2,5,0,33,6,0,11,0,12,29,65,39,3.9,2,6.2
4/16/14,19,0,5,4,0,28,8,0,15,0,16,39,73,40,3.9,2,6.2
4/17/14,16,1,2,10,0,29,7,5,9,0,14,35,67,56,3.9,2,6.2
4/18/14,21,0,5,6,0,32,7,0,5,0,19,31,78,59,3.9,2,6.2
4/19/14,20,0,2,6,0,28,29,0,8,0,3,40,78,54,3.9,2,6.2
4/20/14,16,0,1,0,0,17,17,0,9,0,5,31,75,61,3.9,2,6.2
4/21/14,28,1,2,4,0,35,13,1,4,0,3,21,84,64,3.9,2,6.2
4/22/14,12,0,3,3,0,18,9,0,8,0,2,19,87,63,3.9,2,6.2
4/23/14,19,0,8,5,0,32,8,3,12,0,7,30,87,59,3.9,2,6.2
4/24/14,12,0,1,1,0,14,12,0,12,0,6,30,88,67,3.9,2,6.2
4/25/14,18,0,5,5,0,28,9,1,11,0,9,30,88,63,3.9,2,6.2
4/26/14,20,0,2,8,0,30,13,1,6,1,8,29,86,68,3.9,2,6.2
4/27/14,29,1,0,4,0,34,12,1,6,0,1,20,96,73,3.9,2,6.2
4/28/14,20,0,3,4,0,27,9,1,10,1,4,25,93,66,3.9,2,6.2
4/29/14,15,0,2,5,0,22,10,1,7,0,0,18,84,60,3.9,2,6.2
4/30/14,24,0,3,5,0,32,13,1,9,0,11,34,75,57,3.9,2,6.2
5/1/14,15,1,8,3,0,27,8,4,13,0,2,27,77,52,4.2,2.1,6.3
5/2/14,7,0,1,7,0,15,4,0,6,0,4,14,83,56,4.2,2.1,6.3
5/3/14,14,1,1,7,0,23,17,0,5,0,4,26,94,58,4.2,2.1,6.3
5/4/14,15,0,2,5,0,22,28,5,14,0,4,51,91,61,4.2,2.1,6.3
5/5/14,20,0,5,7,0,32,16,3,8,0,3,30,92,60,4.2,2.1,6.3
5/6/14,24,0,6,9,0,39,6,1,9,1,7,24,87,65,4.2,2.1,6.3
5/7/14,21,0,4,6,0,31,8,0,2,0,8,18,88,70,4.2,2.1,6.3
5/8/14,18,1,2,4,0,25,5,3,6,0,4,18,84,73,4.2,2.1,6.3
5/9/14,23,0,2,3,0,28,7,3,11,0,11,32,86,66,4.2,2.1,6.3
5/10/14,29,0,5,5,0,39,16,1,9,0,4,30,91,60,4.2,2.1,6.3
5/11/14,14,0,1,2,0,17,11,1,11,0,12,35,93,72,4.2,2.1,6.3
5/12/14,30,0,4,10,0,44,5,0,10,0,3,18,82,62,4.2,2.1,6.3
5/13/14,30,0,1,5,0,36,11,0,14,0,8,33,67,55,4.2,2.1,6.3
5/14/14,34,0,0,8,0,42,13,8,9,0,9,39,76,51,4.2,2.1,6.3
5/15/14,19,0,3,2,0,24,3,3,10,0,8,24,84,46,4.2,2.1,6.3
5/16/14,23,0,6,2,0,31,6,1,10,0,11,28,86,61,4.2,2.1,6.3
5/17/14,35,0,4,7,0,46,15,2,7,0,6,30,86,60,4.2,2.1,6.3
5/18/14,13,0,2,1,0,16,13,2,10,0,5,30,85,62,4.2,2.1,6.3
5/19/14,19,0,8,4,0,31,14,1,9,0,3,27,86,66,4.2,2.1,6.3
5/20/14,19,0,2,6,0,27,10,0,9,1,5,25,89,67,4.2,2.1,6.3
5/21/14,25,0,1,6,0,32,13,0,5,0,7,25,89,70,4.2,2.1,6.3
5/22/14,12,0,1,3,0,16,8,5,8,2,5,28,87,70,4.2,2.1,6.3
5/23/14,27,0,2,5,0,34,18,1,7,0,7,33,84,71,4.2,2.1,6.3
5/24/14,25,0,5,5,0,35,10,3,6,2,18,39,86,70,4.2,2.1,6.3
5/25/14,33,0,2,3,0,38,10,0,5,0,11,26,87,72,4.2,2.1,6.3
5/26/14,16,0,0,0,0,16,21,1,14,0,10,46,75,64,4.2,2.1,6.3
5/27/14,23,0,9,5,0,37,12,1,13,0,4,30,73,63,4.2,2.1,6.3
5/28/14,31,0,2,9,0,42,6,2,11,0,4,23,84,68,4.2,2.1,6.3
5/29/14,31,0,3,6,0,40,11,2,9,0,2,24,89,66,4.2,2.1,6.3
5/30/14,35,0,5,8,0,48,8,1,13,0,12,34,94,68,4.2,2.1,6.3
5/31/14,27,0,4,2,0,33,21,0,6,0,25,52,93,70,4.2,2.1,6.3
6/1/14,17,0,1,9,0,27,20,0,10,0,8,38,88,71,4.5,2.1,6.1
6/2/14,26,0,5,6,0,37,14,2,7,0,2,25,91,74,4.5,2.1,6.1
6/3/14,22,0,2,8,0,32,19,3,11,0,12,45,90,75,4.5,2.1,6.1
6/4/14,21,0,3,3,0,27,4,0,8,0,7,19,91,74,4.5,2.1,6.1
6/5/14,18,0,2,2,0,22,7,0,4,0,5,16,91,74,4.5,2.1,6.1
6/6/14,12,0,1,3,0,16,10,1,11,0,10,32,92,73,4.5,2.1,6.1
6/7/14,20,0,2,6,0,28,18,3,6,0,12,39,92,74,4.5,2.1,6.1
6/8/14,13,0,1,5,0,19,14,0,7,0,1,22,90,76,4.5,2.1,6.1
6/9/14,24,0,0,5,0,29,13,4,10,0,3,30,86,68,4.5,2.1,6.1
6/10/14,19,0,2,7,0,28,7,1,9,0,8,25,92,64,4.5,2.1,6.1
6/11/14,23,0,4,2,0,29,7,2,2,0,6,17,94,66,4.5,2.1,6.1
6/12/14,9,0,2,5,0,16,5,1,4,0,3,13,92,68,4.5,2.1,6.1
6/13/14,34,0,3,6,0,43,8,1,8,0,3,20,89,68,4.5,2.1,6.1
6/14/14,31,0,1,10,0,42,15,2,14,0,0,31,87,73,4.5,2.1,6.1
6/15/14,16,0,2,4,0,22,19,1,7,0,9,36,91,74,4.5,2.1,6.1
6/16/14,16,0,1,5,0,22,14,2,4,0,9,29,92,75,4.5,2.1,6.1
6/17/14,29,0,5,5,0,39,12,5,12,0,16,45,92,75,4.5,2.1,6.1
6/18/14,31,0,4,4,0,39,13,1,4,0,3,21,92,77,4.5,2.1,6.1
6/19/14,23,1,2,7,0,33,10,4,9,0,19,42,91,76,4.5,2.1,6.1
6/20/14,14,0,6,3,0,23,9,0,4,0,7,20,91,75,4.5,2.1,6.1
6/21/14,15,0,5,11,0,31,16,0,11,0,3,30,92,75,4.5,2.1,6.1
6/22/14,17,0,1,5,0,23,17,4,2,0,12,35,90,76,4.5,2.1,6.1
6/23/14,13,0,4,5,0,22,7,1,4,1,4,17,88,68,4.5,2.1,6.1
6/24/14,29,0,2,2,0,33,6,2,9,0,6,23,93,74,4.5,2.1,6.1
6/25/14,26,0,3,7,0,36,8,1,5,0,3,17,89,71,4.5,2.1,6.1
6/26/14,19,0,3,12,0,34,7,4,10,0,30,51,88,71,4.5,2.1,6.1
6/27/14,21,2,4,5,0,32,6,2,9,1,1,19,91,75,4.5,2.1,6.1
6/28/14,20,0,0,3,0,23,13,1,7,0,8,29,93,78,4.5,2.1,6.1
6/29/14,24,1,7,7,0,39,23,1,3,0,8,35,95,77,4.5,2.1,6.1
6/30/14,23,1,1,7,0,32,13,1,14,0,5,33,96,77,4.5,2.1,6.1
7/1/14,21,1,1,3,0,26,24,2,7,0,7,40,96,75,4.7,2,6.2
7/2/14,18,0,2,3,0,23,14,3,15,0,6,38,97,73,4.7,2,6.2
7/3/14,31,0,2,5,0,38,9,1,5,0,5,20,96,72,4.7,2,6.2
7/4/14,19,0,0,2,0,21,9,0,5,0,19,33,93,71,4.7,2,6.2
7/5/14,35,0,0,9,0,44,15,1,10,0,13,39,94,69,4.7,2,6.2
7/6/14,31,0,1,2,0,34,19,2,15,0,1,37,95,72,4.7,2,6.2
7/7/14,22,0,4,4,0,30,24,2,16,0,2,44,96,73,4.7,2,6.2
7/8/14,13,0,0,3,0,16,9,4,6,0,2,21,98,74,4.7,2,6.2
7/9/14,26,0,11,5,0,42,15,0,8,0,4,27,98,72,4.7,2,6.2
7/10/14,27,0,5,3,0,35,19,4,10,0,6,39,96,72,4.7,2,6.2
7/11/14,29,0,1,2,0,32,18,2,6,0,7,33,95,71,4.7,2,6.2
7/12/14,23,0,0,5,0,28,13,2,7,0,4,26,98,71,4.7,2,6.2
7/13/14,14,0,0,11,0,25,23,1,5,0,2,31,100,74,4.7,2,6.2
7/14/14,14,0,5,3,0,22,14,0,3,0,5,22,101,75,4.7,2,6.2
7/15/14,33,0,1,6,0,40,13,0,5,0,6,24,92,73,4.7,2,6.2
7/16/14,18,0,2,5,0,25,13,3,5,0,13,34,95,73,4.7,2,6.2
7/17/14,17,0,1,4,0,22,19,3,3,0,6,31,89,74,4.7,2,6.2
7/18/14,20,1,2,7,0,30,11,2,9,0,10,32,78,72,4.7,2,6.2
7/19/14,26,0,8,5,0,39,22,1,5,1,2,31,86,70,4.7,2,6.2
7/20/14,16,0,5,4,0,25,7,1,1,0,5,14,94,74,4.7,2,6.2
7/21/14,23,1,4,15,0,43,10,4,15,0,21,50,96,77,4.7,2,6.2
7/22/14,18,0,3,4,0,25,16,0,6,1,2,25,96,76,4.7,2,6.2
7/23/14,24,1,4,7,0,36,17,16,9,0,12,54,97,75,4.7,2,6.2
7/24/14,20,0,9,5,0,34,11,1,7,0,7,26,94,74,4.7,2,6.2
7/25/14,29,1,5,1,0,36,10,2,11,0,3,26,96,75,4.7,2,6.2
7/26/14,17,0,1,3,0,21,14,0,7,0,2,23,98,76,4.7,2,6.2
7/27/14,21,0,0,5,0,26,18,2,9,0,11,40,98,75,4.7,2,6.2
7/28/14,13,0,4,10,0,27,5,1,8,0,3,17,99,74,4.7,2,6.2
7/29/14,14,1,2,11,0,28,19,2,6,0,2,29,97,76,4.7,2,6.2
7/30/14,30,2,1,1,0,34,11,4,11,0,9,35,96,76,4.7,2,6.2
7/31/14,12,0,3,4,0,19,5,1,8,0,4,18,97,77,4.7,2,6.2
8/1/14,15,1,5,6,0,27,21,1,8,0,4,34,91,73,4.6,1.7,6.1
8/2/14,25,1,0,4,0,30,17,1,5,1,8,32,90,68,4.6,1.7,6.1
8/3/14,24,0,3,3,0,30,22,0,5,0,8,35,94,71,4.6,1.7,6.1
8/4/14,24,1,1,8,0,34,18,2,11,0,7,38,94,72,4.6,1.7,6.1
8/5/14,14,1,1,5,0,21,10,1,10,1,3,25,97,73,4.6,1.7,6.1
8/6/14,25,0,2,0,0,27,14,4,13,0,5,36,99,76,4.6,1.7,6.1
8/7/14,25,0,1,7,0,33,11,0,16,1,3,31,102,77,4.6,1.7,6.1
8/8/14,16,1,3,6,0,26,10,2,6,0,0,18,102,76,4.6,1.7,6.1
8/9/14,22,0,2,13,0,37,13,1,8,0,5,27,100,77,4.6,1.7,6.1
8/10/14,18,0,1,6,0,25,25,0,11,0,5,41,101,77,4.6,1.7,6.1
8/11/14,17,0,4,3,0,24,16,1,6,0,6,29,102,76,4.6,1.7,6.1
8/12/14,29,1,0,9,0,39,11,3,4,0,4,22,100,73,4.6,1.7,6.1
8/13/14,15,0,5,4,0,24,25,4,6,0,2,37,97,69,4.6,1.7,6.1
8/14/14,23,0,3,6,0,32,6,1,4,0,13,24,98,70,4.6,1.7,6.1
8/15/14,22,0,2,11,0,35,4,0,7,0,4,15,101,75,4.6,1.7,6.1
8/16/14,17,0,2,3,0,22,15,1,8,0,4,28,104,77,4.6,1.7,6.1
8/17/14,13,0,1,5,0,19,27,1,4,0,3,35,101,79,4.6,1.7,6.1
8/18/14,16,0,4,6,0,26,17,2,7,0,9,35,102,78,4.6,1.7,6.1
8/19/14,20,0,3,4,0,27,22,1,3,0,6,32,96,77,4.6,1.7,6.1
8/20/14,13,0,5,3,0,21,13,3,8,0,11,35,102,78,4.6,1.7,6.1
8/21/14,25,0,3,5,0,33,15,1,5,0,16,37,103,80,4.6,1.7,6.1
8/22/14,10,0,0,1,0,11,16,0,9,0,1,26,103,79,4.6,1.7,6.1
8/23/14,17,0,3,4,0,24,17,0,8,0,5,30,101,75,4.6,1.7,6.1
8/24/14,19,0,0,13,0,32,17,0,9,0,2,28,101,77,4.6,1.7,6.1
8/25/14,24,1,1,4,0,30,17,1,4,0,0,22,101,76,4.6,1.7,6.1
8/26/14,11,0,3,7,0,21,10,0,4,0,0,14,101,77,4.6,1.7,6.1
8/27/14,19,0,0,7,0,26,9,3,8,0,6,26,98,76,4.6,1.7,6.1
8/28/14,21,0,2,2,0,25,11,1,5,0,5,22,99,76,4.6,1.7,6.1
8/29/14,22,0,3,4,0,29,11,6,7,0,9,33,96,77,4.6,1.7,6.1
8/30/14,27,0,1,3,0,31,28,1,11,0,4,44,95,74,4.6,1.7,6.1
8/31/14,11,0,4,5,0,20,18,1,8,0,6,33,99,74,4.6,1.7,6.1
9/1/14,19,0,3,6,0,28,14,4,6,0,4,28,101,78,4.3,1.7,5.9
9/2/14,19,0,5,20,0,44,14,0,5,0,6,25,98,78,4.3,1.7,5.9
9/3/14,26,0,2,5,0,33,9,2,10,0,15,36,100,76,4.3,1.7,5.9
9/4/14,32,0,1,7,0,40,10,1,11,0,6,28,99,73,4.3,1.7,5.9
9/5/14,14,1,8,3,0,26,11,2,7,0,6,26,97,77,4.3,1.7,5.9
9/6/14,23,0,4,1,0,28,12,0,10,0,14,36,97,74,4.3,1.7,5.9
9/7/14,22,0,4,7,0,33,21,1,4,0,9,35,89,74,4.3,1.7,5.9
9/8/14,13,0,1,9,0,23,17,3,9,0,9,38,96,72,4.3,1.7,5.9
9/9/14,15,0,3,4,0,22,14,3,5,0,10,32,97,74,4.3,1.7,5.9
9/10/14,20,0,1,19,0,40,14,2,10,0,1,27,99,77,4.3,1.7,5.9
9/11/14,11,0,2,6,0,19,11,0,7,0,1,19,99,78,4.3,1.7,5.9
9/12/14,21,0,2,4,0,27,15,0,8,0,1,24,96,66,4.3,1.7,5.9
9/13/14,21,0,4,2,0,27,18,0,13,0,8,39,66,60,4.3,1.7,5.9
9/14/14,21,1,1,7,0,30,16,3,11,0,11,41,77,64,4.3,1.7,5.9
9/15/14,28,1,2,7,0,38,3,1,10,0,9,23,88,69,4.3,1.7,5.9
9/16/14,20,1,1,12,0,34,6,2,8,0,8,24,94,74,4.3,1.7,5.9
9/17/14,18,0,1,10,0,29,13,1,3,0,4,21,91,75,4.3,1.7,5.9
9/18/14,32,0,2,3,0,37,8,2,7,0,1,18,90,72,4.3,1.7,5.9
9/19/14,33,1,4,12,0,50,6,4,13,0,5,28,86,74,4.3,1.7,5.9
9/20/14,34,0,1,3,0,38,22,0,15,0,7,44,90,74,4.3,1.7,5.9
9/21/14,20,0,0,3,0,23,18,3,4,0,8,33,90,72,4.3,1.7,5.9
9/22/14,35,0,2,3,0,40,13,0,14,0,6,33,91,70,4.3,1.7,5.9
9/23/14,17,0,2,8,0,27,9,0,7,0,8,24,85,67,4.3,1.7,5.9
9/24/14,15,1,5,3,0,24,14,2,11,0,1,28,84,60,4.3,1.7,5.9
9/25/14,19,0,1,6,0,26,4,0,5,0,3,12,83,62,4.3,1.7,5.9
9/26/14,19,0,0,4,0,23,7,4,11,0,14,36,85,66,4.3,1.7,5.9
9/27/14,17,0,2,3,0,22,30,0,8,0,6,44,80,68,4.3,1.7,5.9
9/28/14,11,0,1,13,0,25,10,0,9,0,3,22,88,66,4.3,1.7,5.9
9/29/14,25,0,2,1,0,28,15,5,7,1,16,44,89,67,4.3,1.7,5.9
9/30/14,20,0,2,11,0,33,5,1,5,0,8,19,90,65,4.3,1.7,5.9
10/1/14,30,0,1,2,0,33,5,2,3,0,10,20,92,76,3.9,1.7,5.7
10/2/14,23,0,4,5,0,32,3,2,5,0,17,27,92,76,3.9,1.7,5.7
10/3/14,21,0,1,6,0,28,9,0,6,0,4,19,85,65,3.9,1.7,5.7
10/4/14,26,1,3,4,0,34,9,2,11,0,10,32,80,59,3.9,1.7,5.7
10/5/14,11,1,6,2,0,20,14,0,6,0,1,21,87,62,3.9,1.7,5.7
10/6/14,18,0,1,4,0,23,7,1,10,0,8,26,89,72,3.9,1.7,5.7
10/7/14,22,0,5,4,0,31,9,1,4,0,4,18,94,72,3.9,1.7,5.7
10/8/14,21,0,1,2,0,24,11,3,6,0,8,28,90,74,3.9,1.7,5.7
10/9/14,24,1,3,7,0,35,8,6,16,0,7,37,92,75,3.9,1.7,5.7
10/10/14,21,2,1,2,0,26,20,4,2,0,6,32,92,75,3.9,1.7,5.7
10/11/14,15,2,4,3,0,24,18,1,4,0,5,28,78,59,3.9,1.7,5.7
10/12/14,13,1,3,1,0,18,26,1,6,0,4,37,77,61,3.9,1.7,5.7
10/13/14,21,0,4,3,0,28,14,2,8,0,7,31,76,61,3.9,1.7,5.7
10/14/14,25,0,3,6,0,34,11,6,11,0,5,33,80,51,3.9,1.7,5.7
10/15/14,19,0,2,4,0,25,3,0,8,0,1,12,88,56,3.9,1.7,5.7
10/16/14,25,0,1,5,0,31,4,2,8,0,13,27,86,57,3.9,1.7,5.7
10/17/14,16,0,1,4,0,21,6,1,9,0,5,21,87,61,3.9,1.7,5.7
10/18/14,19,1,4,4,0,28,25,1,8,0,5,39,86,66,3.9,1.7,5.7
10/19/14,16,0,2,7,0,25,28,2,1,0,6,37,82,65,3.9,1.7,5.7
10/20/14,9,0,2,6,0,17,21,0,13,0,6,40,82,63,3.9,1.7,5.7
10/21/14,27,2,1,8,0,38,7,4,4,0,5,20,83,58,3.9,1.7,5.7
10/22/14,20,0,3,6,0,29,13,3,5,0,12,33,83,61,3.9,1.7,5.7
10/23/14,17,1,3,9,0,30,13,2,11,0,5,31,83,66,3.9,1.7,5.7
10/24/14,21,0,2,4,0,27,6,6,10,0,4,26,85,60,3.9,1.7,5.7
10/25/14,20,0,4,9,0,33,15,1,9,0,9,34,88,62,3.9,1.7,5.7
10/26/14,9,0,0,12,0,21,18,4,10,0,7,39,86,61,3.9,1.7,5.7
10/27/14,19,0,1,11,0,31,6,1,4,0,14,25,86,62,3.9,1.7,5.7
10/28/14,28,0,2,4,0,34,3,1,6,0,0,10,84,65,3.9,1.7,5.7
10/29/14,24,0,2,5,0,31,7,1,14,0,4,26,81,65,3.9,1.7,5.7
10/30/14,14,0,4,3,0,21,10,3,5,0,12,30,82,63,3.9,1.7,5.7
10/31/14,18,0,1,2,0,21,5,2,8,0,1,16,76,56,3.9,1.7,5.7
11/1/14,16,0,2,5,0,23,10,3,5,0,2,20,68,47,3.8,1.3,5.8
11/2/14,17,0,3,5,0,25,15,1,5,0,14,35,75,48,3.8,1.3,5.8
11/3/14,25,2,2,10,0,39,11,2,15,0,5,33,76,59,3.8,1.3,5.8
11/4/14,19,0,2,3,0,24,11,5,11,0,12,39,75,58,3.8,1.3,5.8
11/5/14,14,0,2,5,0,21,8,1,6,0,5,20,59,55,3.8,1.3,5.8
11/6/14,15,0,6,5,0,26,8,2,1,0,2,13,63,55,3.8,1.3,5.8
11/7/14,28,0,0,3,0,31,6,2,4,0,23,35,71,48,3.8,1.3,5.8
11/8/14,37,0,1,13,0,51,13,1,10,0,4,28,75,48,3.8,1.3,5.8
11/9/14,16,0,0,2,0,18,12,0,9,0,9,30,74,47,3.8,1.3,5.8
11/10/14,25,1,6,4,0,36,7,5,10,0,0,22,76,49,3.8,1.3,5.8
11/11/14,22,0,2,7,0,31,3,2,9,0,13,27,65,42,3.8,1.3,5.8
11/12/14,15,0,4,4,0,23,12,3,12,0,9,36,51,36,3.8,1.3,5.8
11/13/14,16,0,6,5,0,27,9,1,6,0,5,21,41,31,3.8,1.3,5.8
11/14/14,30,0,0,3,0,33,7,2,10,0,3,22,45,30,3.8,1.3,5.8
11/15/14,17,0,3,2,0,22,16,4,11,0,19,50,48,40,3.8,1.3,5.8
11/16/14,12,0,2,3,0,17,10,0,8,0,4,22,50,34,3.8,1.3,5.8
11/17/14,19,0,2,5,0,26,8,3,6,0,2,19,53,30,3.8,1.3,5.8
11/18/14,16,1,0,8,0,25,10,1,4,0,12,27,56,30,3.8,1.3,5.8
11/19/14,19,2,0,13,0,34,8,1,7,0,2,18,69,33,3.8,1.3,5.8
11/20/14,25,1,1,8,0,35,5,8,12,0,4,29,70,44,3.8,1.3,5.8
11/21/14,33,0,0,7,0,40,16,2,5,0,13,36,74,62,3.8,1.3,5.8
11/22/14,29,0,2,4,0,35,9,2,11,0,5,27,67,58,3.8,1.3,5.8
11/23/14,33,0,3,4,0,40,24,1,12,0,12,49,81,53,3.8,1.3,5.8
11/24/14,15,0,2,3,0,20,9,2,9,0,10,30,66,40,3.8,1.3,5.8
11/25/14,18,0,1,2,0,21,9,2,8,0,7,26,67,38,3.8,1.3,5.8
11/26/14,21,0,3,3,0,27,16,0,8,0,4,28,77,42,3.8,1.3,5.8
11/27/14,5,0,1,1,0,7,2,1,2,0,4,9,64,42,3.8,1.3,5.8
11/28/14,24,1,3,4,0,32,13,2,11,0,4,30,72,42,3.8,1.3,5.8
11/29/14,22,0,0,11,0,33,23,0,6,0,14,43,73,56,3.8,1.3,5.8
11/30/14,15,1,1,8,0,25,18,1,9,0,8,36,79,64,3.8,1.3,5.8
12/1/14,23,0,5,8,0,36,11,2,11,0,6,30,66,41,3.5,0.8,5.6
12/2/14,24,1,1,3,0,29,14,2,10,0,0,26,50,39,3.5,0.8,5.6
12/3/14,23,0,3,7,0,33,7,1,7,0,5,20,59,48,3.5,0.8,5.6
12/4/14,19,0,3,4,0,26,7,2,8,1,42,60,66,58,3.5,0.8,5.6
12/5/14,28,0,1,13,0,42,18,2,11,0,16,47,75,63,3.5,0.8,5.6
12/6/14,19,0,0,6,0,25,36,1,4,0,2,43,69,55,3.5,0.8,5.6
12/7/14,28,1,2,10,0,41,32,1,14,0,15,62,56,52,3.5,0.8,5.6
12/8/14,21,1,2,10,0,34,21,2,7,0,11,41,67,49,3.5,0.8,5.6
12/9/14,18,0,3,2,0,23,14,1,4,0,8,27,69,43,3.5,0.8,5.6
12/10/14,19,0,2,15,0,36,5,4,6,0,12,27,66,47,3.5,0.8,5.6
12/11/14,16,0,0,5,0,21,13,2,7,0,10,32,67,57,3.5,0.8,5.6
12/12/14,29,0,4,3,0,36,7,1,9,0,8,25,71,59,3.5,0.8,5.6
12/13/14,17,1,2,15,0,35,17,1,11,0,2,31,74,55,3.5,0.8,5.6
12/14/14,30,1,1,2,0,34,10,0,7,0,3,20,74,61,3.5,0.8,5.6
12/15/14,29,0,3,5,0,37,13,4,6,1,7,31,74,52,3.5,0.8,5.6
12/16/14,23,0,2,3,0,28,9,1,10,1,3,24,63,46,3.5,0.8,5.6
12/17/14,12,0,10,5,0,27,16,1,16,0,5,38,53,48,3.5,0.8,5.6
12/18/14,25,2,3,5,0,35,13,3,7,0,9,32,60,49,3.5,0.8,5.6
12/19/14,20,0,3,6,0,29,15,1,7,0,7,30,57,48,3.5,0.8,5.6
12/20/14,15,0,0,6,0,21,18,1,10,0,10,39,54,49,3.5,0.8,5.6
12/21/14,15,0,0,5,0,20,9,0,9,1,0,19,56,50,3.5,0.8,5.6
12/22/14,22,1,1,3,0,27,11,4,8,0,2,25,77,56,3.5,0.8,5.6
12/23/14,15,0,1,9,0,25,11,4,1,0,12,28,59,43,3.5,0.8,5.6
12/24/14,13,0,1,5,0,19,14,1,6,0,3,24,57,35,3.5,0.8,5.6
12/25/14,15,0,1,0,0,16,0,2,3,0,0,5,65,33,3.5,0.8,5.6
12/26/14,11,0,0,5,0,16,11,0,11,0,7,29,74,53,3.5,0.8,5.6
12/27/14,20,0,2,3,0,25,18,0,18,0,13,49,66,41,3.5,0.8,5.6
12/28/14,19,1,2,9,0,31,13,0,5,0,5,23,47,32,3.5,0.8,5.6
12/29/14,29,0,1,7,0,37,11,0,5,0,3,19,67,30,3.5,0.8,5.6
12/30/14,18,1,1,7,0,27,16,2,10,0,5,33,46,39,3.5,0.8,5.6
12/31/14,18,1,1,1,0,21,18,1,4,0,3,26,42,36,3.5,0.8,5.6
1/1/15,17,0,0,6,0,23,18,0,10,0,3,31,40,34,3.9,-0.1,5.7
1/2/15,22,0,1,2,0,25,13,0,4,0,6,23,43,38,3.9,-0.1,5.7
1/3/15,16,0,0,10,0,26,20,1,7,0,2,30,62,39,3.9,-0.1,5.7
1/4/15,15,0,1,6,0,22,17,0,7,0,11,35,51,35,3.9,-0.1,5.7
1/5/15,35,0,1,3,0,39,13,0,12,1,6,32,52,29,3.9,-0.1,5.7
1/6/15,28,0,0,6,0,34,9,3,10,0,7,29,71,36,3.9,-0.1,5.7
1/7/15,29,0,2,6,0,37,12,0,5,0,3,20,51,30,3.9,-0.1,5.7
1/8/15,14,0,0,5,0,19,6,0,27,0,2,35,36,23,3.9,-0.1,5.7
1/9/15,12,1,1,2,0,16,6,2,7,0,12,27,38,34,3.9,-0.1,5.7
1/10/15,19,0,2,5,0,26,12,1,1,0,5,19,36,32,3.9,-0.1,5.7
1/11/15,27,0,0,5,0,32,14,0,3,0,3,20,49,34,3.9,-0.1,5.7
1/12/15,14,0,3,7,0,24,15,2,9,0,13,39,46,40,3.9,-0.1,5.7
1/13/15,23,0,1,2,0,26,2,1,7,0,1,11,42,35,3.9,-0.1,5.7
1/14/15,18,0,1,13,0,32,6,1,8,0,5,20,40,38,3.9,-0.1,5.7
1/15/15,13,0,3,9,0,25,7,0,4,0,3,14,59,38,3.9,-0.1,5.7
1/16/15,15,0,5,3,0,23,8,0,6,0,4,18,64,38,3.9,-0.1,5.7
1/17/15,20,0,1,4,0,25,25,2,11,0,0,38,69,39,3.9,-0.1,5.7
1/18/15,23,0,1,10,0,34,33,1,3,0,4,41,72,46,3.9,-0.1,5.7
1/19/15,15,1,2,8,0,26,22,1,4,0,3,30,75,37,3.9,-0.1,5.7
1/20/15,18,1,5,6,0,30,11,3,10,0,14,38,80,41,3.9,-0.1,5.7
1/21/15,16,0,1,10,0,27,11,2,11,0,3,27,56,50,3.9,-0.1,5.7
1/22/15,14,0,2,6,0,22,6,3,14,0,2,25,52,41,3.9,-0.1,5.7
1/23/15,17,0,2,3,0,22,7,0,5,0,5,17,51,38,3.9,-0.1,5.7
1/24/15,27,0,2,2,0,31,11,1,7,0,3,22,63,36,3.9,-0.1,5.7
1/25/15,18,1,1,14,0,34,13,1,7,0,3,24,73,40,3.9,-0.1,5.7
1/26/15,28,0,0,10,0,38,16,2,10,0,3,31,74,46,3.9,-0.1,5.7
1/27/15,22,0,2,8,0,32,14,2,4,0,7,27,83,51,3.9,-0.1,5.7
1/28/15,25,0,5,4,0,34,6,3,7,0,3,19,81,42,3.9,-0.1,5.7
1/29/15,16,0,4,5,0,25,7,2,9,0,4,22,79,52,3.9,-0.1,5.7
1/30/15,24,0,2,9,0,35,16,2,10,0,3,31,58,48,3.9,-0.1,5.7
1/31/15,16,0,2,4,0,22,23,0,4,0,6,33,62,49,3.9,-0.1,5.7
2/1/15,21,0,1,12,0,34,16,0,9,1,8,34,73,44,3.6,0,5.5
2/2/15,15,0,1,4,0,20,15,2,12,0,10,39,49,33,3.6,0,5.5
2/3/15,19,0,0,4,0,23,8,1,12,0,7,28,43,40,3.6,0,5.5
2/4/15,25,0,5,4,0,34,16,0,6,0,10,32,55,42,3.6,0,5.5
2/5/15,13,1,0,7,0,21,12,4,4,0,1,21,52,38,3.6,0,5.5
2/6/15,19,0,3,5,0,27,7,4,5,0,7,23,60,37,3.6,0,5.5
2/7/15,21,1,1,11,0,34,24,0,8,0,6,38,69,40,3.6,0,5.5
2/8/15,16,1,4,3,0,24,23,3,3,0,5,34,78,58,3.6,0,5.5
2/9/15,18,0,1,4,0,23,10,1,12,0,10,33,83,52,3.6,0,5.5
2/10/15,18,0,1,5,0,24,12,1,10,0,5,28,81,46,3.6,0,5.5
2/11/15,22,1,5,8,0,36,9,2,3,0,5,19,78,51,3.6,0,5.5
2/12/15,28,0,4,2,0,34,21,2,9,0,7,39,62,44,3.6,0,5.5
2/13/15,22,0,3,11,0,36,8,3,9,0,7,27,70,39,3.6,0,5.5
2/14/15,16,0,8,5,0,29,23,1,4,0,2,30,78,48,3.6,0,5.5
2/15/15,24,1,0,4,0,29,18,2,7,0,5,32,68,57,3.6,0,5.5
2/16/15,24,0,2,6,0,32,14,1,12,0,2,29,66,36,3.6,0,5.5
2/17/15,14,0,1,8,0,23,14,1,6,0,0,21,55,34,3.6,0,5.5
2/18/15,20,0,2,9,0,31,9,2,9,0,7,27,66,32,3.6,0,5.5
2/19/15,35,0,0,5,0,40,8,3,17,0,4,32,70,38,3.6,0,5.5
2/20/15,22,1,2,7,0,32,11,2,10,0,11,34,75,54,3.6,0,5.5
2/21/15,17,1,3,9,0,30,22,1,4,0,5,32,78,55,3.6,0,5.5
2/22/15,19,0,1,5,0,25,15,2,11,0,6,34,56,37,3.6,0,5.5
2/23/15,20,1,1,6,0,28,15,1,3,0,10,29,37,30,3.6,0,5.5
2/24/15,18,0,3,2,0,23,7,3,6,0,6,22,37,30,3.6,0,5.5
2/25/15,31,0,9,5,0,45,11,0,14,1,2,28,63,35,3.6,0,5.5
2/26/15,20,0,3,8,0,31,5,3,9,0,7,24,52,33,3.6,0,5.5
2/27/15,13,0,1,10,0,24,16,1,6,0,2,25,36,31,3.6,0,5.5
2/28/15,13,0,3,5,0,21,12,1,9,1,3,26,36,31,3.6,0,5.5
3/1/15,7,0,1,2,0,10,20,2,6,0,5,33,43,35,3.4,-0.1,5.4
3/2/15,21,0,3,7,0,31,13,0,7,0,6,26,45,38,3.4,-0.1,5.4
3/3/15,7,0,1,4,0,12,11,0,7,0,1,19,60,41,3.4,-0.1,5.4
3/4/15,18,0,6,10,0,34,9,1,4,0,1,15,70,34,3.4,-0.1,5.4
3/5/15,12,0,2,4,0,18,3,0,7,0,2,12,47,31,3.4,-0.1,5.4
3/6/15,35,0,3,6,0,44,4,3,8,0,10,25,57,26,3.4,-0.1,5.4
3/7/15,27,0,3,4,0,34,15,2,4,0,5,26,60,38,3.4,-0.1,5.4
3/8/15,8,0,2,5,0,15,16,0,2,0,7,25,54,47,3.4,-0.1,5.4
3/9/15,8,0,1,3,0,12,13,0,6,0,2,21,55,49,3.4,-0.1,5.4
3/10/15,28,0,3,4,0,35,13,1,7,0,4,25,63,50,3.4,-0.1,5.4
3/11/15,25,0,2,6,0,33,7,2,10,0,0,19,59,54,3.4,-0.1,5.4
3/12/15,22,0,5,3,0,30,6,1,7,0,3,17,73,52,3.4,-0.1,5.4
3/13/15,24,2,4,9,0,39,12,5,9,0,5,31,78,53,3.4,-0.1,5.4
3/14/15,13,0,1,4,0,18,30,3,7,0,9,49,78,53,3.4,-0.1,5.4
3/15/15,18,0,12,5,0,35,23,3,5,0,3,34,69,51,3.4,-0.1,5.4
3/16/15,14,1,7,4,0,26,12,1,7,0,5,25,77,52,3.4,-0.1,5.4
3/17/15,24,0,3,9,0,36,9,2,10,0,1,22,77,63,3.4,-0.1,5.4
3/18/15,29,0,3,3,0,35,8,0,6,0,1,15,81,60,3.4,-0.1,5.4
3/19/15,26,0,3,4,0,33,5,3,5,0,3,16,83,63,3.4,-0.1,5.4
3/20/15,21,0,3,3,0,27,12,0,9,0,4,25,71,57,3.4,-0.1,5.4
3/21/15,13,0,2,8,0,23,15,1,10,0,0,26,61,55,3.4,-0.1,5.4
3/22/15,21,0,1,5,0,27,15,0,5,0,9,29,78,57,3.4,-0.1,5.4
3/23/15,20,0,1,6,0,27,11,2,14,1,4,32,80,52,3.4,-0.1,5.4
3/24/15,31,0,1,6,0,38,11,0,25,0,4,40,83,59,3.4,-0.1,5.4
3/25/15,29,0,1,2,0,32,10,0,9,1,14,34,84,62,3.4,-0.1,5.4
3/26/15,22,0,2,4,0,28,7,2,11,0,6,26,70,54,3.4,-0.1,5.4
3/27/15,15,0,3,3,0,21,10,3,15,0,1,29,82,46,3.4,-0.1,5.4
3/28/15,18,0,4,3,0,25,14,1,7,0,2,24,84,48,3.4,-0.1,5.4
3/29/15,24,0,1,7,0,32,16,3,7,0,2,28,84,57,3.4,-0.1,5.4
3/30/15,18,1,7,4,0,30,15,2,6,0,10,33,80,64,3.4,-0.1,5.4
3/31/15,14,0,1,2,0,17,5,0,12,2,0,19,82,66,3.4,-0.1,5.4
4/1/15,14,1,3,3,0,21,8,2,13,0,4,27,83,68,3.1,-0.2,5.4
4/2/15,15,1,3,34,0,53,10,1,7,0,31,49,84,68,3.1,-0.2,5.4
4/3/15,16,0,7,10,0,33,11,1,0,1,11,24,86,66,3.1,-0.2,5.4
4/4/15,26,1,2,3,0,32,21,0,4,0,11,36,69,56,3.1,-0.2,5.4
4/5/15,12,0,1,7,0,20,20,1,5,0,7,33,69,59,3.1,-0.2,5.4
4/6/15,18,0,1,4,0,23,15,0,13,0,1,29,85,65,3.1,-0.2,5.4
4/7/15,17,0,3,6,0,26,13,0,11,0,1,25,87,68,3.1,-0.2,5.4
4/8/15,20,0,7,4,0,31,8,0,8,0,11,27,79,69,3.1,-0.2,5.4
4/9/15,21,0,1,3,0,25,9,0,11,0,4,24,87,70,3.1,-0.2,5.4
4/10/15,27,0,1,6,0,34,6,4,8,0,14,32,74,56,3.1,-0.2,5.4
4/11/15,23,0,1,5,0,29,13,0,7,0,4,24,70,59,3.1,-0.2,5.4
4/12/15,16,0,7,8,0,31,9,1,15,0,8,33,82,67,3.1,-0.2,5.4
4/13/15,23,0,4,4,0,31,10,3,12,0,9,34,87,64,3.1,-0.2,5.4
4/14/15,15,0,4,6,0,25,7,2,9,0,1,19,77,57,3.1,-0.2,5.4
4/15/15,15,1,1,4,0,21,5,1,6,0,5,17,83,54,3.1,-0.2,5.4
4/16/15,20,0,4,7,0,31,4,0,6,0,6,16,81,67,3.1,-0.2,5.4
4/17/15,19,0,6,12,0,37,9,1,9,0,2,21,75,66,3.1,-0.2,5.4
4/18/15,21,0,3,5,0,29,13,1,6,0,4,24,77,54,3.1,-0.2,5.4
4/19/15,12,0,5,6,0,23,19,4,5,0,9,37,89,57,3.1,-0.2,5.4
4/20/15,28,3,1,5,0,37,4,3,11,0,7,25,73,54,3.1,-0.2,5.4
4/21/15,22,0,3,5,0,30,12,4,19,0,5,40,81,51,3.1,-0.2,5.4
4/22/15,27,0,1,5,0,33,11,2,10,0,2,25,81,67,3.1,-0.2,5.4
4/23/15,14,0,1,9,0,24,6,5,8,0,3,22,85,68,3.1,-0.2,5.4
4/24/15,28,0,5,15,0,48,4,2,16,0,7,29,85,69,3.1,-0.2,5.4
4/25/15,18,0,1,3,0,22,24,0,6,0,6,36,93,70,3.1,-0.2,5.4
4/26/15,19,0,3,5,0,27,13,1,15,0,1,30,86,69,3.1,-0.2,5.4
4/27/15,20,0,1,4,0,25,9,1,10,0,5,25,85,63,3.1,-0.2,5.4
4/28/15,28,0,7,2,0,37,11,0,10,0,9,30,65,53,3.1,-0.2,5.4
4/29/15,23,0,5,8,0,36,12,3,8,0,7,30,77,49,3.1,-0.2,5.4
4/30/15,16,0,2,7,0,25,12,1,2,0,4,19,83,50,3.1,-0.2,5.4
5/1/15,24,0,2,4,0,30,6,5,10,0,8,29,84,55,3.3,0,5.6
5/2/15,21,0,7,0,0,28,34,0,13,0,1,48,83,58,3.3,0,5.6
5/3/15,10,0,3,7,0,20,35,0,9,1,8,53,84,58,3.3,0,5.6
5/4/15,24,0,1,10,0,35,11,6,9,0,4,30,84,66,3.3,0,5.6
5/5/15,14,0,2,5,0,21,22,1,10,0,5,38,83,66,3.3,0,5.6
5/6/15,30,0,2,2,0,34,7,1,20,0,1,29,87,71,3.3,0,5.6
5/7/15,21,0,3,5,0,29,7,5,8,0,5,25,83,73,3.3,0,5.6
5/8/15,18,0,1,4,0,23,17,1,8,0,0,26,79,73,3.3,0,5.6
5/9/15,23,0,3,6,0,32,18,0,10,0,4,32,85,72,3.3,0,5.6
5/10/15,18,0,1,5,0,24,24,0,10,0,8,42,87,76,3.3,0,5.6
5/11/15,27,0,0,4,0,31,8,1,9,0,3,21,79,68,3.3,0,5.6
5/12/15,25,0,2,6,0,33,6,2,13,0,13,34,69,65,3.3,0,5.6
5/13/15,18,0,2,5,0,25,5,0,6,0,4,15,70,64,3.3,0,5.6
5/14/15,31,1,4,7,0,43,8,4,14,0,3,29,87,68,3.3,0,5.6
5/15/15,26,0,3,4,0,33,6,4,10,2,9,31,77,67,3.3,0,5.6
5/16/15,27,0,3,11,0,41,13,0,14,0,4,31,87,67,3.3,0,5.6
5/17/15,28,0,2,6,0,36,12,3,17,0,5,37,84,66,3.3,0,5.6
5/18/15,32,0,1,6,0,39,12,0,8,0,8,28,88,73,3.3,0,5.6
5/19/15,21,0,2,12,0,35,10,2,7,0,7,26,89,74,3.3,0,5.6
5/20/15,20,0,4,6,0,30,9,3,19,0,11,42,89,72,3.3,0,5.6
5/21/15,26,0,1,1,0,28,15,2,12,0,5,34,76,62,3.3,0,5.6
5/22/15,29,0,0,5,0,34,12,3,9,0,3,27,77,62,3.3,0,5.6
5/23/15,27,0,4,5,0,36,23,0,10,0,8,41,87,66,3.3,0,5.6
5/24/15,31,0,4,3,0,38,20,2,6,0,3,31,82,64,3.3,0,5.6
5/25/15,23,0,3,3,0,29,28,5,14,0,5,52,82,66,3.3,0,5.6
5/26/15,14,0,3,0,0,17,12,2,14,0,19,47,89,66,3.3,0,5.6
5/27/15,32,0,5,9,0,46,13,1,11,0,27,52,85,67,3.3,0,5.6
5/28/15,38,0,2,4,0,44,11,4,13,0,13,41,87,69,3.3,0,5.6
5/29/15,20,0,10,7,0,37,11,0,20,0,14,45,89,64,3.3,0,5.6
5/30/15,24,0,2,3,0,29,18,2,10,0,2,32,88,70,3.3,0,5.6
5/31/15,17,0,2,9,0,28,16,1,8,0,11,36,86,67,3.3,0,5.6
6/1/15,28,1,6,7,0,42,17,1,12,0,2,32,88,64,3.6,0.1,5.3
6/2/15,28,0,7,5,0,40,5,3,5,0,3,16,90,67,3.6,0.1,5.3
6/3/15,35,0,1,10,0,46,8,2,19,0,3,32,89,67,3.6,0.1,5.3
6/4/15,15,0,3,14,0,32,10,1,10,1,8,30,88,68,3.6,0.1,5.3
6/5/15,34,0,2,6,0,42,7,2,11,0,20,40,90,69,3.6,0.1,5.3
6/6/15,25,0,2,6,0,33,13,0,6,0,3,22,90,70,3.6,0.1,5.3
6/7/15,26,1,1,5,0,33,32,0,8,1,5,46,91,70,3.6,0.1,5.3
6/8/15,19,0,1,8,0,28,10,0,4,0,5,19,93,71,3.6,0.1,5.3
6/9/15,16,0,3,6,0,25,13,2,10,0,1,26,95,72,3.6,0.1,5.3
6/10/15,8,0,3,6,0,17,8,2,5,0,4,19,93,72,3.6,0.1,5.3
6/11/15,20,0,5,3,0,28,15,2,3,0,9,29,94,73,3.6,0.1,5.3
6/12/15,20,1,8,0,0,29,11,3,7,0,6,27,93,75,3.6,0.1,5.3
6/13/15,19,0,8,9,0,36,13,0,11,0,11,35,95,75,3.6,0.1,5.3
6/14/15,26,0,3,3,0,32,13,0,7,0,0,20,86,72,3.6,0.1,5.3
6/15/15,16,0,6,9,0,31,16,1,8,1,3,29,89,74,3.6,0.1,5.3
6/16/15,21,0,5,2,0,28,8,1,10,0,2,21,83,73,3.6,0.1,5.3
6/17/15,19,0,4,4,0,27,8,3,6,0,2,19,89,72,3.6,0.1,5.3
6/18/15,28,0,5,3,0,36,8,0,14,0,9,31,90,73,3.6,0.1,5.3
6/19/15,28,0,2,11,0,41,10,0,10,0,27,47,84,71,3.6,0.1,5.3
6/20/15,28,0,1,4,0,33,17,1,11,0,13,42,83,72,3.6,0.1,5.3
6/21/15,32,0,1,5,0,38,17,2,10,1,11,41,86,72,3.6,0.1,5.3
6/22/15,24,0,7,10,0,41,9,1,7,0,1,18,89,72,3.6,0.1,5.3
6/23/15,26,0,2,6,0,34,16,1,17,0,5,39,92,75,3.6,0.1,5.3
6/24/15,14,0,3,3,0,20,12,2,8,0,16,38,92,74,3.6,0.1,5.3
6/25/15,21,0,3,2,0,26,16,4,7,0,4,31,93,73,3.6,0.1,5.3
6/26/15,24,1,10,5,0,40,14,2,3,1,7,27,93,76,3.6,0.1,5.3
6/27/15,27,0,0,9,0,36,14,1,5,0,3,23,91,74,3.6,0.1,5.3
6/28/15,32,0,2,8,0,42,24,2,9,1,2,38,91,73,3.6,0.1,5.3
6/29/15,31,1,1,4,0,37,15,3,14,0,19,51,93,74,3.6,0.1,5.3
6/30/15,25,0,2,14,0,41,11,2,5,1,14,33,94,73,3.6,0.1,5.3
7/1/15,15,0,1,2,0,18,13,1,7,0,12,33,91,71,3.7,0.2,5.2
7/2/15,23,1,0,3,0,27,13,0,9,0,17,39,91,70,3.7,0.2,5.2
7/3/15,13,0,0,4,0,17,15,3,5,0,6,29,91,76,3.7,0.2,5.2
7/4/15,29,0,2,0,0,31,7,2,5,1,0,15,92,76,3.7,0.2,5.2
7/5/15,24,0,5,2,0,31,23,2,12,1,2,40,91,76,3.7,0.2,5.2
7/6/15,30,0,3,2,0,35,14,3,12,0,9,38,91,77,3.7,0.2,5.2
7/7/15,20,0,3,8,0,31,10,1,11,0,2,24,91,78,3.7,0.2,5.2
7/8/15,23,0,2,5,0,30,16,0,6,0,9,31,91,78,3.7,0.2,5.2
7/9/15,19,2,5,5,0,31,14,4,6,0,5,29,93,76,3.7,0.2,5.2
7/10/15,14,0,6,5,0,25,10,2,8,0,8,28,94,74,3.7,0.2,5.2
7/11/15,36,0,3,1,0,40,12,0,7,0,5,24,93,73,3.7,0.2,5.2
7/12/15,23,0,1,2,0,26,12,1,9,0,1,23,94,74,3.7,0.2,5.2
7/13/15,20,0,2,3,0,25,11,2,8,0,9,30,96,75,3.7,0.2,5.2
7/14/15,16,0,1,4,0,21,8,2,6,0,7,23,97,74,3.7,0.2,5.2
7/15/15,21,1,4,3,0,29,10,3,10,0,8,31,95,75,3.7,0.2,5.2
7/16/15,4,0,3,7,0,14,8,2,8,1,4,23,95,74,3.7,0.2,5.2
7/17/15,21,0,2,5,0,28,13,1,8,0,3,25,96,76,3.7,0.2,5.2
7/18/15,19,0,2,3,0,24,10,0,8,1,5,24,98,77,3.7,0.2,5.2
7/19/15,15,0,3,2,0,20,14,0,9,0,11,34,97,76,3.7,0.2,5.2
7/20/15,24,0,6,5,0,35,11,0,8,0,6,25,97,74,3.7,0.2,5.2
7/21/15,14,1,2,5,0,22,12,2,10,1,7,32,97,75,3.7,0.2,5.2
7/22/15,11,0,1,3,0,15,11,0,6,0,5,22,97,77,3.7,0.2,5.2
7/23/15,14,0,2,11,0,27,12,1,10,0,7,30,99,77,3.7,0.2,5.2
7/24/15,11,0,4,3,0,18,12,3,13,0,2,30,99,77,3.7,0.2,5.2
7/25/15,13,0,0,2,0,15,16,2,1,0,5,24,98,75,3.7,0.2,5.2
7/26/15,13,0,3,4,0,20,19,0,10,0,2,31,98,76,3.7,0.2,5.2
7/27/15,29,1,1,5,0,36,13,1,4,0,3,21,100,77,3.7,0.2,5.2
7/28/15,18,1,3,4,0,26,11,1,5,0,7,24,100,77,3.7,0.2,5.2
7/29/15,28,1,5,2,0,36,8,1,3,0,13,25,101,76,3.7,0.2,5.2
7/30/15,12,0,6,5,0,23,5,0,12,0,3,20,101,75,3.7,0.2,5.2
7/31/15,14,0,2,3,0,19,16,1,1,0,15,33,102,78,3.7,0.2,5.2
8/1/15,29,0,2,6,0,37,24,0,3,0,4,31,99,73,3.4,0.2,5.1
8/2/15,12,1,0,3,0,16,27,2,5,1,2,37,100,75,3.4,0.2,5.1
8/3/15,19,1,1,5,0,26,7,2,1,1,11,22,99,75,3.4,0.2,5.1
8/4/15,31,1,0,4,0,36,12,1,18,0,4,35,100,77,3.4,0.2,5.1
8/5/15,23,0,3,9,0,35,7,0,6,0,2,15,101,78,3.4,0.2,5.1
8/6/15,16,0,3,3,0,22,10,0,5,0,3,18,102,77,3.4,0.2,5.1
8/7/15,12,0,0,6,0,18,10,1,6,1,8,26,101,76,3.4,0.2,5.1
8/8/15,18,1,3,5,0,27,18,2,3,0,5,28,102,78,3.4,0.2,5.1
8/9/15,15,0,1,4,0,20,22,0,8,0,7,37,103,76,3.4,0.2,5.1
8/10/15,18,0,1,7,0,26,11,0,8,0,3,22,104,75,3.4,0.2,5.1
8/11/15,17,1,1,3,0,22,8,2,6,0,9,25,105,75,3.4,0.2,5.1
8/12/15,15,1,4,4,0,24,8,3,6,0,7,24,105,79,3.4,0.2,5.1
8/13/15,15,1,3,8,0,27,12,3,10,0,13,38,104,78,3.4,0.2,5.1
8/14/15,19,0,6,3,0,28,11,2,10,0,9,32,101,78,3.4,0.2,5.1
8/15/15,22,0,3,4,0,29,13,2,3,0,2,20,98,79,3.4,0.2,5.1
8/16/15,28,0,0,4,0,32,15,0,4,0,0,19,98,75,3.4,0.2,5.1
8/17/15,17,0,0,6,0,23,9,1,8,0,1,19,98,74,3.4,0.2,5.1
8/18/15,9,0,4,4,0,17,8,0,13,0,6,27,99,76,3.4,0.2,5.1
8/19/15,20,0,3,4,0,27,7,0,5,1,11,24,99,78,3.4,0.2,5.1
8/20/15,25,0,2,5,0,32,9,1,9,1,0,20,84,73,3.4,0.2,5.1
8/21/15,14,0,2,3,0,19,8,0,5,0,4,17,92,72,3.4,0.2,5.1
8/22/15,36,0,1,7,0,44,11,0,5,0,2,18,99,75,3.4,0.2,5.1
8/23/15,22,0,2,6,0,30,17,0,6,0,1,24,101,76,3.4,0.2,5.1
8/24/15,21,0,0,4,0,25,13,0,12,0,2,27,101,76,3.4,0.2,5.1
8/25/15,22,0,2,6,0,30,8,0,10,2,22,42,101,77,3.4,0.2,5.1
8/26/15,19,0,1,5,0,25,13,0,6,0,5,24,98,73,3.4,0.2,5.1
8/27/15,21,0,5,4,0,30,10,1,9,0,8,28,98,74,3.4,0.2,5.1
8/28/15,12,0,3,2,0,17,12,3,14,0,9,38,98,72,3.4,0.2,5.1
8/29/15,19,0,4,2,0,25,22,1,8,0,5,36,95,71,3.4,0.2,5.1
8/30/15,17,0,6,3,0,26,17,1,5,0,5,28,96,75,3.4,0.2,5.1
8/31/15,13,0,3,5,0,21,13,0,5,0,12,30,97,74,3.4,0.2,5.1
9/1/15,12,0,4,9,0,25,12,0,11,0,6,29,94,74,3.4,0,5
9/2/15,24,0,1,1,0,26,7,0,4,0,6,17,95,71,3.4,0,5
9/3/15,13,0,3,7,0,23,6,1,12,1,6,26,94,73,3.4,0,5
9/4/15,25,0,1,4,0,30,11,2,12,1,3,29,100,75,3.4,0,5
9/5/15,19,0,1,4,0,24,12,2,3,0,3,20,101,79,3.4,0,5
9/6/15,22,0,1,7,0,30,17,0,7,0,6,30,100,76,3.4,0,5
9/7/15,25,0,2,6,0,33,19,0,7,0,8,34,100,76,3.4,0,5
9/8/15,15,0,11,5,0,31,12,1,3,0,6,22,99,76,3.4,0,5
9/9/15,22,1,2,3,0,28,9,2,6,0,12,29,93,74,3.4,0,5
9/10/15,13,0,0,7,0,20,10,2,7,0,13,32,96,72,3.4,0,5
9/11/15,21,0,4,8,0,33,12,0,12,0,5,29,93,75,3.4,0,5
9/12/15,40,0,0,8,0,48,14,0,10,0,9,33,91,69,3.4,0,5
9/13/15,21,0,1,4,0,26,24,1,10,0,5,40,91,63,3.4,0,5
9/14/15,24,0,1,4,0,29,4,2,5,0,14,25,90,64,3.4,0,5
9/15/15,13,0,3,7,0,23,6,2,6,0,9,23,95,73,3.4,0,5
9/16/15,26,0,2,6,0,34,8,3,6,1,4,22,93,75,3.4,0,5
9/17/15,12,0,2,4,0,18,16,1,7,0,20,44,96,75,3.4,0,5
9/18/15,18,0,3,2,0,23,10,1,11,0,10,32,96,75,3.4,0,5
9/19/15,21,0,2,9,0,32,21,0,12,1,5,39,96,74,3.4,0,5
9/20/15,8,0,0,8,0,16,16,1,3,0,7,27,95,69,3.4,0,5
9/21/15,16,0,3,7,0,26,10,0,8,0,12,30,95,73,3.4,0,5
9/22/15,10,1,3,0,0,14,11,2,3,0,3,19,97,70,3.4,0,5
9/23/15,10,0,3,9,0,22,12,0,8,0,5,25,94,68,3.4,0,5
9/24/15,12,0,0,4,0,16,9,0,4,0,0,13,95,69,3.4,0,5
9/25/15,14,0,2,3,0,19,7,0,5,0,3,15,96,72,3.4,0,5
9/26/15,32,0,0,7,0,39,8,0,11,0,13,32,95,68,3.4,0,5
9/27/15,14,0,0,2,0,16,28,0,5,0,3,36,95,67,3.4,0,5
9/28/15,19,0,1,4,0,24,8,1,6,0,1,16,89,69,3.4,0,5
9/29/15,15,0,1,4,0,20,9,1,9,1,7,27,94,67,3.4,0,5
9/30/15,24,0,2,10,0,36,8,0,10,0,3,21,95,70,3.4,0,5
10/1/15,16,0,3,2,0,21,6,0,4,0,2,12,94,69,3.3,0.2,5
10/2/15,22,0,2,2,0,26,7,0,9,0,3,19,89,67,3.3,0.2,5
10/3/15,25,1,1,9,0,36,6,1,6,0,1,14,87,56,3.3,0.2,5
10/4/15,16,1,2,3,0,22,16,1,4,0,0,21,87,59,3.3,0.2,5
10/5/15,22,0,2,3,0,27,8,0,14,0,7,29,85,67,3.3,0.2,5
10/6/15,29,0,4,7,0,40,10,0,6,0,11,27,90,63,3.3,0.2,5
10/7/15,23,0,2,7,0,32,7,0,10,0,14,31,91,62,3.3,0.2,5
10/8/15,22,0,3,6,0,31,6,2,10,0,8,26,91,68,3.3,0.2,5
10/9/15,12,0,6,4,0,22,10,0,6,0,3,19,88,72,3.3,0.2,5
10/10/15,12,0,0,1,0,13,14,0,8,0,14,36,90,67,3.3,0.2,5
10/11/15,21,0,3,10,0,34,18,0,12,0,2,32,95,64,3.3,0.2,5
10/12/15,15,0,1,2,0,18,14,0,10,0,22,46,99,72,3.3,0.2,5
10/13/15,14,0,2,4,0,20,11,1,8,0,15,35,94,64,3.3,0.2,5
10/14/15,16,0,3,4,0,23,6,0,1,1,3,11,96,60,3.3,0.2,5
10/15/15,18,0,0,7,0,25,6,2,8,0,3,19,95,63,3.3,0.2,5
10/16/15,14,0,4,5,0,23,10,0,10,0,6,26,90,62,3.3,0.2,5
10/17/15,14,1,1,5,0,21,24,1,7,0,1,33,88,62,3.3,0.2,5
10/18/15,17,0,1,9,0,27,29,0,7,0,5,41,84,57,3.3,0.2,5
10/19/15,25,0,0,5,0,30,13,1,10,0,4,28,86,54,3.3,0.2,5
10/20/15,14,0,0,3,0,17,7,0,13,0,1,21,87,58,3.3,0.2,5
10/21/15,11,0,3,4,0,18,7,1,7,0,4,19,86,72,3.3,0.2,5
10/22/15,13,0,1,7,0,21,8,1,5,0,2,16,82,70,3.3,0.2,5
10/23/15,17,0,4,5,0,26,7,0,3,0,5,15,80,71,3.3,0.2,5
10/24/15,26,0,1,0,0,27,19,1,7,0,0,27,76,60,3.3,0.2,5
10/25/15,27,1,3,5,0,36,15,1,12,0,3,31,64,57,3.3,0.2,5
10/26/15,31,1,4,2,0,38,3,3,13,0,3,22,79,58,3.3,0.2,5
10/27/15,22,0,1,11,0,34,10,0,13,0,5,28,84,58,3.3,0.2,5
10/28/15,18,0,1,4,0,23,8,0,6,0,10,24,82,58,3.3,0.2,5
10/29/15,18,0,1,14,0,33,14,0,9,0,3,26,81,51,3.3,0.2,5
10/30/15,25,0,21,1,0,47,2,0,3,0,0,5,75,67,3.3,0.2,5
10/31/15,35,0,4,3,0,42,17,0,16,0,14,47,77,65,3.3,0.2,5
11/1/15,29,0,0,5,0,34,9,0,25,0,11,45,75,59,3.2,0.5,5.1
11/2/15,23,0,2,10,0,35,3,0,23,0,5,31,79,57,3.2,0.5,5.1
11/3/15,34,0,4,3,0,41,12,0,12,0,5,29,80,57,3.2,0.5,5.1
11/4/15,25,0,2,9,0,36,8,0,18,1,2,29,78,61,3.2,0.5,5.1
11/5/15,23,0,4,3,0,30,10,0,14,0,13,37,85,72,3.2,0.5,5.1
11/6/15,31,0,4,4,0,39,6,2,12,0,6,26,76,59,3.2,0.5,5.1
11/7/15,16,0,0,6,0,22,15,0,5,0,4,24,63,56,3.2,0.5,5.1
11/8/15,22,0,1,3,0,26,17,2,7,0,7,33,71,53,3.2,0.5,5.1
11/9/15,21,2,1,2,0,26,9,2,11,0,10,32,73,52,3.2,0.5,5.1
11/10/15,19,0,3,2,0,24,9,0,13,0,5,27,74,60,3.2,0.5,5.1
11/11/15,25,0,4,5,0,34,9,0,7,0,2,18,85,69,3.2,0.5,5.1
11/12/15,27,0,4,4,0,35,10,1,9,0,3,23,71,56,3.2,0.5,5.1
11/13/15,20,0,3,5,0,28,7,1,23,0,12,43,65,56,3.2,0.5,5.1
11/14/15,19,0,3,3,0,25,14,0,14,0,2,30,65,54,3.2,0.5,5.1
11/15/15,28,0,3,3,0,34,16,0,10,0,12,38,70,54,3.2,0.5,5.1
11/16/15,15,0,1,7,0,23,2,0,14,0,8,24,75,65,3.2,0.5,5.1
11/17/15,22,0,0,4,0,26,13,0,8,0,5,26,75,47,3.2,0.5,5.1
11/18/15,35,0,1,2,0,38,10,0,9,0,3,22,72,43,3.2,0.5,5.1
11/19/15,20,0,0,4,0,24,9,0,11,0,2,22,79,46,3.2,0.5,5.1
11/20/15,18,0,2,6,0,26,13,0,10,0,12,35,77,52,3.2,0.5,5.1
11/21/15,24,0,0,7,0,31,18,0,2,0,2,22,66,41,3.2,0.5,5.1
11/22/15,19,0,1,5,0,25,17,0,6,0,4,27,59,34,3.2,0.5,5.1
11/23/15,12,0,3,7,0,22,13,0,8,0,15,36,63,32,3.2,0.5,5.1
11/24/15,24,0,4,1,0,29,10,0,4,0,3,17,64,47,3.2,0.5,5.1
11/25/15,24,0,9,2,0,35,11,0,21,0,5,37,74,62,3.2,0.5,5.1
11/26/15,7,0,0,0,0,7,1,1,4,0,2,8,74,68,3.2,0.5,5.1
11/27/15,27,0,2,6,0,35,20,1,14,0,5,40,74,41,3.2,0.5,5.1
11/28/15,24,0,1,1,0,26,14,1,8,0,7,30,44,39,3.2,0.5,5.1
11/29/15,18,0,0,5,0,23,15,1,8,1,1,26,47,42,3.2,0.5,5.1
11/30/15,19,0,3,4,0,26,13,2,9,0,20,44,55,45,3.2,0.5,5.1
12/1/15,34,1,0,1,0,36,6,4,9,0,4,23,59,46,3,0.7,5
12/2/15,23,1,1,5,0,30,7,2,11,0,4,24,68,42,3,0.7,5
12/3/15,23,2,2,7,0,34,1,0,5,1,13,20,63,40,3,0.7,5
12/4/15,5,0,1,9,0,15,5,0,8,0,7,20,63,37,3,0.7,5
12/5/15,12,0,1,6,0,19,10,0,9,0,0,19,65,37,3,0.7,5
12/6/15,15,0,0,4,0,19,14,0,7,0,8,29,70,44,3,0.7,5
12/7/15,29,0,2,11,0,42,13,1,5,0,9,28,69,44,3,0.7,5
12/8/15,17,0,0,3,0,20,11,2,10,0,8,31,75,42,3,0.7,5
12/9/15,26,0,3,3,0,32,2,0,6,0,1,9,76,47,3,0.7,5
12/10/15,13,0,10,2,0,25,5,2,11,0,5,23,78,51,3,0.7,5
12/11/15,22,1,1,3,0,27,8,0,7,1,3,19,79,52,3,0.7,5
12/12/15,17,0,2,1,0,20,15,1,12,0,2,30,75,70,3,0.7,5
12/13/15,17,0,0,3,0,20,25,1,11,0,4,41,74,46,3,0.7,5
12/14/15,10,0,4,8,0,22,11,0,6,0,2,19,75,42,3,0.7,5
12/15/15,17,0,1,3,0,21,9,1,10,0,7,27,75,53,3,0.7,5
12/16/15,37,0,2,3,0,42,10,0,8,0,3,21,63,46,3,0.7,5
12/17/15,31,1,1,6,0,39,20,0,6,0,3,29,68,39,3,0.7,5
12/18/15,14,0,1,5,0,20,14,1,6,0,1,22,58,34,3,0.7,5
12/19/15,17,0,1,5,0,23,15,0,6,0,13,34,66,36,3,0.7,5
12/20/15,23,0,1,4,0,28,17,0,10,0,4,31,67,51,3,0.7,5
12/21/15,22,0,2,9,0,33,13,0,10,0,5,28,76,54,3,0.7,5
12/22/15,13,1,0,2,0,16,24,1,10,0,3,38,79,49,3,0.7,5
12/23/15,14,0,1,4,0,19,18,1,8,0,0,27,81,53,3,0.7,5
12/24/15,8,0,1,0,0,9,12,0,9,0,1,22,74,52,3,0.7,5
12/25/15,8,0,2,1,0,11,20,0,15,1,7,43,70,51,3,0.7,5
12/26/15,35,0,3,4,0,42,11,0,8,0,13,32,78,70,3,0.7,5
12/27/15,13,0,2,2,0,17,10,0,12,0,8,30,73,36,3,0.7,5
12/28/15,21,0,2,0,0,23,15,0,9,0,2,26,46,36,3,0.7,5
12/29/15,17,0,2,7,0,26,5,5,12,0,3,25,49,37,3,0.7,5
12/30/15,14,0,2,3,0,19,15,0,8,0,5,28,57,41,3,0.7,5
12/31/15,19,0,4,4,0,27,1,0,4,0,7,12,53,39,3,0.7,5
1/1/16,31,0,3,0,0,34,12,0,11,0,8,31,48,44,3.3,1.4,4.8
1/2/16,31,0,2,8,0,41,12,0,10,1,1,24,47,42,3.3,1.4,4.8
1/3/16,14,0,1,5,0,20,9,0,14,0,13,36,62,41,3.3,1.4,4.8
1/4/16,22,0,2,3,0,27,13,0,8,0,8,29,58,37,3.3,1.4,4.8
1/5/16,13,0,2,4,0,19,8,1,17,0,12,38,56,36,3.3,1.4,4.8
1/6/16,23,0,2,4,0,29,9,1,8,0,11,29,53,46,3.3,1.4,4.8
1/7/16,19,0,0,3,0,22,9,0,6,0,3,18,73,49,3.3,1.4,4.8
1/8/16,21,0,3,3,0,27,19,0,2,0,3,24,66,44,3.3,1.4,4.8
1/9/16,16,0,2,4,0,22,16,0,13,0,4,33,58,38,3.3,1.4,4.8
1/10/16,29,0,0,5,0,34,13,1,6,0,0,20,50,33,3.3,1.4,4.8
1/11/16,20,1,2,9,0,32,15,0,13,0,6,34,56,34,3.3,1.4,4.8
1/12/16,15,0,1,4,0,20,10,0,10,1,6,27,66,34,3.3,1.4,4.8
1/13/16,29,0,4,5,0,38,8,0,9,0,1,18,66,38,3.3,1.4,4.8
1/14/16,14,1,2,6,0,23,15,0,5,0,3,23,70,47,3.3,1.4,4.8
1/15/16,20,0,4,4,0,28,18,2,4,0,20,44,70,48,3.3,1.4,4.8
1/16/16,41,1,1,4,0,47,16,2,11,1,9,39,64,43,3.3,1.4,4.8
1/17/16,20,0,2,5,0,27,18,0,7,0,15,40,57,32,3.3,1.4,4.8
1/18/16,19,0,4,3,0,26,5,0,12,0,8,25,59,36,3.3,1.4,4.8
1/19/16,11,0,2,13,0,26,13,0,6,0,7,26,69,43,3.3,1.4,4.8
1/20/16,18,0,1,5,0,24,12,0,4,0,8,24,57,45,3.3,1.4,4.8
1/21/16,15,0,5,5,0,25,12,0,8,0,8,28,64,43,3.3,1.4,4.8
1/22/16,21,1,1,8,0,31,17,1,6,0,7,31,54,37,3.3,1.4,4.8
1/23/16,21,0,2,3,0,26,20,0,6,0,1,27,57,31,3.3,1.4,4.8
1/24/16,16,0,3,2,0,21,10,0,5,0,20,35,70,35,3.3,1.4,4.8
1/25/16,13,0,1,7,0,21,8,1,12,0,1,22,75,56,3.3,1.4,4.8
1/26/16,18,0,0,0,0,18,7,1,8,0,5,21,58,43,3.3,1.4,4.8
1/27/16,25,0,1,8,0,34,10,0,5,0,6,21,59,36,3.3,1.4,4.8
1/28/16,20,0,9,1,0,30,4,0,9,0,8,21,71,32,3.3,1.4,4.8
1/29/16,12,0,4,2,0,18,13,0,9,0,1,23,76,38,3.3,1.4,4.8
1/30/16,25,0,0,6,0,31,12,1,6,0,8,27,77,46,3.3,1.4,4.8
1/31/16,16,1,6,3,0,26,8,1,9,0,2,20,86,58,3.3,1.4,4.8
2/1/16,13,0,4,5,0,22,7,0,6,0,16,29,77,54,3.2,1,4.9
2/2/16,12,0,15,2,0,29,7,1,9,0,3,20,72,51,3.2,1,4.9
2/3/16,30,0,0,3,0,33,12,1,6,0,1,20,58,39,3.2,1,4.9
2/4/16,12,0,1,9,0,22,11,1,2,1,8,23,59,34,3.2,1,4.9
2/5/16,11,0,4,9,0,24,22,0,6,0,3,31,62,33,3.2,1,4.9
2/6/16,10,0,3,4,0,17,15,0,9,0,9,33,61,39,3.2,1,4.9
2/7/16,13,0,2,7,0,22,14,0,7,0,4,25,68,32,3.2,1,4.9
2/8/16,8,0,1,4,0,13,8,0,3,1,2,14,65,46,3.2,1,4.9
2/9/16,16,0,7,8,0,31,12,0,4,0,4,20,74,39,3.2,1,4.9
2/10/16,16,0,1,10,0,27,16,0,4,0,4,24,74,38,3.2,1,4.9
2/11/16,18,0,2,10,0,30,12,2,13,0,2,29,83,52,3.2,1,4.9
2/12/16,16,0,2,7,0,25,32,0,7,0,0,39,79,47,3.2,1,4.9
2/13/16,33,0,2,3,0,38,22,0,16,0,1,39,75,52,3.2,1,4.9
2/14/16,13,0,1,1,0,15,24,1,7,0,15,47,75,57,3.2,1,4.9
2/15/16,22,0,1,9,0,32,6,2,14,0,10,32,74,50,3.2,1,4.9
2/16/16,17,0,2,6,0,25,0,0,6,0,4,10,82,43,3.2,1,4.9
2/17/16,13,0,1,2,0,16,16,3,4,0,0,23,75,50,3.2,1,4.9
2/18/16,20,0,0,14,0,34,10,0,7,0,4,21,79,54,3.2,1,4.9
2/19/16,22,0,1,5,0,28,16,1,11,0,3,31,81,64,3.2,1,4.9
2/20/16,37,1,2,6,0,46,16,0,9,0,8,33,76,66,3.2,1,4.9
2/21/16,13,0,0,7,0,20,9,0,11,1,7,28,71,65,3.2,1,4.9
2/22/16,17,0,3,8,0,28,15,0,7,0,1,23,72,57,3.2,1,4.9
2/23/16,26,0,4,4,0,34,14,1,13,0,5,33,61,47,3.2,1,4.9
2/24/16,21,0,3,19,0,43,10,2,13,0,2,27,65,42,3.2,1,4.9
2/25/16,23,0,1,9,0,33,11,0,11,1,2,25,69,38,3.2,1,4.9
2/26/16,28,0,4,12,0,44,20,0,5,0,1,26,64,41,3.2,1,4.9
2/27/16,18,0,0,8,0,26,16,0,10,2,16,44,73,42,3.2,1,4.9
2/28/16,24,0,0,10,0,34,13,0,11,0,6,30,78,55,3.2,1,4.9
2/29/16,11,0,2,6,0,19,9,1,10,0,15,35,77,62,3.2,1,4.9
3/1/16,27,0,0,6,0,33,14,4,9,0,7,34,81,59,3.2,0.9,5
3/2/16,28,2,4,5,0,39,11,0,8,0,13,32,78,49,3.2,0.9,5
3/3/16,12,0,1,6,0,19,8,0,6,0,0,14,83,62,3.2,0.9,5
3/4/16,19,0,0,1,0,20,24,0,11,0,0,35,76,45,3.2,0.9,5
3/5/16,19,0,6,3,0,28,14,2,3,0,11,30,79,57,3.2,0.9,5
3/6/16,10,0,5,14,0,29,7,0,14,0,9,30,77,58,3.2,0.9,5
3/7/16,17,0,0,3,0,20,17,3,8,0,7,35,76,64,3.2,0.9,5
3/8/16,22,0,6,9,0,37,11,0,12,0,1,24,83,68,3.2,0.9,5
3/9/16,22,0,2,1,0,25,4,1,7,0,3,15,71,59,3.2,0.9,5
3/10/16,30,0,3,4,0,37,9,0,7,0,6,22,64,58,3.2,0.9,5
3/11/16,20,0,3,7,0,30,15,0,10,0,1,26,71,59,3.2,0.9,5
3/12/16,26,0,2,8,0,36,13,0,9,0,2,24,74,57,3.2,0.9,5
3/13/16,17,0,1,3,0,21,12,1,19,0,6,38,85,56,3.2,0.9,5
3/14/16,23,0,3,5,0,31,14,1,5,0,4,24,92,54,3.2,0.9,5
3/15/16,12,0,3,2,0,17,13,0,9,0,2,24,92,67,3.2,0.9,5
3/16/16,17,0,5,6,0,28,16,1,4,0,5,26,81,61,3.2,0.9,5
3/17/16,21,0,0,4,0,25,8,0,7,0,4,19,79,67,3.2,0.9,5
3/18/16,18,0,2,13,0,33,8,1,7,0,7,23,79,56,3.2,0.9,5
3/19/16,18,0,5,5,0,28,19,2,12,0,13,46,62,47,3.2,0.9,5
3/20/16,18,0,1,9,0,28,12,0,7,0,4,23,64,42,3.2,0.9,5
3/21/16,12,0,5,8,0,25,7,3,5,0,11,26,68,35,3.2,0.9,5
3/22/16,16,0,5,6,0,27,6,4,10,1,3,24,78,45,3.2,0.9,5
3/23/16,14,0,6,8,0,28,15,0,10,0,4,29,82,65,3.2,0.9,5
3/24/16,20,0,1,13,0,34,12,0,9,0,1,22,70,48,3.2,0.9,5
3/25/16,15,0,3,8,0,26,30,2,4,0,7,43,73,41,3.2,0.9,5
3/26/16,15,0,2,7,0,24,10,1,16,0,8,35,74,48,3.2,0.9,5
3/27/16,17,0,5,4,0,26,11,0,11,0,10,32,74,56,3.2,0.9,5
3/28/16,23,0,3,7,0,33,18,0,13,0,2,33,75,48,3.2,0.9,5
3/29/16,17,0,1,7,0,25,7,0,7,0,3,17,69,58,3.2,0.9,5
3/30/16,21,0,2,5,0,28,3,0,11,1,2,17,77,68,3.2,0.9,5
3/31/16,17,0,3,3,0,23,8,0,10,0,2,20,86,66,3.2,0.9,5
4/1/16,18,0,0,1,0,19,17,0,3,0,6,26,66,51,2.9,1.1,5.1
4/2/16,19,0,3,4,0,26,20,1,9,0,0,30,74,45,2.9,1.1,5.1
4/3/16,21,0,2,5,0,28,13,0,10,0,5,28,79,44,2.9,1.1,5.1
4/4/16,16,0,0,5,0,21,14,1,8,0,4,27,83,53,2.9,1.1,5.1
4/5/16,19,0,4,3,0,26,8,1,8,0,6,23,82,53,2.9,1.1,5.1
4/6/16,12,0,1,0,0,13,14,0,5,0,7,26,82,55,2.9,1.1,5.1
4/7/16,9,0,1,11,0,21,8,0,7,0,1,16,85,48,2.9,1.1,5.1
4/8/16,14,0,5,6,0,25,17,0,11,0,4,32,80,55,2.9,1.1,5.1
4/9/16,25,0,2,6,0,33,12,0,6,0,5,23,77,58,2.9,1.1,5.1
4/10/16,13,1,3,4,0,21,12,1,15,0,9,37,79,65,2.9,1.1,5.1
4/11/16,24,0,3,8,0,35,6,0,12,0,1,19,89,70,2.9,1.1,5.1
4/12/16,21,1,0,5,0,27,3,0,6,0,3,12,73,62,2.9,1.1,5.1
4/13/16,17,0,2,6,0,25,13,1,5,0,1,20,72,58,2.9,1.1,5.1
4/14/16,17,0,2,5,0,24,10,0,11,0,6,27,77,54,2.9,1.1,5.1
4/15/16,24,0,8,5,0,37,20,0,4,0,5,29,79,54,2.9,1.1,5.1
4/16/16,21,0,1,9,0,31,14,0,4,0,9,27,75,64,2.9,1.1,5.1
4/17/16,13,0,5,2,0,20,10,0,9,0,33,52,78,64,2.9,1.1,5.1
4/18/16,19,0,2,5,0,26,5,2,10,0,1,18,75,63,2.9,1.1,5.1
4/19/16,18,0,4,8,0,30,10,1,12,1,2,26,81,62,2.9,1.1,5.1
4/20/16,28,0,0,5,0,33,8,0,15,0,3,26,81,60,2.9,1.1,5.1
4/21/16,13,0,3,10,0,26,10,0,13,1,0,24,83,60,2.9,1.1,5.1
4/22/16,41,0,1,4,0,46,11,0,11,0,1,23,84,60,2.9,1.1,5.1
4/23/16,20,0,2,5,0,27,14,0,10,0,2,26,83,55,2.9,1.1,5.1
4/24/16,12,0,4,6,0,22,7,1,7,0,14,29,79,63,2.9,1.1,5.1
4/25/16,16,0,2,7,0,25,11,0,11,0,5,27,88,70,2.9,1.1,5.1
4/26/16,16,0,1,5,0,22,11,0,11,0,4,26,86,72,2.9,1.1,5.1
4/27/16,16,0,1,4,0,21,11,1,8,0,2,22,90,62,2.9,1.1,5.1
4/28/16,22,0,6,3,0,31,10,0,9,0,3,22,87,63,2.9,1.1,5.1
4/29/16,19,0,3,5,0,27,17,4,9,0,2,32,84,75,2.9,1.1,5.1
4/30/16,36,0,1,6,0,43,17,0,13,0,1,31,86,66,2.9,1.1,5.1
5/1/16,17,0,1,9,0,27,8,0,12,0,3,23,78,66,2.9,1,4.8
5/2/16,25,0,4,6,0,35,12,0,12,0,3,27,70,57,2.9,1,4.8
5/3/16,20,0,2,7,0,29,13,1,12,0,4,30,78,55,2.9,1,4.8
5/4/16,20,0,3,8,0,31,7,1,7,0,1,16,87,54,2.9,1,4.8
5/5/16,18,0,5,2,0,25,8,2,13,0,2,25,89,59,2.9,1,4.8
5/6/16,21,0,1,3,0,25,24,0,9,0,6,39,86,56,2.9,1,4.8
5/7/16,19,0,1,8,0,28,15,0,12,1,5,33,85,60,2.9,1,4.8
5/8/16,19,0,2,1,0,22,17,1,12,0,13,43,73,67,2.9,1,4.8
5/9/16,27,0,0,7,0,34,12,1,7,1,7,28,87,67,2.9,1,4.8
5/10/16,24,1,3,4,0,32,4,1,13,1,9,28,91,66,2.9,1,4.8
5/11/16,39,0,1,9,0,49,11,0,11,0,3,25,87,65,2.9,1,4.8
5/12/16,43,0,5,3,0,51,7,1,9,0,3,20,84,68,2.9,1,4.8
5/13/16,24,0,3,6,0,33,18,0,13,0,4,35,87,71,2.9,1,4.8
5/14/16,32,0,2,6,0,40,18,1,9,0,3,31,81,63,2.9,1,4.8
5/15/16,26,0,3,2,0,31,10,1,8,0,11,30,72,62,2.9,1,4.8
5/16/16,24,0,0,5,0,29,12,0,8,0,5,25,80,67,2.9,1,4.8
5/17/16,40,0,2,11,0,53,11,0,20,1,3,35,82,65,2.9,1,4.8
5/18/16,29,0,5,8,0,42,5,0,12,1,21,39,78,64,2.9,1,4.8
5/19/16,19,0,4,3,0,26,9,2,13,0,2,26,76,61,2.9,1,4.8
5/20/16,21,0,3,11,0,35,23,0,4,0,21,48,83,62,2.9,1,4.8
5/21/16,40,0,1,5,0,46,27,2,3,0,8,40,83,70,2.9,1,4.8
5/22/16,20,0,2,6,0,28,13,0,15,0,13,41,87,72,2.9,1,4.8
5/23/16,36,0,0,10,0,46,19,0,13,0,3,35,85,71,2.9,1,4.8
5/24/16,17,0,3,2,0,22,12,1,6,2,7,28,87,74,2.9,1,4.8
5/25/16,29,1,6,11,0,47,14,3,9,1,8,35,86,77,2.9,1,4.8
5/26/16,27,0,2,11,0,40,11,0,8,0,14,33,90,68,2.9,1,4.8
5/27/16,11,0,2,0,0,13,16,0,15,0,3,34,77,65,2.9,1,4.8
5/28/16,14,0,1,1,0,16,20,0,5,0,1,26,91,65,2.9,1,4.8
5/29/16,14,0,1,2,0,17,18,0,2,0,13,33,88,70,2.9,1,4.8
5/30/16,26,0,3,6,0,35,11,1,7,0,12,31,89,66,2.9,1,4.8
5/31/16,28,0,1,4,0,33,3,0,9,0,9,21,82,67,2.9,1,4.8
6/1/16,62,0,1,6,0,69,11,1,18,1,5,36,87,68,3.5,1,4.9
6/2/16,15,0,1,22,0,38,14,0,5,1,9,29,84,68,3.5,1,4.9
6/3/16,17,0,1,6,0,24,21,1,6,2,10,40,85,65,3.5,1,4.9
6/4/16,11,0,1,3,0,15,22,1,8,0,2,33,86,67,3.5,1,4.9
6/5/16,28,0,0,6,0,34,21,0,6,1,2,30,88,68,3.5,1,4.9
6/6/16,36,0,0,5,0,41,8,2,8,0,6,24,90,70,3.5,1,4.9
6/7/16,24,0,3,5,0,32,3,0,6,0,7,16,92,69,3.5,1,4.9
6/8/16,29,0,2,1,0,32,16,0,8,0,8,32,92,70,3.5,1,4.9
6/9/16,17,0,1,6,0,24,20,1,10,0,9,40,92,71,3.5,1,4.9
6/10/16,14,0,5,3,0,22,27,4,4,0,2,37,91,69,3.5,1,4.9
6/11/16,11,0,1,8,0,20,18,0,3,0,1,22,93,76,3.5,1,4.9
6/12/16,11,0,2,7,0,20,10,2,2,0,3,17,94,77,3.5,1,4.9
6/13/16,13,0,5,7,0,25,16,0,6,0,2,24,94,76,3.5,1,4.9
6/14/16,22,0,9,13,0,44,8,0,4,0,0,12,94,78,3.5,1,4.9
6/15/16,19,0,7,2,0,28,17,2,4,0,2,25,96,78,3.5,1,4.9
6/16/16,11,0,2,7,0,20,10,0,4,0,8,22,96,75,3.5,1,4.9
6/17/16,11,0,3,3,0,17,25,0,8,0,5,38,97,76,3.5,1,4.9
6/18/16,16,0,1,9,0,26,26,1,4,0,2,33,96,76,3.5,1,4.9
6/19/16,21,0,2,4,0,27,23,0,8,0,6,37,94,77,3.5,1,4.9
6/20/16,25,0,4,0,0,29,11,0,10,0,14,35,95,75,3.5,1,4.9
6/21/16,16,0,1,7,0,24,14,3,14,0,1,32,96,75,3.5,1,4.9
6/22/16,20,0,0,6,0,26,6,0,8,0,4,18,96,76,3.5,1,4.9
6/23/16,15,0,3,2,0,20,8,0,6,0,4,18,95,75,3.5,1,4.9
6/24/16,20,0,6,5,0,31,17,0,7,0,5,29,93,75,3.5,1,4.9
6/25/16,21,0,4,7,0,32,21,0,8,0,9,38,88,77,3.5,1,4.9
6/26/16,17,0,2,6,0,25,9,1,7,0,2,19,95,76,3.5,1,4.9
6/27/16,26,0,1,4,0,31,15,1,8,0,8,32,96,75,3.5,1,4.9
6/28/16,21,0,3,4,0,28,10,0,12,0,6,28,101,72,3.5,1,4.9
6/29/16,19,0,0,3,0,22,13,0,3,0,6,22,96,71,3.5,1,4.9
6/30/16,22,0,2,4,0,28,5,0,8,0,4,17,94,76,3.5,1,4.9
7/1/16,26,0,2,3,0,31,7,0,5,0,1,13,96,74,3.6,0.8,4.8
7/2/16,18,0,2,2,0,22,15,1,5,0,2,23,98,76,3.6,0.8,4.8
7/3/16,20,0,1,0,0,21,10,0,7,0,9,26,98,78,3.6,0.8,4.8
7/4/16,11,0,1,2,0,14,17,0,8,0,16,41,99,80,3.6,0.8,4.8
7/5/16,27,0,4,3,0,34,12,1,7,0,7,27,99,79,3.6,0.8,4.8
7/6/16,22,0,1,3,0,26,17,0,6,0,3,26,100,79,3.6,0.8,4.8
7/7/16,23,0,6,2,0,31,3,1,5,0,3,12,99,79,3.6,0.8,4.8
7/8/16,14,0,1,3,0,18,21,0,8,0,3,32,100,79,3.6,0.8,4.8
7/9/16,20,0,0,2,0,22,12,1,9,0,2,24,99,78,3.6,0.8,4.8
7/10/16,20,0,2,5,0,27,9,1,8,0,5,23,97,77,3.6,0.8,4.8
7/11/16,18,0,2,5,0,25,15,2,5,0,6,28,100,79,3.6,0.8,4.8
7/12/16,16,0,0,3,0,19,13,0,7,0,6,26,100,77,3.6,0.8,4.8
7/13/16,15,0,6,4,0,25,12,0,7,0,4,23,101,80,3.6,0.8,4.8
7/14/16,17,0,2,7,0,26,3,0,11,0,6,20,101,77,3.6,0.8,4.8
7/15/16,15,0,3,12,0,30,16,0,8,0,4,28,101,78,3.6,0.8,4.8
7/16/16,17,0,5,6,0,28,13,0,2,0,9,24,100,76,3.6,0.8,4.8
7/17/16,17,0,0,5,0,22,11,1,2,0,12,26,99,76,3.6,0.8,4.8
7/18/16,8,0,0,2,0,10,9,0,4,0,10,23,99,78,3.6,0.8,4.8
7/19/16,17,0,1,4,0,22,12,1,9,0,2,24,100,77,3.6,0.8,4.8
7/20/16,16,0,2,2,0,20,29,1,8,0,1,39,101,77,3.6,0.8,4.8
7/21/16,17,0,0,6,0,23,31,1,7,0,0,39,101,76,3.6,0.8,4.8
7/22/16,19,0,0,5,0,24,31,0,5,0,0,36,102,76,3.6,0.8,4.8
7/23/16,32,0,0,7,0,39,42,0,6,0,2,50,101,78,3.6,0.8,4.8
7/24/16,12,0,1,8,0,21,19,0,8,0,6,33,101,78,3.6,0.8,4.8
7/25/16,12,0,2,6,0,20,17,0,10,0,2,29,102,76,3.6,0.8,4.8
7/26/16,22,0,4,2,0,28,14,0,8,0,2,24,93,75,3.6,0.8,4.8
7/27/16,31,0,5,3,0,39,12,0,5,1,5,23,92,74,3.6,0.8,4.8
7/28/16,23,0,4,6,0,33,7,0,11,0,6,24,97,75,3.6,0.8,4.8
7/29/16,16,0,0,4,0,20,18,1,5,0,3,27,96,74,3.6,0.8,4.8
7/30/16,13,0,1,4,0,18,29,0,4,0,2,35,97,76,3.6,0.8,4.8
7/31/16,19,0,5,3,0,27,19,0,6,0,4,29,98,78,3.6,0.8,4.8
8/1/16,15,0,1,4,0,20,12,0,2,1,1,16,99,75,3.5,1.1,4.9
8/2/16,12,0,2,1,0,15,17,1,6,0,2,26,98,75,3.5,1.1,4.9
8/3/16,18,0,2,6,0,26,9,0,8,0,3,20,99,76,3.5,1.1,4.9
8/4/16,20,0,4,5,0,29,6,0,8,1,1,16,99,76,3.5,1.1,4.9
8/5/16,11,0,2,8,0,21,8,1,4,0,2,15,100,77,3.5,1.1,4.9
8/6/16,22,0,1,5,0,28,16,1,10,0,1,28,100,77,3.5,1.1,4.9
8/7/16,14,0,3,9,0,26,14,1,12,0,1,28,100,77,3.5,1.1,4.9
8/8/16,21,0,2,6,0,29,11,0,9,0,7,27,100,78,3.5,1.1,4.9
8/9/16,22,0,2,7,0,31,12,0,7,0,2,21,102,79,3.5,1.1,4.9
8/10/16,18,0,4,6,0,28,9,0,1,0,5,15,102,81,3.5,1.1,4.9
8/11/16,19,0,6,3,0,28,10,0,3,0,6,19,102,78,3.5,1.1,4.9
8/12/16,12,0,2,5,0,19,9,0,4,1,4,18,105,79,3.5,1.1,4.9
8/13/16,18,0,0,2,0,20,7,1,6,0,2,16,96,77,3.5,1.1,4.9
8/14/16,18,0,0,4,0,22,12,0,6,0,2,20,84,71,3.5,1.1,4.9
8/15/16,41,0,3,4,0,48,17,1,10,0,6,34,76,71,3.5,1.1,4.9
8/16/16,21,0,2,6,0,29,14,0,10,0,15,39,83,71,3.5,1.1,4.9
8/17/16,21,0,7,1,0,29,20,1,6,0,2,29,84,75,3.5,1.1,4.9
8/18/16,20,0,2,4,0,26,20,0,10,0,4,34,88,74,3.5,1.1,4.9
8/19/16,19,0,3,5,0,27,18,0,5,1,2,26,93,75,3.5,1.1,4.9
8/20/16,27,0,1,5,0,33,16,0,11,0,0,27,83,73,3.5,1.1,4.9
8/21/16,18,0,1,14,0,33,10,0,10,0,10,30,82,73,3.5,1.1,4.9
8/22/16,22,0,3,3,0,28,10,0,5,0,5,20,91,75,3.5,1.1,4.9
8/23/16,13,0,3,4,0,20,22,0,4,0,3,29,94,77,3.5,1.1,4.9
8/24/16,19,0,1,2,0,22,8,0,7,0,16,31,93,76,3.5,1.1,4.9
8/25/16,19,0,1,4,0,24,7,0,9,0,13,29,94,74,3.5,1.1,4.9
8/26/16,22,0,2,5,0,29,21,0,5,0,3,29,93,75,3.5,1.1,4.9
8/27/16,21,0,3,2,0,26,18,1,8,0,4,31,92,72,3.5,1.1,4.9
8/28/16,21,0,2,5,0,28,12,1,9,0,2,24,92,73,3.5,1.1,4.9
8/29/16,15,0,4,2,0,21,11,0,6,0,3,20,91,73,3.5,1.1,4.9
8/30/16,17,0,1,2,0,20,6,0,2,0,2,10,92,73,3.5,1.1,4.9
8/31/16,15,0,0,2,0,17,15,1,6,0,4,26,94,74,3.5,1.1,4.9
9/1/16,19,0,1,5,0,25,13,0,12,0,1,26,96,75,3.5,1.5,5
9/2/16,17,0,4,8,0,29,19,0,5,0,1,25,92,75,3.5,1.5,5
9/3/16,21,0,5,18,0,44,39,0,5,1,3,48,92,73,3.5,1.5,5
9/4/16,11,0,6,5,0,22,12,0,7,0,3,22,93,75,3.5,1.5,5
9/5/16,25,0,0,5,0,30,11,0,15,0,5,31,94,73,3.5,1.5,5
9/6/16,23,0,1,15,0,39,13,0,7,0,1,21,95,77,3.5,1.5,5
9/7/16,13,0,0,5,0,18,16,1,15,0,4,36,96,78,3.5,1.5,5
9/8/16,23,0,3,4,0,30,11,0,10,0,11,32,95,77,3.5,1.5,5
9/9/16,12,0,3,5,0,20,16,0,7,0,1,24,95,77,3.5,1.5,5
9/10/16,26,0,3,4,0,33,20,1,6,0,3,30,93,71,3.5,1.5,5
9/11/16,17,0,2,9,0,28,15,0,9,0,13,37,93,69,3.5,1.5,5
9/12/16,13,0,3,3,0,19,11,1,12,0,8,32,93,70,3.5,1.5,5
9/13/16,13,1,4,5,0,23,9,3,4,0,2,18,94,74,3.5,1.5,5
9/14/16,18,0,3,4,0,25,7,0,4,0,6,17,92,76,3.5,1.5,5
9/15/16,22,0,1,4,0,27,7,0,9,1,1,18,94,72,3.5,1.5,5
9/16/16,15,0,1,3,0,19,15,0,5,0,5,25,95,75,3.5,1.5,5
9/17/16,29,0,2,4,0,35,13,0,4,0,4,21,96,74,3.5,1.5,5
9/18/16,8,0,0,7,0,15,10,0,13,0,2,25,98,75,3.5,1.5,5
9/19/16,25,0,2,5,0,32,12,1,5,1,7,26,99,76,3.5,1.5,5
9/20/16,13,0,1,8,0,22,18,1,8,0,7,34,99,75,3.5,1.5,5
9/21/16,19,0,3,6,0,28,14,0,6,0,7,27,96,75,3.5,1.5,5
9/22/16,18,0,3,3,0,24,12,3,7,0,7,29,94,70,3.5,1.5,5
9/23/16,12,0,2,6,0,20,22,0,8,0,8,38,93,76,3.5,1.5,5
9/24/16,17,0,1,3,0,21,17,0,7,0,3,27,97,77,3.5,1.5,5
9/25/16,31,0,3,6,0,40,10,0,11,0,10,31,88,70,3.5,1.5,5
9/26/16,23,0,1,4,0,28,2,0,6,0,6,14,73,67,3.5,1.5,5
9/27/16,22,0,1,1,0,24,10,0,13,0,3,26,80,67,3.5,1.5,5
9/28/16,25,0,4,3,0,32,7,0,3,0,13,23,89,65,3.5,1.5,5
9/29/16,14,0,0,7,0,21,14,0,8,0,4,26,86,63,3.5,1.5,5
9/30/16,14,0,2,3,0,19,26,0,10,0,5,41,83,60,3.5,1.5,5
10/1/16,27,0,4,4,0,35,11,0,8,0,3,22,80,59,3.3,1.6,4.9
10/2/16,20,0,2,3,0,25,12,0,15,0,6,33,85,58,3.3,1.6,4.9
10/3/16,33,0,0,4,0,37,11,2,9,1,1,24,87,62,3.3,1.6,4.9
10/4/16,5,0,10,4,0,19,15,0,8,0,2,25,91,70,3.3,1.6,4.9
10/5/16,10,0,2,2,0,14,18,0,1,0,4,23,92,75,3.3,1.6,4.9
10/6/16,5,0,2,1,0,8,25,0,4,0,1,30,92,76,3.3,1.6,4.9
10/7/16,11,0,2,4,0,17,20,0,5,0,4,29,89,63,3.3,1.6,4.9
10/8/16,33,0,2,1,0,36,22,1,9,0,2,34,86,61,3.3,1.6,4.9
10/9/16,21,0,1,5,0,27,10,0,11,0,5,26,84,58,3.3,1.6,4.9
10/10/16,21,0,3,4,0,28,7,0,8,1,2,18,84,52,3.3,1.6,4.9
10/11/16,15,0,2,6,0,23,11,0,6,0,1,18,88,53,3.3,1.6,4.9
10/12/16,16,0,4,5,0,25,4,0,8,0,5,17,91,61,3.3,1.6,4.9
10/13/16,21,0,2,2,0,25,11,0,10,0,2,23,89,68,3.3,1.6,4.9
10/14/16,12,0,3,9,0,24,14,1,9,0,2,26,87,67,3.3,1.6,4.9
10/15/16,20,0,3,3,0,26,20,0,4,0,2,26,91,71,3.3,1.6,4.9
10/16/16,27,0,1,8,0,36,8,0,12,1,7,28,94,75,3.3,1.6,4.9
10/17/16,17,0,1,7,0,25,10,2,11,0,12,35,94,74,3.3,1.6,4.9
10/18/16,7,0,3,13,0,23,10,0,3,0,10,23,93,75,3.3,1.6,4.9
10/19/16,18,0,4,2,0,24,11,1,10,0,9,31,92,75,3.3,1.6,4.9
10/20/16,14,0,1,5,0,20,7,2,6,0,3,18,83,65,3.3,1.6,4.9
10/21/16,23,0,7,13,0,43,9,0,6,2,3,20,77,53,3.3,1.6,4.9
10/22/16,23,0,3,5,0,31,20,0,4,0,7,31,80,47,3.3,1.6,4.9
10/23/16,18,0,0,4,0,22,7,0,9,0,11,27,84,55,3.3,1.6,4.9
10/24/16,9,0,1,10,0,20,8,1,8,1,3,21,86,67,3.3,1.6,4.9
10/25/16,15,0,3,1,0,19,11,1,5,0,6,23,86,67,3.3,1.6,4.9
10/26/16,17,0,3,4,0,24,8,0,3,0,6,17,87,64,3.3,1.6,4.9
10/27/16,9,0,1,4,0,14,7,0,5,1,6,19,88,64,3.3,1.6,4.9
10/28/16,11,0,1,5,0,17,13,0,4,0,3,20,86,61,3.3,1.6,4.9
10/29/16,9,0,1,6,0,16,11,0,2,0,3,16,86,64,3.3,1.6,4.9
10/30/16,6,0,1,3,0,10,12,0,6,0,4,22,87,65,3.3,1.6,4.9
10/31/16,21,0,0,6,0,27,9,2,8,0,2,21,86,60,3.3,1.6,4.9
11/1/16,18,0,2,5,0,25,9,0,7,1,6,23,91,71,3.2,1.7,4.7
11/2/16,26,0,5,1,0,32,8,0,9,0,4,21,88,73,3.2,1.7,4.7
11/3/16,16,0,3,1,0,20,20,1,8,0,14,43,80,68,3.2,1.7,4.7
11/4/16,36,0,2,7,0,45,16,0,8,0,2,26,73,68,3.2,1.7,4.7
11/5/16,17,0,3,8,0,28,16,0,12,0,6,34,72,63,3.2,1.7,4.7
11/6/16,20,0,2,7,0,29,13,0,5,0,5,23,76,59,3.2,1.7,4.7
11/7/16,22,0,4,1,0,27,12,0,5,0,8,25,71,61,3.2,1.7,4.7
11/8/16,23,0,3,4,0,30,3,0,11,0,0,14,69,62,3.2,1.7,4.7
11/9/16,23,0,3,1,0,27,10,1,6,0,6,23,65,60,3.2,1.7,4.7
11/10/16,35,0,2,8,0,45,7,2,11,0,10,30,71,56,3.2,1.7,4.7
11/11/16,20,0,0,5,0,25,18,0,12,0,2,32,74,55,3.2,1.7,4.7
11/12/16,15,0,2,5,0,22,18,0,15,0,3,36,77,57,3.2,1.7,4.7
11/13/16,21,0,0,4,0,25,10,1,12,0,13,36,76,54,3.2,1.7,4.7
11/14/16,21,0,4,3,0,28,6,0,9,0,11,26,82,56,3.2,1.7,4.7
11/15/16,16,0,7,6,0,29,6,0,6,0,1,13,86,59,3.2,1.7,4.7
11/16/16,15,0,1,6,0,22,5,0,16,0,2,23,86,55,3.2,1.7,4.7
11/17/16,24,0,0,4,0,28,15,0,18,0,1,34,82,58,3.2,1.7,4.7
11/18/16,13,0,6,2,0,21,15,0,12,0,6,33,79,52,3.2,1.7,4.7
11/19/16,19,0,2,9,0,30,13,0,11,1,2,27,63,41,3.2,1.7,4.7
11/20/16,24,0,0,3,0,27,11,0,11,0,2,24,67,35,3.2,1.7,4.7
11/21/16,20,0,0,3,0,23,10,1,9,0,5,25,77,44,3.2,1.7,4.7
11/22/16,15,0,1,5,0,21,7,0,4,1,6,18,76,62,3.2,1.7,4.7
11/23/16,15,0,6,2,0,23,0,0,2,0,0,2,73,51,3.2,1.7,4.7
11/24/16,0,0,1,2,0,3,32,0,7,0,5,44,76,46,3.2,1.7,4.7
11/25/16,19,0,2,3,0,24,36,0,16,0,12,64,66,55,3.2,1.7,4.7
11/26/16,24,0,5,9,0,38,27,2,6,0,0,35,70,53,3.2,1.7,4.7
11/27/16,25,0,4,6,0,35,19,1,10,0,6,36,76,56,3.2,1.7,4.7
11/28/16,22,0,0,8,0,30,14,2,11,0,8,35,79,51,3.2,1.7,4.7
11/29/16,16,0,7,2,0,25,9,1,6,0,7,23,79,49,3.2,1.7,4.7
11/30/16,21,0,3,4,0,28,7,0,7,0,0,14,67,42,3.2,1.7,4.7
12/1/16,12,0,1,8,0,21,7,0,3,0,2,12,69,37,3.2,2.1,4.7
12/2/16,16,1,2,1,0,20,6,0,8,0,6,20,64,51,3.2,2.1,4.7
12/3/16,31,0,2,4,0,37,15,0,8,0,4,27,52,49,3.2,2.1,4.7
12/4/16,20,0,2,1,0,23,7,1,7,0,5,20,53,49,3.2,2.1,4.7
12/5/16,19,1,4,13,0,37,6,2,10,0,3,21,52,47,3.2,2.1,4.7
12/6/16,19,0,2,8,0,29,18,1,16,0,3,38,58,43,3.2,2.1,4.7
12/7/16,23,0,6,8,0,37,14,1,13,0,2,30,56,39,3.2,2.1,4.7
12/8/16,26,0,2,6,0,34,8,0,12,0,6,26,52,36,3.2,2.1,4.7
12/9/16,25,0,1,12,0,38,22,0,8,1,8,39,46,33,3.2,2.1,4.7
12/10/16,20,0,1,4,0,25,18,0,9,0,6,33,52,35,3.2,2.1,4.7
12/11/16,17,0,0,8,0,25,10,1,8,0,18,37,67,50,3.2,2.1,4.7
12/12/16,13,0,0,5,0,18,20,0,7,0,1,28,67,46,3.2,2.1,4.7
12/13/16,11,0,2,4,0,17,11,1,7,0,4,23,77,50,3.2,2.1,4.7
12/14/16,16,0,1,4,0,21,14,1,6,0,1,22,57,43,3.2,2.1,4.7
12/15/16,16,0,3,6,0,25,10,1,6,0,1,18,54,45,3.2,2.1,4.7
12/16/16,26,0,1,6,0,33,18,0,6,1,3,28,67,51,3.2,2.1,4.7
12/17/16,21,0,1,8,0,30,21,0,5,0,7,33,76,34,3.2,2.1,4.7
12/18/16,12,0,2,10,0,24,8,2,9,0,0,19,37,26,3.2,2.1,4.7
12/19/16,28,0,1,9,0,38,21,0,7,1,6,35,45,23,3.2,2.1,4.7
12/20/16,10,0,2,4,0,16,16,0,3,0,1,20,59,35,3.2,2.1,4.7
12/21/16,13,0,2,3,0,18,13,1,0,0,13,27,71,43,3.2,2.1,4.7
12/22/16,9,0,2,6,0,17,12,0,8,0,6,26,68,50,3.2,2.1,4.7
12/23/16,13,0,6,3,0,22,21,0,4,0,0,25,68,52,3.2,2.1,4.7
12/24/16,8,0,3,2,0,13,1,0,0,0,0,1,78,65,3.2,2.1,4.7
12/25/16,3,0,0,0,0,3,14,0,6,0,3,23,80,68,3.2,2.1,4.7
12/26/16,44,0,1,2,0,47,15,0,16,0,2,33,84,70,3.2,2.1,4.7
12/27/16,12,0,1,8,0,21,10,2,7,0,5,24,76,62,3.2,2.1,4.7
12/28/16,28,0,2,1,0,31,9,0,26,0,8,43,83,62,3.2,2.1,4.7
12/29/16,27,0,5,3,0,35,25,0,4,1,9,39,70,49,3.2,2.1,4.7
12/30/16,16,0,15,4,0,35,25,0,9,0,3,37,55,49,3.2,2.1,4.7
12/31/16,18,0,1,4,0,23,2,0,7,1,0,10,77,51,3.2,2.1,4.7
1/1/17,19,0,3,1,0,23,24,0,16,0,1,41,75,53,3.6,2.5,4.7
1/2/17,34,0,2,2,0,38,15,0,11,0,3,29,74,52,3.6,2.5,4.7
1/3/17,33,0,7,3,0,43,0,0,2,0,0,2,76,44,3.6,2.5,4.7
1/4/17,15,0,0,0,0,15,9,1,9,0,10,29,50,38,3.6,2.5,4.7
1/5/17,18,0,0,2,0,20,17,0,14,0,3,34,63,34,3.6,2.5,4.7
1/6/17,15,0,1,3,0,19,17,0,13,0,3,33,34,23,3.6,2.5,4.7
1/7/17,15,0,1,4,0,20,17,0,6,0,4,27,44,19,3.6,2.5,4.7
1/8/17,22,0,1,5,0,28,10,1,9,0,2,22,53,21,3.6,2.5,4.7
1/9/17,18,0,1,4,0,23,15,0,9,0,6,30,71,43,3.6,2.5,4.7
1/10/17,16,0,3,3,0,22,7,0,5,1,2,15,79,59,3.6,2.5,4.7
1/11/17,15,0,0,4,0,19,15,0,9,0,9,33,80,59,3.6,2.5,4.7
1/12/17,17,0,2,11,0,30,13,0,10,0,3,26,81,67,3.6,2.5,4.7
1/13/17,15,0,1,3,0,19,16,0,5,3,7,31,78,56,3.6,2.5,4.7
1/14/17,25,0,1,7,0,33,13,0,12,0,11,36,56,47,3.6,2.5,4.7
1/15/17,15,0,3,6,0,24,12,2,16,0,6,36,73,51,3.6,2.5,4.7
1/16/17,21,0,1,3,0,25,9,0,5,0,4,18,70,58,3.6,2.5,4.7
1/17/17,10,0,3,6,0,19,13,1,5,0,17,36,59,48,3.6,2.5,4.7
1/18/17,22,0,1,8,0,31,8,0,8,0,6,22,56,47,3.6,2.5,4.7
1/19/17,17,0,2,4,0,23,9,0,6,0,3,18,71,52,3.6,2.5,4.7
1/20/17,23,0,0,1,0,24,5,0,6,0,1,12,76,47,3.6,2.5,4.7
1/21/17,29,0,3,10,0,42,19,0,8,0,4,31,81,48,3.6,2.5,4.7
1/22/17,32,0,1,5,0,38,15,1,12,0,5,33,70,53,3.6,2.5,4.7
1/23/17,21,0,0,5,0,26,18,0,6,0,5,29,76,46,3.6,2.5,4.7
1/24/17,13,0,0,10,0,23,9,0,11,0,2,22,84,50,3.6,2.5,4.7
1/25/17,24,0,2,8,0,34,12,0,13,0,5,30,69,48,3.6,2.5,4.7
1/26/17,19,0,1,6,0,26,8,0,5,0,4,17,59,40,3.6,2.5,4.7
1/27/17,16,0,1,17,0,34,44,0,7,0,1,52,58,38,3.6,2.5,4.7
1/28/17,12,0,1,13,0,26,50,0,4,1,2,57,61,39,3.6,2.5,4.7
1/29/17,13,0,2,10,0,25,11,1,1,0,10,23,70,40,3.6,2.5,4.7
1/30/17,18,0,1,11,0,30,19,0,3,0,2,24,79,47,3.6,2.5,4.7
1/31/17,15,0,1,7,0,23,10,0,4,0,2,16,78,44,3.6,2.5,4.7
2/1/17,12,0,6,2,0,20,12,0,11,0,2,25,82,51,3.6,2.7,4.6
2/2/17,17,0,4,10,0,31,17,1,13,0,7,38,64,46,3.6,2.7,4.6
2/3/17,29,0,0,6,0,35,16,0,10,0,4,30,53,45,3.6,2.7,4.6
2/4/17,24,0,1,10,0,35,18,0,6,0,4,28,51,47,3.6,2.7,4.6
2/5/17,19,0,0,9,0,28,12,1,13,0,9,35,72,51,3.6,2.7,4.6
2/6/17,19,0,6,7,0,32,7,0,5,0,8,20,78,67,3.6,2.7,4.6
2/7/17,13,0,2,17,0,32,13,0,12,0,6,31,86,56,3.6,2.7,4.6
2/8/17,16,0,8,5,0,29,10,0,5,0,16,31,87,51,3.6,2.7,4.6
2/9/17,17,0,0,7,0,24,29,0,15,0,4,48,68,43,3.6,2.7,4.6
2/10/17,29,0,5,9,0,43,55,1,9,0,3,68,79,51,3.6,2.7,4.6
2/11/17,13,0,0,17,0,30,51,0,3,0,0,54,86,66,3.6,2.7,4.6
2/12/17,16,0,2,21,0,39,13,0,7,1,11,32,79,66,3.6,2.7,4.6
2/13/17,16,0,1,20,0,37,21,0,12,0,14,47,78,63,3.6,2.7,4.6
2/14/17,18,0,1,10,0,29,8,0,7,1,2,18,67,47,3.6,2.7,4.6
2/15/17,20,0,1,9,0,30,8,0,8,1,4,21,65,43,3.6,2.7,4.6
2/16/17,15,0,3,16,0,34,8,0,16,0,8,32,70,40,3.6,2.7,4.6
2/17/17,13,0,0,9,0,22,10,0,8,0,0,18,77,50,3.6,2.7,4.6
2/18/17,16,0,2,15,0,33,15,1,8,0,2,26,86,62,3.6,2.7,4.6
2/19/17,14,0,1,4,0,19,15,1,9,0,7,32,81,61,3.6,2.7,4.6
2/20/17,20,1,2,9,0,32,17,0,12,0,9,38,70,58,3.6,2.7,4.6
2/21/17,18,0,0,5,0,23,13,2,8,0,1,24,82,52,3.6,2.7,4.6
2/22/17,20,0,0,9,0,29,10,0,7,1,11,29,87,51,3.6,2.7,4.6
2/23/17,26,1,4,9,0,40,15,0,9,0,4,28,90,55,3.6,2.7,4.6
2/24/17,14,0,4,3,0,21,13,1,11,0,8,33,80,54,3.6,2.7,4.6
2/25/17,24,0,5,4,0,33,24,0,12,0,1,37,63,44,3.6,2.7,4.6
2/26/17,19,0,1,4,0,24,10,0,2,0,13,25,72,42,3.6,2.7,4.6
2/27/17,24,0,8,6,0,38,13,0,3,0,7,23,82,66,3.6,2.7,4.6
2/28/17,20,0,4,7,0,31,14,0,8,0,5,27,80,69,3.6,2.7,4.6
3/1/17,18,0,4,4,0,26,16,0,13,0,6,35,73,54,3.4,2.4,4.4
3/2/17,28,0,4,3,0,35,13,0,9,0,4,26,66,49,3.4,2.4,4.4
3/3/17,23,0,2,2,0,27,15,1,13,0,1,30,71,40,3.4,2.4,4.4
3/4/17,14,0,2,4,0,20,9,0,7,0,3,19,59,54,3.4,2.4,4.4
3/5/17,16,0,2,3,0,21,8,0,14,0,7,29,75,57,3.4,2.4,4.4
3/6/17,15,0,8,3,0,26,4,0,17,0,1,22,84,68,3.4,2.4,4.4
3/7/17,16,0,7,2,0,25,10,0,13,0,6,29,77,61,3.4,2.4,4.4
3/8/17,17,0,4,2,0,23,7,0,11,0,3,21,76,60,3.4,2.4,4.4
3/9/17,29,0,1,4,0,34,5,0,6,0,10,21,80,67,3.4,2.4,4.4
3/10/17,24,0,0,6,0,30,8,0,11,0,1,20,83,62,3.4,2.4,4.4
3/11/17,16,0,1,5,0,22,9,0,7,0,3,19,66,61,3.4,2.4,4.4
3/12/17,21,0,1,6,0,28,13,0,8,1,18,40,62,47,3.4,2.4,4.4
3/13/17,29,0,2,7,0,38,8,0,9,0,10,27,70,48,3.4,2.4,4.4
3/14/17,22,0,5,7,0,34,14,0,12,0,4,30,73,40,3.4,2.4,4.4
3/15/17,20,0,5,5,0,30,7,0,14,0,7,28,75,49,3.4,2.4,4.4
3/16/17,20,0,0,8,0,28,8,0,11,0,11,30,79,58,3.4,2.4,4.4
3/17/17,18,0,5,6,0,29,12,0,9,2,4,27,83,65,3.4,2.4,4.4
3/18/17,8,0,2,12,0,22,22,0,6,0,4,32,84,65,3.4,2.4,4.4
3/19/17,7,0,1,1,0,9,13,1,6,0,5,25,85,65,3.4,2.4,4.4
3/20/17,15,0,1,5,0,21,12,0,7,0,6,25,85,64,3.4,2.4,4.4
3/21/17,20,0,2,5,0,27,5,0,6,0,3,14,85,63,3.4,2.4,4.4
3/22/17,19,0,3,1,0,23,8,0,14,0,1,23,83,68,3.4,2.4,4.4
3/23/17,15,0,2,5,0,22,6,0,4,0,16,26,85,65,3.4,2.4,4.4
3/24/17,15,0,2,10,0,27,11,0,9,0,1,21,83,60,3.4,2.4,4.4
3/25/17,25,0,1,9,0,35,16,1,8,1,1,27,84,53,3.4,2.4,4.4
3/26/17,18,0,1,4,0,23,9,0,9,0,10,28,86,63,3.4,2.4,4.4
3/27/17,22,0,0,12,0,34,12,0,11,0,19,42,86,70,3.4,2.4,4.4
3/28/17,21,0,2,6,0,29,7,0,12,0,4,23,86,70,3.4,2.4,4.4
3/29/17,28,0,1,7,0,36,11,0,7,0,7,25,84,60,3.4,2.4,4.4
3/30/17,13,0,4,2,0,19,9,0,10,0,1,20,82,54,3.4,2.4,4.4
3/31/17,19,0,4,4,0,27,13,0,7,0,3,23,86,55,3.4,2.4,4.4
4/1/17,14,0,4,5,0,23,10,1,9,0,0,20,76,65,3,2.2,4.4
4/2/17,11,0,0,3,0,14,16,0,5,0,10,31,77,57,3,2.2,4.4
4/3/17,29,0,3,3,0,35,18,0,8,0,10,36,90,49,3,2.2,4.4
4/4/17,21,0,4,5,0,30,8,0,13,0,3,24,89,60,3,2.2,4.4
4/5/17,22,0,9,10,0,41,1,0,2,0,2,5,75,52,3,2.2,4.4
4/6/17,10,0,1,7,0,18,11,0,6,0,4,21,79,49,3,2.2,4.4
4/7/17,14,0,1,4,0,19,20,0,5,0,4,29,81,52,3,2.2,4.4
4/8/17,29,0,1,4,0,34,22,0,4,0,2,28,82,56,3,2.2,4.4
4/9/17,11,0,3,6,0,20,7,0,14,0,10,31,81,66,3,2.2,4.4
4/10/17,17,0,1,9,0,27,15,0,9,0,14,38,80,71,3,2.2,4.4
4/11/17,27,0,3,6,0,36,17,3,10,0,4,34,72,62,3,2.2,4.4
4/12/17,22,0,2,16,0,40,21,0,9,0,2,32,78,61,3,2.2,4.4
4/13/17,15,0,1,6,0,22,20,1,6,0,9,36,82,67,3,2.2,4.4
4/14/17,17,0,0,3,0,20,31,0,10,0,1,42,84,65,3,2.2,4.4
4/15/17,16,0,2,4,0,22,18,1,6,0,3,28,84,67,3,2.2,4.4
4/16/17,8,0,0,7,0,15,14,0,6,0,8,28,84,69,3,2.2,4.4
4/17/17,19,0,4,5,0,28,8,0,6,0,10,24,80,63,3,2.2,4.4
4/18/17,19,0,5,10,0,34,10,0,7,0,9,26,82,61,3,2.2,4.4
4/19/17,15,0,3,3,0,21,3,0,6,0,4,13,85,68,3,2.2,4.4
4/20/17,17,0,1,7,0,25,6,0,7,0,2,15,88,70,3,2.2,4.4
4/21/17,16,0,2,8,0,26,13,0,12,0,3,28,89,71,3,2.2,4.4
4/22/17,25,0,1,3,0,29,11,0,7,0,6,24,73,57,3,2.2,4.4
4/23/17,15,0,1,2,0,18,5,0,10,0,6,21,77,50,3,2.2,4.4
4/24/17,14,0,5,4,0,23,7,0,9,0,4,20,82,48,3,2.2,4.4
4/25/17,25,0,4,5,0,34,13,0,9,0,11,33,90,62,3,2.2,4.4
4/26/17,16,0,2,2,0,20,9,1,6,0,7,23,91,62,3,2.2,4.4
4/27/17,25,0,3,6,0,34,11,0,16,0,15,42,86,53,3,2.2,4.4
4/28/17,13,0,3,10,0,26,2,0,3,1,1,7,95,70,3,2.2,4.4
4/29/17,24,0,3,5,0,32,10,0,11,0,3,24,92,66,3,2.2,4.4
4/30/17,18,0,0,6,0,24,7,2,7,1,4,21,78,52,3,2.2,4.4
5/1/17,23,0,5,12,0,40,10,0,8,0,7,25,91,51,3,1.9,4.4
5/2/17,14,0,5,6,0,25,21,0,8,0,16,45,92,62,3,1.9,4.4
5/3/17,26,0,11,5,0,42,6,1,8,0,6,21,95,64,3,1.9,4.4
5/4/17,16,0,5,5,0,26,8,0,9,0,8,25,79,60,3,1.9,4.4
5/5/17,22,0,2,4,0,28,22,0,7,0,3,32,86,55,3,1.9,4.4
5/6/17,11,0,2,4,0,17,16,0,3,1,2,22,91,54,3,1.9,4.4
5/7/17,11,0,1,11,0,23,21,0,8,0,1,30,88,61,3,1.9,4.4
5/8/17,11,0,1,8,0,20,23,0,17,0,5,45,84,64,3,1.9,4.4
5/9/17,17,0,1,7,0,25,12,0,5,0,6,23,76,66,3,1.9,4.4
5/10/17,16,0,1,7,0,24,12,0,13,0,2,27,83,71,3,1.9,4.4
5/11/17,26,0,5,9,0,40,7,1,9,0,2,19,88,71,3,1.9,4.4
5/12/17,21,0,1,7,0,29,11,0,9,0,0,20,88,63,3,1.9,4.4
5/13/17,16,0,1,6,0,23,11,0,9,0,10,30,89,58,3,1.9,4.4
5/14/17,23,0,1,7,0,31,5,0,6,0,12,23,93,62,3,1.9,4.4
5/15/17,23,0,1,5,0,29,9,0,10,0,2,21,92,67,3,1.9,4.4
5/16/17,13,0,1,9,0,23,10,1,8,0,8,27,86,70,3,1.9,4.4
5/17/17,34,0,2,3,0,39,4,0,6,1,5,16,90,70,3,1.9,4.4
5/18/17,28,0,3,6,0,37,15,0,8,0,21,44,94,73,3,1.9,4.4
5/19/17,29,0,4,5,0,38,16,0,4,1,2,23,95,75,3,1.9,4.4
5/20/17,15,0,1,7,0,23,12,1,5,0,2,20,84,66,3,1.9,4.4
5/21/17,28,1,1,6,0,36,9,1,9,0,7,26,78,62,3,1.9,4.4
5/22/17,13,0,0,2,0,15,12,1,4,0,4,21,77,61,3,1.9,4.4
5/23/17,17,0,1,7,0,25,10,1,9,0,13,33,86,58,3,1.9,4.4
5/24/17,25,0,0,5,0,30,9,0,13,0,7,29,87,56,3,1.9,4.4
5/25/17,13,0,2,5,0,20,18,0,10,0,16,44,94,62,3,1.9,4.4
5/26/17,22,0,1,4,0,27,35,0,7,0,0,42,92,75,3,1.9,4.4
5/27/17,17,0,5,6,0,28,33,0,11,1,4,49,97,76,3,1.9,4.4
5/28/17,17,0,2,6,0,25,39,0,7,0,2,48,94,66,3,1.9,4.4
5/29/17,17,1,5,11,0,34,14,0,11,0,10,35,88,68,3,1.9,4.4
5/30/17,23,0,1,10,0,34,10,0,9,0,13,32,88,68,3,1.9,4.4
5/31/17,24,0,6,13,0,43,7,0,8,1,2,18,85,68,3,1.9,4.4
6/1/17,27,0,3,6,0,36,5,1,7,0,9,22,89,67,3.3,1.6,4.3
6/2/17,22,0,0,6,0,28,10,0,6,0,6,22,92,74,3.3,1.6,4.3
6/3/17,18,0,0,9,0,27,14,1,12,0,1,28,92,71,3.3,1.6,4.3
6/4/17,28,0,1,6,0,35,8,0,9,0,4,21,91,68,3.3,1.6,4.3
6/5/17,21,0,3,12,0,36,21,0,9,0,6,36,90,66,3.3,1.6,4.3
6/6/17,27,0,0,2,0,29,9,0,8,0,2,19,92,70,3.3,1.6,4.3
6/7/17,17,0,4,9,0,30,7,0,10,0,4,21,95,70,3.3,1.6,4.3
6/8/17,22,0,2,5,0,29,19,0,8,0,5,32,93,73,3.3,1.6,4.3
6/9/17,18,0,4,7,0,29,21,0,5,0,0,26,90,74,3.3,1.6,4.3
6/10/17,13,0,5,11,0,29,13,1,6,1,1,22,93,70,3.3,1.6,4.3
6/11/17,16,0,3,4,0,23,20,0,9,0,2,31,93,73,3.3,1.6,4.3
6/12/17,11,0,0,7,0,18,12,0,7,0,8,27,94,75,3.3,1.6,4.3
6/13/17,7,0,4,6,0,17,6,0,6,0,1,13,98,76,3.3,1.6,4.3
6/14/17,11,0,4,5,0,20,7,2,4,0,1,14,96,78,3.3,1.6,4.3
6/15/17,19,0,2,7,0,28,12,0,7,0,4,23,99,76,3.3,1.6,4.3
6/16/17,15,0,1,5,0,21,9,0,17,0,2,28,98,77,3.3,1.6,4.3
6/17/17,16,0,2,5,0,23,17,1,3,0,1,22,101,77,3.3,1.6,4.3
6/18/17,15,0,1,0,0,16,5,1,13,0,15,34,100,78,3.3,1.6,4.3
6/19/17,27,0,2,10,0,39,12,0,10,0,12,34,92,76,3.3,1.6,4.3
6/20/17,22,0,3,1,0,26,9,0,13,0,1,23,98,76,3.3,1.6,4.3
6/21/17,40,0,5,5,0,50,12,0,4,0,7,23,97,75,3.3,1.6,4.3
6/22/17,26,0,5,5,0,36,14,0,10,0,11,35,99,76,3.3,1.6,4.3
6/23/17,8,0,2,5,0,15,21,0,5,1,4,31,104,78,3.3,1.6,4.3
6/24/17,11,0,3,1,0,15,14,0,8,1,2,25,85,72,3.3,1.6,4.3
6/25/17,15,0,4,6,0,25,13,0,3,0,12,28,90,75,3.3,1.6,4.3
6/26/17,9,0,2,6,0,17,15,4,14,0,10,43,91,72,3.3,1.6,4.3
6/27/17,31,0,3,9,0,43,3,0,12,0,4,19,91,71,3.3,1.6,4.3
6/28/17,22,0,5,5,0,32,14,1,5,0,1,21,92,71,3.3,1.6,4.3
6/29/17,20,0,3,7,0,30,8,0,9,0,3,20,99,75,3.3,1.6,4.3
6/30/17,14,0,3,2,0,19,10,0,4,0,5,19,98,79,3.3,1.6,4.3
7/1/17,14,0,1,0,0,15,19,0,14,0,4,37,98,79,3.3,1.7,4.3
7/2/17,18,0,3,0,0,21,12,0,10,1,20,43,100,78,3.3,1.7,4.3
7/3/17,20,0,2,16,0,38,13,1,5,0,13,32,99,76,3.3,1.7,4.3
7/4/17,15,0,4,4,0,23,11,2,10,0,1,24,101,78,3.3,1.7,4.3
7/5/17,27,0,4,3,0,34,12,0,15,1,9,37,99,78,3.3,1.7,4.3
7/6/17,26,0,3,6,0,35,13,0,7,0,9,29,100,77,3.3,1.7,4.3
7/7/17,16,0,2,7,0,25,14,0,9,0,1,24,99,75,3.3,1.7,4.3
7/8/17,23,0,0,3,0,26,4,0,3,0,1,8,100,75,3.3,1.7,4.3
7/9/17,38,0,0,7,0,45,16,1,11,0,5,33,101,77,3.3,1.7,4.3
7/10/17,21,0,4,7,0,32,10,0,4,0,22,36,100,76,3.3,1.7,4.3
7/11/17,19,0,2,4,0,25,17,0,6,0,9,32,101,77,3.3,1.7,4.3
7/12/17,16,0,0,7,0,23,16,0,9,0,9,34,101,77,3.3,1.7,4.3
7/13/17,19,0,5,7,0,31,14,0,8,0,7,29,102,77,3.3,1.7,4.3
7/14/17,32,0,1,6,0,39,15,1,6,0,1,23,101,77,3.3,1.7,4.3
7/15/17,17,0,3,7,0,27,11,0,4,0,1,16,103,71,3.3,1.7,4.3
7/16/17,21,0,2,4,0,27,6,1,10,0,16,33,99,68,3.3,1.7,4.3
7/17/17,20,0,1,8,0,29,19,0,8,0,9,36,98,77,3.3,1.7,4.3
7/18/17,18,0,2,6,0,26,3,1,6,0,4,14,100,76,3.3,1.7,4.3
7/19/17,20,0,6,4,0,30,8,0,5,0,4,17,101,77,3.3,1.7,4.3
7/20/17,16,0,2,5,0,23,14,0,8,0,8,30,103,77,3.3,1.7,4.3
7/21/17,26,0,0,5,0,31,11,1,5,0,6,23,104,77,3.3,1.7,4.3
7/22/17,20,0,3,6,0,29,15,1,6,0,0,22,103,77,3.3,1.7,4.3
7/23/17,13,0,0,2,0,15,14,1,10,1,4,30,103,77,3.3,1.7,4.3
7/24/17,16,0,1,3,0,20,16,1,8,0,11,36,102,76,3.3,1.7,4.3
7/25/17,24,0,2,1,0,27,11,0,5,0,3,19,103,78,3.3,1.7,4.3
7/26/17,22,0,1,11,0,34,7,0,6,0,0,13,103,78,3.3,1.7,4.3
7/27/17,8,0,2,7,0,17,13,0,7,0,6,26,103,75,3.3,1.7,4.3
7/28/17,14,0,2,1,0,17,33,0,7,0,2,42,105,76,3.3,1.7,4.3
7/29/17,24,0,1,7,0,32,18,0,4,0,5,27,107,77,3.3,1.7,4.3
7/30/17,17,0,0,3,0,20,17,0,6,0,0,23,106,79,3.3,1.7,4.3
7/31/17,20,0,0,4,0,24,12,0,10,0,13,35,99,77,3.3,1.7,4.3
8/1/17,24,0,4,2,0,30,11,1,11,0,4,27,100,75,3.3,1.9,4.4
8/2/17,23,0,3,5,0,31,10,0,10,0,3,23,87,78,3.3,1.9,4.4
8/3/17,30,0,2,10,0,42,8,0,13,0,10,31,95,75,3.3,1.9,4.4
8/4/17,14,0,3,8,0,25,13,0,5,0,5,23,99,76,3.3,1.9,4.4
8/5/17,10,0,5,3,0,18,10,0,8,0,3,21,102,77,3.3,1.9,4.4
8/6/17,22,0,1,2,0,25,12,0,5,0,12,29,101,78,3.3,1.9,4.4
8/7/17,13,0,3,5,0,21,9,0,6,0,16,31,85,69,3.3,1.9,4.4
8/8/17,16,0,2,6,0,24,5,0,4,0,1,10,94,73,3.3,1.9,4.4
8/9/17,10,0,3,6,0,19,11,0,6,0,7,24,96,74,3.3,1.9,4.4
8/10/17,21,0,1,7,0,29,8,0,5,0,6,19,100,75,3.3,1.9,4.4
8/11/17,15,0,15,6,0,36,13,0,9,0,4,26,100,76,3.3,1.9,4.4
8/12/17,17,0,1,3,0,21,10,0,9,0,2,21,100,78,3.3,1.9,4.4
8/13/17,12,0,0,3,0,15,11,0,6,0,9,26,101,78,3.3,1.9,4.4
8/14/17,29,0,3,2,0,34,12,0,5,0,12,29,100,77,3.3,1.9,4.4
8/15/17,17,0,1,11,0,29,13,1,1,0,6,21,99,77,3.3,1.9,4.4
8/16/17,12,0,0,8,0,20,15,0,15,1,16,47,101,80,3.3,1.9,4.4
8/17/17,14,0,3,9,0,26,10,1,8,0,3,22,102,80,3.3,1.9,4.4
8/18/17,18,0,0,7,0,25,79,0,1,0,1,81,101,78,3.3,1.9,4.4
8/19/17,16,0,4,11,0,31,9,1,3,0,2,15,101,76,3.3,1.9,4.4
8/20/17,15,0,0,8,0,23,9,0,8,0,2,19,101,76,3.3,1.9,4.4
8/21/17,15,0,0,9,0,24,7,0,5,0,15,27,99,78,3.3,1.9,4.4
8/22/17,11,0,4,9,0,24,18,1,5,0,5,29,100,76,3.3,1.9,4.4
8/23/17,15,0,2,5,0,22,14,0,6,0,7,27,100,75,3.3,1.9,4.4
8/24/17,18,0,1,10,0,29,9,0,6,0,4,19,96,76,3.3,1.9,4.4
8/25/17,15,0,1,4,0,20,12,0,10,0,2,24,90,76,3.3,1.9,4.4
8/26/17,14,0,6,4,0,24,8,0,7,0,4,19,76,72,3.3,1.9,4.4
8/27/17,19,0,0,3,0,22,16,0,8,0,4,28,74,70,3.3,1.9,4.4
8/28/17,35,0,1,4,0,40,11,0,10,0,1,22,86,70,3.3,1.9,4.4
8/29/17,23,0,6,9,0,38,9,0,15,0,0,24,90,70,3.3,1.9,4.4
8/30/17,20,0,3,4,0,27,13,0,11,0,3,27,93,70,3.3,1.9,4.4
8/31/17,23,0,4,3,0,30,14,0,2,0,4,20,93,68,3.3,1.9,4.4
9/1/17,14,0,65,4,0,83,21,1,8,0,1,31,94,68,3,2.2,4.3
9/2/17,25,0,14,1,0,40,21,0,9,0,1,31,94,69,3,2.2,4.3
9/3/17,22,0,40,4,0,66,18,0,17,0,14,49,92,70,3,2.2,4.3
9/4/17,13,0,42,5,0,60,20,0,10,0,5,35,92,71,3,2.2,4.3
9/5/17,20,0,6,6,0,32,12,0,12,0,4,28,96,72,3,2.2,4.3
9/6/17,22,0,8,3,0,33,8,0,5,0,8,21,87,67,3,2.2,4.3
9/7/17,21,0,7,2,0,30,6,0,12,0,1,19,85,57,3,2.2,4.3
9/8/17,13,0,2,10,0,25,22,0,5,0,1,28,85,59,3,2.2,4.3
9/9/17,11,0,2,6,0,19,15,0,8,0,1,24,87,63,3,2.2,4.3
9/10/17,14,0,6,4,0,24,7,0,9,0,2,18,86,66,3,2.2,4.3
9/11/17,12,0,22,7,0,41,18,0,5,1,5,29,87,61,3,2.2,4.3
9/12/17,14,0,2,8,0,24,8,0,15,0,1,24,93,63,3,2.2,4.3
9/13/17,25,0,7,10,0,42,3,0,8,1,7,19,93,63,3,2.2,4.3
9/14/17,12,0,2,3,0,17,5,3,8,0,27,43,94,74,3,2.2,4.3
9/15/17,14,0,4,3,0,21,27,0,11,0,3,41,92,73,3,2.2,4.3
9/16/17,11,0,3,5,0,19,15,0,7,0,9,31,93,75,3,2.2,4.3
9/17/17,11,0,4,7,0,22,5,0,5,0,8,18,93,72,3,2.2,4.3
9/18/17,15,0,5,4,0,24,12,0,12,0,8,32,95,75,3,2.2,4.3
9/19/17,18,0,5,8,0,31,11,0,5,0,6,22,95,77,3,2.2,4.3
9/20/17,17,0,2,9,0,28,6,0,5,0,18,29,96,77,3,2.2,4.3
9/21/17,17,0,1,7,0,25,6,0,9,0,8,23,96,75,3,2.2,4.3
9/22/17,13,0,1,3,0,17,8,2,6,1,0,17,91,75,3,2.2,4.3
9/23/17,25,0,5,5,0,35,15,1,12,0,5,33,90,73,3,2.2,4.3
9/24/17,11,0,1,5,0,17,8,0,10,0,1,19,90,74,3,2.2,4.3
9/25/17,17,0,2,14,0,33,9,0,5,0,13,27,91,74,3,2.2,4.3
9/26/17,18,0,0,8,0,26,7,1,11,1,8,28,83,71,3,2.2,4.3
9/27/17,23,0,2,5,0,30,6,1,6,0,12,25,85,71,3,2.2,4.3
9/28/17,17,0,3,5,0,25,19,1,10,0,17,47,84,73,3,2.2,4.3
9/29/17,18,0,5,3,0,26,15,1,6,0,0,22,76,70,3,2.2,4.3
9/30/17,22,0,4,2,0,28,15,1,6,0,0,22,87,66,3,2.2,4.3
10/1/17,25,0,1,7,0,33,15,1,15,0,10,41,88,62,2.8,2,4.2
10/2/17,30,0,4,16,0,50,8,0,10,0,70,88,89,69,2.8,2,4.2
10/3/17,25,0,0,5,0,30,11,1,16,0,29,57,87,74,2.8,2,4.2
10/4/17,21,0,2,3,0,26,11,0,5,0,12,28,89,76,2.8,2,4.2
10/5/17,15,0,4,2,0,21,12,0,10,0,12,34,89,70,2.8,2,4.2
10/6/17,15,0,4,3,0,22,21,1,4,0,0,26,87,68,2.8,2,4.2
10/7/17,28,0,0,3,0,31,27,0,7,0,2,36,88,68,2.8,2,4.2
10/8/17,16,0,4,3,0,23,14,0,3,0,18,35,91,68,2.8,2,4.2
10/9/17,21,0,0,8,0,29,12,1,9,0,4,26,92,73,2.8,2,4.2
10/10/17,22,0,0,5,0,27,11,1,6,1,5,24,79,60,2.8,2,4.2
10/11/17,32,0,3,6,0,41,12,0,8,1,3,24,80,57,2.8,2,4.2
10/12/17,16,0,2,3,0,21,12,3,7,0,3,25,88,61,2.8,2,4.2
10/13/17,21,1,3,9,0,34,9,0,12,0,4,25,90,69,2.8,2,4.2
10/14/17,16,0,4,0,0,20,14,0,19,0,1,34,90,73,2.8,2,4.2
10/15/17,26,0,3,1,0,30,11,0,8,0,12,31,79,63,2.8,2,4.2
10/16/17,21,0,0,7,0,28,16,0,12,0,18,46,77,54,2.8,2,4.2
10/17/17,16,0,1,2,0,19,10,0,8,0,1,19,79,50,2.8,2,4.2
10/18/17,17,0,4,6,0,27,13,0,5,0,3,21,83,49,2.8,2,4.2
10/19/17,13,0,0,5,0,18,9,0,7,0,7,23,84,57,2.8,2,4.2
10/20/17,17,0,1,5,0,23,13,0,4,0,1,18,84,66,2.8,2,4.2
10/21/17,10,0,3,3,0,16,12,0,10,0,1,23,89,72,2.8,2,4.2
10/22/17,20,0,1,10,0,31,9,0,15,0,8,32,80,55,2.8,2,4.2
10/23/17,20,0,3,3,0,26,9,0,11,0,4,24,82,50,2.8,2,4.2
10/24/17,25,0,0,2,0,27,1,0,7,0,12,20,79,54,2.8,2,4.2
10/25/17,21,0,2,3,0,26,14,0,2,0,8,24,81,51,2.8,2,4.2
10/26/17,15,0,4,2,0,21,12,0,4,0,5,21,83,50,2.8,2,4.2
10/27/17,16,0,4,1,0,21,29,0,11,0,2,42,66,46,2.8,2,4.2
10/28/17,21,0,2,6,0,29,23,1,1,0,2,27,64,39,2.8,2,4.2
10/29/17,19,0,7,7,0,33,24,1,6,0,6,37,76,39,2.8,2,4.2
10/30/17,14,0,1,7,0,22,12,0,4,0,5,21,80,48,2.8,2,4.2
10/31/17,12,0,1,3,0,16,20,0,9,0,3,32,62,51,2.8,2,4.2
11/1/17,23,0,2,2,0,27,6,0,15,0,2,23,78,52,2.9,2.2,4.2
11/2/17,17,0,5,4,0,26,6,1,4,0,12,23,85,66,2.9,2.2,4.2
11/3/17,10,0,4,4,0,18,9,0,8,0,0,17,88,74,2.9,2.2,4.2
11/4/17,24,0,1,4,0,29,6,0,10,0,1,17,83,71,2.9,2.2,4.2
11/5/17,18,0,3,10,0,31,10,0,13,0,4,27,88,72,2.9,2.2,4.2
11/6/17,28,0,2,1,0,31,9,0,12,0,1,22,88,72,2.9,2.2,4.2
11/7/17,16,0,4,6,0,26,11,0,5,0,13,29,79,60,2.9,2.2,4.2
11/8/17,18,0,4,3,0,25,8,0,9,0,8,25,60,46,2.9,2.2,4.2
11/9/17,19,0,0,6,0,25,9,0,3,0,5,17,57,46,2.9,2.2,4.2
11/10/17,8,0,2,3,0,13,6,0,5,0,5,16,63,52,2.9,2.2,4.2
11/11/17,22,0,0,1,0,23,12,0,9,0,1,22,75,59,2.9,2.2,4.2
11/12/17,21,0,1,3,0,25,13,1,14,0,1,29,78,65,2.9,2.2,4.2
11/13/17,21,0,1,7,0,29,8,0,8,0,9,25,78,63,2.9,2.2,4.2
11/14/17,18,0,0,5,0,23,8,0,9,0,4,21,80,62,2.9,2.2,4.2
11/15/17,15,0,2,1,0,18,10,0,10,0,9,29,73,68,2.9,2.2,4.2
11/16/17,15,0,3,16,0,34,9,0,4,0,20,33,83,64,2.9,2.2,4.2
11/17/17,15,0,2,2,0,19,19,0,6,0,3,28,85,70,2.9,2.2,4.2
11/18/17,15,0,0,6,0,21,10,0,8,0,3,21,84,54,2.9,2.2,4.2
11/19/17,17,0,1,6,0,24,7,0,6,0,8,21,65,43,2.9,2.2,4.2
11/20/17,35,0,0,5,0,40,11,1,10,0,5,27,69,40,2.9,2.2,4.2
11/21/17,19,0,0,7,0,26,8,1,0,0,7,16,76,51,2.9,2.2,4.2
11/22/17,18,0,3,4,0,25,1,1,5,0,0,7,66,43,2.9,2.2,4.2
11/23/17,2,0,0,1,0,3,16,0,6,0,0,22,72,38,2.9,2.2,4.2
11/24/17,15,0,3,5,0,23,15,0,5,0,1,21,77,42,2.9,2.2,4.2
11/25/17,11,0,1,5,0,17,26,0,10,0,9,45,81,49,2.9,2.2,4.2
11/26/17,9,0,1,3,0,13,14,0,7,0,1,22,78,54,2.9,2.2,4.2
11/27/17,13,0,4,3,0,20,11,0,5,0,10,26,77,53,2.9,2.2,4.2
11/28/17,16,0,7,6,0,29,4,1,7,0,6,18,80,53,2.9,2.2,4.2
11/29/17,13,0,2,6,0,21,7,0,7,0,6,20,73,50,2.9,2.2,4.2
11/30/17,29,0,1,3,0,33,11,0,7,0,15,33,77,46,2.9,2.2,4.2
12/1/17,12,0,3,5,0,20,9,0,12,0,1,22,77,53,2.8,2.1,4.1
12/2/17,16,0,4,3,0,23,11,0,5,0,2,18,80,51,2.8,2.1,4.1
12/3/17,20,0,2,4,0,26,5,0,4,0,3,12,73,61,2.8,2.1,4.1
12/4/17,14,0,7,5,0,26,2,1,11,0,2,16,85,67,2.8,2.1,4.1
12/5/17,24,0,1,16,0,41,4,0,8,0,4,16,72,42,2.8,2.1,4.1
12/6/17,20,0,2,5,0,27,6,0,7,0,4,17,43,40,2.8,2.1,4.1
12/7/17,19,0,1,8,0,28,8,0,7,0,8,23,47,32,2.8,2.1,4.1
12/8/17,18,0,1,4,0,23,24,0,11,0,12,47,49,31,2.8,2.1,4.1
12/9/17,24,0,5,2,0,31,16,0,8,0,1,25,67,34,2.8,2.1,4.1
12/10/17,11,0,2,3,0,16,21,0,5,0,3,29,70,38,2.8,2.1,4.1
12/11/17,14,0,3,9,0,26,14,0,9,0,6,29,76,44,2.8,2.1,4.1
12/12/17,18,0,2,9,0,29,9,0,10,0,8,27,65,39,2.8,2.1,4.1
12/13/17,11,0,3,3,0,17,9,0,5,0,5,19,62,36,2.8,2.1,4.1
12/14/17,10,0,3,4,0,17,12,1,12,0,4,29,65,44,2.8,2.1,4.1
12/15/17,15,0,2,7,0,24,7,0,5,0,1,13,61,42,2.8,2.1,4.1
12/16/17,20,0,4,6,0,30,16,0,7,0,0,23,53,41,2.8,2.1,4.1
12/17/17,19,0,0,3,0,22,10,1,11,0,8,30,59,45,2.8,2.1,4.1
12/18/17,25,0,2,6,0,33,8,0,7,0,0,15,57,49,2.8,2.1,4.1
12/19/17,22,0,1,11,0,34,13,0,9,0,4,26,71,56,2.8,2.1,4.1
12/20/17,17,0,2,5,0,24,15,0,7,0,16,38,77,50,2.8,2.1,4.1
12/21/17,15,0,1,11,0,27,19,0,4,0,4,27,79,48,2.8,2.1,4.1
12/22/17,16,0,0,4,0,20,18,0,10,0,8,36,71,41,2.8,2.1,4.1
12/23/17,17,0,4,5,0,26,7,1,9,0,1,18,56,37,2.8,2.1,4.1
12/24/17,11,0,2,0,0,13,0,0,2,0,0,2,63,38,2.8,2.1,4.1
12/25/17,0,0,2,0,0,2,15,0,16,0,10,41,55,34,2.8,2.1,4.1
12/26/17,20,0,4,9,0,33,16,0,10,0,2,28,51,41,2.8,2.1,4.1
12/27/17,18,0,2,8,0,28,10,1,8,0,4,23,41,38,2.8,2.1,4.1
12/28/17,14,0,3,4,0,21,16,2,6,1,2,27,50,37,2.8,2.1,4.1
12/29/17,18,0,1,6,0,25,13,0,7,0,0,20,49,40,2.8,2.1,4.1
12/30/17,26,0,0,8,0,34,22,0,6,0,4,32,63,43,2.8,2.1,4.1
12/31/17,21,0,2,8,0,31,0,0,2,0,0,2,43,27,2.8,2.1,4.1
1/1/18,7,0,5,1,0,13,6,0,10,0,3,19,32,25,3.1,2.1,4
1/2/18,25,0,6,7,0,38,16,0,2,0,4,22,32,26,3.1,2.1,4
1/3/18,24,0,0,2,0,26,19,1,15,0,4,39,56,22,3.1,2.1,4
1/4/18,13,0,1,3,0,17,11,0,7,0,4,22,55,30,3.1,2.1,4
1/5/18,18,0,0,8,0,26,12,0,7,0,0,19,62,44,3.1,2.1,4
1/6/18,20,0,1,9,0,30,15,0,6,0,3,24,63,40,3.1,2.1,4
1/7/18,18,0,0,4,0,22,14,2,11,1,1,29,67,54,3.1,2.1,4
1/8/18,28,0,1,6,0,35,8,1,3,0,1,13,69,44,3.1,2.1,4
1/9/18,13,0,4,4,0,21,12,0,9,0,6,27,70,39,3.1,2.1,4
1/10/18,15,0,3,6,0,24,8,0,5,0,6,19,71,48,3.1,2.1,4
1/11/18,13,0,2,2,0,17,14,0,9,0,4,27,72,44,3.1,2.1,4
1/12/18,21,0,4,5,0,30,18,0,4,0,4,26,58,34,3.1,2.1,4
1/13/18,18,0,1,6,0,25,34,0,8,0,8,50,54,32,3.1,2.1,4
1/14/18,14,0,1,5,0,20,15,1,3,0,5,24,61,29,3.1,2.1,4
1/15/18,15,0,1,16,0,32,0,0,5,0,0,5,71,38,3.1,2.1,4
1/16/18,8,0,2,0,0,10,14,0,6,0,7,27,38,26,3.1,2.1,4
1/17/18,33,0,3,7,0,43,13,0,7,1,9,30,38,18,3.1,2.1,4
1/18/18,22,0,0,4,0,26,7,0,11,0,4,22,45,26,3.1,2.1,4
1/19/18,9,0,3,1,0,13,14,0,15,0,0,29,54,40,3.1,2.1,4
1/20/18,26,0,1,3,0,30,15,0,10,0,0,25,68,51,3.1,2.1,4
1/21/18,18,0,4,8,0,30,13,0,14,0,5,32,72,59,3.1,2.1,4
1/22/18,26,0,1,9,0,36,9,0,6,0,3,18,65,45,3.1,2.1,4
1/23/18,13,0,2,13,0,28,8,0,15,0,13,36,66,39,3.1,2.1,4
1/24/18,20,0,1,6,0,27,14,0,8,0,11,33,65,36,3.1,2.1,4
1/25/18,15,0,1,6,0,22,9,0,8,0,2,19,66,32,3.1,2.1,4
1/26/18,17,0,4,8,0,29,18,0,4,0,1,23,68,51,3.1,2.1,4
1/27/18,16,0,2,5,0,23,17,0,8,0,1,26,70,59,3.1,2.1,4
1/28/18,20,0,4,4,0,28,17,1,5,0,9,32,71,50,3.1,2.1,4
1/29/18,16,0,2,6,0,24,5,0,6,0,12,23,68,40,3.1,2.1,4
1/30/18,18,0,1,7,0,26,8,0,14,0,5,27,67,34,3.1,2.1,4
1/31/18,18,0,3,5,0,26,17,1,8,0,2,28,72,46,3.1,2.1,4
2/1/18,24,0,2,5,0,31,15,1,7,0,4,27,73,53,3.1,2.2,4.1
2/2/18,11,0,2,4,0,17,23,1,7,1,3,35,59,45,3.1,2.2,4.1
2/3/18,15,0,1,4,0,20,18,0,4,0,2,24,56,43,3.1,2.2,4.1
2/4/18,16,0,3,10,0,29,10,0,6,1,3,20,76,42,3.1,2.2,4.1
2/5/18,11,0,1,8,0,20,9,0,7,0,9,25,55,40,3.1,2.2,4.1
2/6/18,17,0,1,5,0,23,7,0,15,0,0,22,54,39,3.1,2.2,4.1
2/7/18,25,0,5,7,0,37,6,1,9,0,13,29,48,36,3.1,2.2,4.1
2/8/18,27,0,2,5,0,34,16,0,8,0,5,29,59,34,3.1,2.2,4.1
2/9/18,12,0,2,11,0,25,16,0,6,0,2,24,64,52,3.1,2.2,4.1
2/10/18,17,0,4,2,0,23,13,1,15,0,0,29,62,40,3.1,2.2,4.1
2/11/18,22,0,2,9,0,33,10,1,9,0,12,32,43,31,3.1,2.2,4.1
2/12/18,12,0,2,6,0,20,15,0,14,0,3,32,44,31,3.1,2.2,4.1
2/13/18,19,0,0,4,0,23,8,0,5,0,6,19,47,39,3.1,2.2,4.1
2/14/18,15,0,2,5,0,22,11,0,4,0,9,24,72,46,3.1,2.2,4.1
2/15/18,32,0,2,3,0,37,12,1,7,0,8,28,77,64,3.1,2.2,4.1
2/16/18,24,0,0,3,0,27,10,0,7,0,3,20,71,57,3.1,2.2,4.1
2/17/18,24,0,1,4,0,29,15,0,6,0,1,22,62,50,3.1,2.2,4.1
2/18/18,17,0,1,8,0,26,16,0,8,0,6,30,75,51,3.1,2.2,4.1
2/19/18,14,0,4,4,0,22,14,0,5,0,14,33,80,69,3.1,2.2,4.1
2/20/18,16,0,1,8,0,25,8,1,6,0,5,20,73,69,3.1,2.2,4.1
2/21/18,11,0,2,6,0,19,6,5,3,0,1,15,71,39,3.1,2.2,4.1
2/22/18,9,0,1,6,0,16,13,0,5,0,4,22,44,37,3.1,2.2,4.1
2/23/18,19,0,4,6,0,29,14,0,7,0,2,23,65,43,3.1,2.2,4.1
2/24/18,29,0,2,2,0,33,13,2,9,0,1,25,74,62,3.1,2.2,4.1
2/25/18,22,0,1,6,0,29,9,0,4,0,1,14,68,52,3.1,2.2,4.1
2/26/18,23,0,4,6,0,33,9,0,4,0,11,24,70,47,3.1,2.2,4.1
2/27/18,19,0,3,4,0,26,18,0,9,0,13,40,80,59,3.1,2.2,4.1
2/28/18,21,0,2,6,0,29,14,1,8,0,5,28,83,69,3.1,2.2,4.1
3/1/18,25,0,2,2,0,29,14,0,5,0,5,24,72,54,3.1,2.4,4
3/2/18,23,0,1,6,0,30,15,0,8,0,12,35,75,52,3.1,2.4,4
3/3/18,19,0,0,17,0,36,26,0,7,0,1,34,72,53,3.1,2.4,4
3/4/18,14,0,0,5,0,19,13,0,11,0,1,25,81,63,3.1,2.4,4
3/5/18,24,0,3,8,0,35,9,0,11,0,10,30,85,61,3.1,2.4,4
3/6/18,43,0,2,3,0,48,0,0,7,0,0,7,74,51,3.1,2.4,4
3/7/18,6,0,3,4,0,13,12,2,7,1,2,24,69,47,3.1,2.4,4
3/8/18,21,0,6,6,0,33,7,0,9,0,7,23,71,49,3.1,2.4,4
3/9/18,16,0,2,7,0,25,50,0,6,0,0,56,73,52,3.1,2.4,4
3/10/18,18,0,2,6,0,26,31,0,7,0,1,39,90,65,3.1,2.4,4
3/11/18,13,0,5,8,0,26,18,0,9,0,1,28,70,55,3.1,2.4,4
3/12/18,13,0,2,6,0,21,8,0,7,0,5,20,68,46,3.1,2.4,4
3/13/18,20,0,0,15,0,35,9,0,10,0,0,19,71,42,3.1,2.4,4
3/14/18,15,0,4,3,0,22,7,0,11,1,5,24,72,41,3.1,2.4,4
3/15/18,12,0,3,6,0,21,17,0,6,0,2,25,75,50,3.1,2.4,4
3/16/18,10,0,0,3,0,13,42,0,8,0,0,50,89,63,3.1,2.4,4
3/17/18,20,0,1,5,0,26,22,0,3,0,0,25,85,67,3.1,2.4,4
3/18/18,15,0,2,7,0,24,9,2,5,0,3,19,84,68,3.1,2.4,4
3/19/18,12,0,4,5,0,21,8,0,9,0,3,20,82,60,3.1,2.4,4
3/20/18,21,0,2,10,0,33,8,0,10,0,13,31,75,49,3.1,2.4,4
3/21/18,24,0,5,3,0,32,6,1,9,0,7,23,78,43,3.1,2.4,4
3/22/18,19,0,3,3,0,25,7,1,9,0,2,19,81,52,3.1,2.4,4
3/23/18,29,0,2,14,0,45,10,0,9,1,3,23,81,59,3.1,2.4,4
3/24/18,23,0,3,4,0,30,22,0,4,0,0,26,84,68,3.1,2.4,4
3/25/18,24,0,1,4,0,29,8,0,9,0,2,19,77,68,3.1,2.4,4
3/26/18,17,0,4,6,0,27,11,0,10,0,4,25,88,69,3.1,2.4,4
3/27/18,18,0,2,5,0,25,13,0,8,0,4,25,82,63,3.1,2.4,4
3/28/18,27,0,5,5,0,37,16,1,14,0,2,33,72,58,3.1,2.4,4
3/29/18,16,0,4,6,0,26,22,1,9,0,13,45,86,56,3.1,2.4,4
3/30/18,29,0,3,4,0,36,13,1,10,0,2,26,74,55,3.1,2.4,4
3/31/18,16,0,1,3,0,20,18,1,3,0,8,30,83,57,3.1,2.4,4
4/1/18,18,0,4,8,0,30,6,0,6,0,10,22,82,64,2.7,2.5,4
4/2/18,19,0,3,7,0,29,11,0,11,0,11,33,84,57,2.7,2.5,4
4/3/18,11,0,4,6,0,21,15,0,5,0,13,33,82,62,2.7,2.5,4
4/4/18,33,0,0,9,0,42,16,1,15,0,6,38,71,50,2.7,2.5,4
4/5/18,19,0,6,7,0,32,20,0,6,0,12,38,78,57,2.7,2.5,4
4/6/18,21,0,2,6,0,29,10,0,6,0,4,20,84,64,2.7,2.5,4
4/7/18,19,0,2,10,0,31,17,0,7,0,4,28,64,40,2.7,2.5,4
4/8/18,10,0,0,3,0,13,6,0,3,0,1,10,66,41,2.7,2.5,4
4/9/18,9,0,4,8,0,21,17,0,9,0,7,33,65,53,2.7,2.5,4
4/10/18,23,0,2,9,0,34,12,0,9,0,3,24,78,53,2.7,2.5,4
4/11/18,13,0,4,6,0,23,2,0,12,0,6,20,82,47,2.7,2.5,4
4/12/18,26,0,2,6,0,34,12,1,10,0,3,26,86,63,2.7,2.5,4
4/13/18,15,0,1,6,0,22,16,0,10,0,6,32,88,60,2.7,2.5,4
4/14/18,17,0,4,8,0,29,14,0,11,0,1,26,72,54,2.7,2.5,4
4/15/18,12,0,2,10,0,24,14,0,8,0,13,35,78,47,2.7,2.5,4
4/16/18,29,0,2,5,0,36,10,0,13,0,7,30,84,47,2.7,2.5,4
4/17/18,19,0,9,7,0,35,3,0,10,0,7,20,87,58,2.7,2.5,4
4/18/18,17,0,4,2,0,23,8,2,6,0,0,16,83,66,2.7,2.5,4
4/19/18,9,0,1,4,0,14,12,1,7,0,7,27,78,59,2.7,2.5,4
4/20/18,16,0,0,7,0,23,19,0,7,0,3,29,72,57,2.7,2.5,4
4/21/18,11,0,3,5,0,19,17,0,1,0,1,19,73,58,2.7,2.5,4
4/22/18,11,0,4,4,0,19,6,0,8,0,2,16,79,52,2.7,2.5,4
4/23/18,13,0,5,6,0,24,8,0,9,0,5,22,87,52,2.7,2.5,4
4/24/18,18,0,1,5,0,24,14,0,14,0,8,36,87,59,2.7,2.5,4
4/25/18,23,0,5,7,0,35,13,0,11,1,3,28,89,55,2.7,2.5,4
4/26/18,26,0,1,7,0,34,10,0,14,0,8,32,78,50,2.7,2.5,4
4/27/18,24,0,2,5,0,31,10,0,4,0,3,17,80,55,2.7,2.5,4
4/28/18,16,0,3,7,0,26,15,0,13,0,1,29,86,56,2.7,2.5,4
4/29/18,14,0,0,5,0,19,15,1,13,0,7,36,84,59,2.7,2.5,4
4/30/18,30,0,0,7,0,37,14,0,3,0,2,19,80,64,2.7,2.5,4
5/1/18,11,0,2,13,0,26,12,3,4,1,8,28,81,70,2.7,2.8,3.8
5/2/18,9,0,6,6,0,21,5,0,7,0,17,29,90,73,2.7,2.8,3.8
5/3/18,19,0,5,4,0,28,16,0,8,0,3,27,88,75,2.7,2.8,3.8
5/4/18,15,0,1,5,0,21,11,0,9,0,0,20,75,62,2.7,2.8,3.8
5/5/18,18,0,2,10,0,30,34,0,8,0,0,42,86,63,2.7,2.8,3.8
5/6/18,20,0,0,3,0,23,9,0,11,0,8,28,90,60,2.7,2.8,3.8
5/7/18,21,0,0,9,0,30,7,0,7,0,14,28,91,58,2.7,2.8,3.8
5/8/18,15,0,1,3,0,19,14,0,3,0,5,22,88,64,2.7,2.8,3.8
5/9/18,17,0,2,7,0,26,16,0,10,0,6,32,88,66,2.7,2.8,3.8
5/10/18,14,0,0,7,0,21,10,0,10,0,5,25,90,66,2.7,2.8,3.8
5/11/18,13,0,1,11,0,25,10,0,10,0,15,35,90,70,2.7,2.8,3.8
5/12/18,21,0,1,5,0,27,16,0,7,0,2,25,91,73,2.7,2.8,3.8
5/13/18,14,0,4,4,0,22,11,1,2,0,7,21,91,74,2.7,2.8,3.8
5/14/18,11,0,0,11,0,22,9,0,4,0,2,15,91,74,2.7,2.8,3.8
5/15/18,18,0,5,4,0,27,15,1,10,0,10,36,90,72,2.7,2.8,3.8
5/16/18,11,0,6,6,0,23,9,0,4,0,1,14,97,66,2.7,2.8,3.8
5/17/18,8,0,2,5,0,15,8,0,6,0,1,15,96,70,2.7,2.8,3.8
5/18/18,13,0,3,6,0,22,15,0,6,0,3,24,95,71,2.7,2.8,3.8
5/19/18,17,0,2,11,0,30,11,0,3,0,5,19,94,72,2.7,2.8,3.8
5/20/18,25,0,4,14,0,43,10,0,9,0,14,33,82,69,2.7,2.8,3.8
5/21/18,20,0,1,7,0,28,14,0,8,0,16,38,88,69,2.7,2.8,3.8
5/22/18,31,0,3,7,0,41,4,0,9,0,2,15,88,72,2.7,2.8,3.8
5/23/18,21,0,2,2,0,25,5,0,9,1,8,23,90,73,2.7,2.8,3.8
5/24/18,28,0,2,0,0,30,11,1,4,1,10,27,93,73,2.7,2.8,3.8
5/25/18,11,0,0,7,0,18,17,0,10,0,2,29,95,74,2.7,2.8,3.8
5/26/18,10,0,3,4,0,17,27,1,11,0,1,40,99,74,2.7,2.8,3.8
5/27/18,25,0,1,4,0,30,36,0,6,0,6,48,97,74,2.7,2.8,3.8
5/28/18,15,0,0,1,0,16,18,0,12,1,15,46,96,73,2.7,2.8,3.8
5/29/18,31,0,2,6,0,39,18,0,7,0,0,25,97,74,2.7,2.8,3.8
5/30/18,27,0,6,8,0,41,11,0,8,0,6,25,98,75,2.7,2.8,3.8
5/31/18,9,0,2,8,0,19,12,0,4,0,5,21,98,76,2.7,2.8,3.8
6/1/18,19,0,2,5,0,26,18,1,7,0,3,29,99,77,3.3,2.9,4
6/2/18,17,0,1,18,0,36,20,0,9,0,1,30,101,77,3.3,2.9,4
6/3/18,19,0,3,15,0,37,6,0,9,0,5,20,100,74,3.3,2.9,4
6/4/18,20,0,3,9,0,32,16,1,6,0,4,27,89,71,3.3,2.9,4
6/5/18,19,0,4,9,0,32,17,0,9,0,1,27,99,75,3.3,2.9,4
6/6/18,17,0,1,13,0,31,8,0,5,0,15,28,99,77,3.3,2.9,4
6/7/18,21,0,2,4,0,27,5,1,7,1,4,18,98,76,3.3,2.9,4
6/8/18,21,0,3,7,0,31,17,0,3,0,3,23,95,75,3.3,2.9,4
6/9/18,20,0,2,3,0,25,17,0,9,0,1,27,96,77,3.3,2.9,4
6/10/18,17,0,0,4,0,21,21,0,10,0,3,34,99,77,3.3,2.9,4
6/11/18,18,0,3,6,0,27,11,0,11,0,9,31,98,78,3.3,2.9,4
6/12/18,15,0,1,5,0,21,7,0,6,0,7,20,100,78,3.3,2.9,4
6/13/18,9,0,5,7,0,21,8,0,5,0,7,20,99,78,3.3,2.9,4
6/14/18,16,0,1,14,0,31,11,0,2,0,16,29,99,76,3.3,2.9,4
6/15/18,14,0,0,5,0,19,9,0,5,0,3,17,98,75,3.3,2.9,4
6/16/18,21,0,3,2,0,26,7,0,9,0,1,17,94,76,3.3,2.9,4
6/17/18,14,0,2,0,0,16,11,0,5,0,11,27,94,75,3.3,2.9,4
6/18/18,19,0,1,11,0,31,10,0,9,0,7,26,93,76,3.3,2.9,4
6/19/18,18,0,1,1,0,20,5,0,3,0,7,15,80,74,3.3,2.9,4
6/20/18,28,0,0,8,0,36,6,1,3,0,5,15,84,75,3.3,2.9,4
6/21/18,34,0,3,3,0,40,13,0,7,0,15,35,94,74,3.3,2.9,4
6/22/18,17,0,1,3,0,21,25,0,6,1,2,34,101,76,3.3,2.9,4
6/23/18,24,0,0,5,0,29,11,2,4,0,1,18,100,76,3.3,2.9,4
6/24/18,12,0,0,2,0,14,19,0,5,0,5,29,100,78,3.3,2.9,4
6/25/18,17,0,0,3,0,20,20,0,11,0,13,44,95,77,3.3,2.9,4
6/26/18,12,0,4,2,0,18,22,0,9,0,5,36,100,78,3.3,2.9,4
6/27/18,40,0,2,7,0,49,13,0,6,0,5,24,101,76,3.3,2.9,4
6/28/18,20,0,1,6,0,27,15,0,7,0,5,27,100,76,3.3,2.9,4
6/29/18,18,0,1,5,0,24,14,0,5,0,2,21,100,78,3.3,2.9,4
6/30/18,11,0,2,4,0,17,23,0,5,0,0,28,101,78,3.3,2.9,4
7/1/18,12,0,1,11,0,24,18,0,7,1,9,35,104,77,3.2,2.9,3.8
7/2/18,30,0,4,7,0,41,13,1,6,0,1,21,102,76,3.2,2.9,3.8
7/3/18,25,0,8,3,0,36,8,0,5,0,1,14,103,76,3.2,2.9,3.8
7/4/18,13,0,2,5,0,20,10,0,7,0,20,37,97,72,3.2,2.9,3.8
7/5/18,38,0,3,1,0,42,11,0,11,2,13,37,94,72,3.2,2.9,3.8
7/6/18,38,0,1,3,0,42,17,0,11,0,1,29,96,76,3.2,2.9,3.8
7/7/18,22,0,2,2,0,26,18,1,11,1,1,32,94,75,3.2,2.9,3.8
7/8/18,21,0,2,3,0,26,15,0,10,0,7,32,93,73,3.2,2.9,3.8
7/9/18,34,0,0,8,0,42,19,0,15,0,13,47,83,73,3.2,2.9,3.8
7/10/18,20,0,7,8,0,35,8,0,13,1,4,26,93,73,3.2,2.9,3.8
7/11/18,32,0,0,5,0,37,10,0,4,1,9,24,96,74,3.2,2.9,3.8
7/12/18,16,0,4,2,0,22,14,0,7,0,9,30,96,75,3.2,2.9,3.8
7/13/18,18,0,1,2,0,21,26,1,2,0,2,31,96,76,3.2,2.9,3.8
7/14/18,22,0,1,10,0,33,9,0,14,1,4,28,97,77,3.2,2.9,3.8
7/15/18,16,0,6,7,0,29,21,0,5,1,0,27,97,78,3.2,2.9,3.8
7/16/18,14,0,5,5,0,24,13,1,4,0,7,25,99,76,3.2,2.9,3.8
7/17/18,16,0,4,5,0,25,10,0,7,0,11,28,101,74,3.2,2.9,3.8
7/18/18,20,0,1,4,0,25,6,0,8,1,9,24,102,77,3.2,2.9,3.8
7/19/18,20,0,1,4,0,25,6,0,2,0,1,9,103,77,3.2,2.9,3.8
7/20/18,20,0,1,4,0,25,16,0,5,0,5,26,103,77,3.2,2.9,3.8
7/21/18,18,0,5,6,0,29,14,0,3,0,7,24,104,75,3.2,2.9,3.8
7/22/18,10,0,0,5,0,15,11,0,9,0,6,26,106,76,3.2,2.9,3.8
7/23/18,24,0,3,10,0,37,7,0,6,0,16,29,110,78,3.2,2.9,3.8
7/24/18,22,0,0,6,0,28,7,0,9,0,3,19,101,84,3.2,2.9,3.8
7/25/18,14,0,3,9,0,26,14,0,6,0,9,29,101,77,3.2,2.9,3.8
7/26/18,8,0,3,4,0,15,9,0,5,0,10,24,101,76,3.2,2.9,3.8
7/27/18,15,0,7,4,0,26,23,0,11,0,1,35,103,76,3.2,2.9,3.8
7/28/18,17,0,2,4,0,23,27,0,4,0,0,31,102,74,3.2,2.9,3.8
7/29/18,8,0,2,5,0,15,17,0,1,0,14,32,103,77,3.2,2.9,3.8
7/30/18,5,0,3,7,0,15,10,0,2,0,6,18,100,78,3.2,2.9,3.8
7/31/18,20,0,4,9,0,33,8,0,5,0,2,15,98,80,3.2,2.9,3.8
8/1/18,13,0,2,8,0,23,6,0,9,0,12,27,100,72,3.1,2.7,3.8
8/2/18,19,0,1,0,0,20,8,0,6,0,8,22,100,70,3.1,2.7,3.8
8/3/18,19,0,3,5,0,27,13,0,6,1,0,20,99,74,3.1,2.7,3.8
8/4/18,24,0,1,7,0,32,15,0,5,0,1,21,101,74,3.1,2.7,3.8
8/5/18,21,0,1,6,0,28,12,0,11,0,13,36,98,77,3.1,2.7,3.8
8/6/18,19,0,3,19,0,41,4,0,7,0,12,23,98,76,3.1,2.7,3.8
8/7/18,16,0,5,23,0,44,15,0,2,0,10,27,100,77,3.1,2.7,3.8
8/8/18,21,0,2,1,0,24,9,0,10,0,5,24,102,78,3.1,2.7,3.8
8/9/18,19,0,2,7,0,28,12,1,6,0,5,24,101,76,3.1,2.7,3.8
8/10/18,17,0,0,12,0,29,13,0,7,0,1,21,96,78,3.1,2.7,3.8
8/11/18,15,0,0,1,0,16,36,0,5,0,16,57,96,75,3.1,2.7,3.8
8/12/18,15,0,2,2,0,19,15,0,4,0,7,26,90,74,3.1,2.7,3.8
8/13/18,25,0,3,2,0,30,16,0,12,0,28,56,99,77,3.1,2.7,3.8
8/14/18,19,0,3,5,0,27,18,0,7,0,7,32,100,76,3.1,2.7,3.8
8/15/18,22,0,4,2,0,28,11,0,6,0,6,23,102,77,3.1,2.7,3.8
8/16/18,23,0,3,2,0,28,16,0,7,2,10,35,103,78,3.1,2.7,3.8
8/17/18,21,0,1,5,0,27,66,0,4,0,1,71,105,76,3.1,2.7,3.8
8/18/18,11,0,2,10,0,23,31,0,4,0,1,36,104,77,3.1,2.7,3.8
8/19/18,20,0,2,5,0,27,16,0,2,0,3,21,103,77,3.1,2.7,3.8
8/20/18,15,0,7,8,0,30,18,0,5,0,5,28,104,79,3.1,2.7,3.8
8/21/18,8,0,3,5,0,16,17,1,13,0,2,33,104,78,3.1,2.7,3.8
8/22/18,15,0,5,8,0,28,14,0,10,0,5,29,104,80,3.1,2.7,3.8
8/23/18,15,0,2,10,0,27,21,0,6,0,4,31,104,77,3.1,2.7,3.8
8/24/18,25,0,3,10,0,38,14,0,9,0,0,23,103,77,3.1,2.7,3.8
8/25/18,13,0,3,5,0,21,11,0,9,0,7,27,102,78,3.1,2.7,3.8
8/26/18,19,0,4,5,0,28,11,0,7,0,2,20,102,79,3.1,2.7,3.8
8/27/18,12,0,2,4,0,18,14,1,1,1,1,18,102,79,3.1,2.7,3.8
8/28/18,11,0,2,6,0,19,6,0,4,0,2,12,103,79,3.1,2.7,3.8
8/29/18,26,0,1,4,0,31,5,1,8,0,1,15,102,79,3.1,2.7,3.8
8/30/18,14,0,0,5,0,19,10,0,11,0,0,21,99,77,3.1,2.7,3.8
8/31/18,18,0,4,6,0,28,12,0,9,0,4,25,100,74,3.1,2.7,3.8
9/1/18,17,0,2,8,0,27,14,0,7,1,2,24,100,75,3,2.3,3.7
9/2/18,17,0,5,6,0,28,24,1,11,0,5,41,99,77,3,2.3,3.7
9/3/18,29,0,3,4,0,36,11,1,4,0,7,23,97,76,3,2.3,3.7
9/4/18,13,0,1,6,0,20,8,0,12,0,7,27,93,74,3,2.3,3.7
9/5/18,26,0,3,7,0,36,10,1,6,0,13,30,96,76,3,2.3,3.7
9/6/18,15,0,2,3,0,20,7,0,13,0,5,25,97,75,3,2.3,3.7
9/7/18,24,0,2,4,0,30,18,0,13,0,5,36,89,75,3,2.3,3.7
9/8/18,29,0,1,8,0,38,13,0,14,2,1,30,89,74,3,2.3,3.7
9/9/18,17,0,3,8,0,28,7,0,5,0,1,13,79,73,3,2.3,3.7
9/10/18,38,0,2,7,0,47,12,0,8,0,20,40,77,71,3,2.3,3.7
9/11/18,28,0,5,2,0,35,9,1,7,0,15,32,85,71,3,2.3,3.7
9/12/18,19,0,7,7,0,33,11,0,11,0,14,36,88,74,3,2.3,3.7
9/13/18,29,0,7,1,0,37,15,1,11,0,7,34,92,74,3,2.3,3.7
9/14/18,21,0,1,6,0,28,16,0,6,0,1,23,85,73,3,2.3,3.7
9/15/18,17,0,2,8,0,27,7,0,8,0,0,15,86,74,3,2.3,3.7
9/16/18,19,0,0,5,0,24,22,1,9,0,2,34,91,74,3,2.3,3.7
9/17/18,17,0,3,7,0,27,18,0,7,0,21,46,93,71,3,2.3,3.7
9/18/18,14,0,1,5,0,20,17,1,3,0,2,23,95,73,3,2.3,3.7
9/19/18,13,0,2,13,0,28,11,0,8,0,5,24,94,72,3,2.3,3.7
9/20/18,25,0,3,6,0,34,14,0,10,0,10,34,90,74,3,2.3,3.7
9/21/18,28,0,3,7,0,38,17,0,14,0,6,37,88,77,3,2.3,3.7
9/22/18,25,0,1,11,0,37,10,1,8,0,2,21,79,68,3,2.3,3.7
9/23/18,31,0,3,9,0,43,13,0,11,0,10,34,79,68,3,2.3,3.7
9/24/18,35,0,1,9,0,45,11,0,11,0,13,35,87,71,3,2.3,3.7
9/25/18,23,0,2,10,0,35,8,0,12,1,10,31,95,75,3,2.3,3.7
9/26/18,12,0,1,5,0,18,8,0,4,0,3,15,88,68,3,2.3,3.7
9/27/18,22,0,0,6,0,28,6,0,13,0,13,32,82,62,3,2.3,3.7
9/28/18,18,0,3,4,0,25,14,0,7,0,5,26,83,63,3,2.3,3.7
9/29/18,20,0,0,6,0,26,16,0,3,0,2,21,78,72,3,2.3,3.7
9/30/18,18,0,1,6,0,25,10,0,9,0,10,29,87,71,3,2.3,3.7
10/1/18,15,0,2,12,0,29,7,0,5,0,5,17,87,71,2.8,2.5,3.8
10/2/18,13,0,4,2,0,19,5,0,10,1,4,20,88,73,2.8,2.5,3.8
10/3/18,23,0,3,6,0,32,4,0,6,1,4,15,91,75,2.8,2.5,3.8
10/4/18,23,0,2,6,0,31,25,0,6,0,2,33,91,74,2.8,2.5,3.8
10/5/18,19,0,4,1,0,24,18,0,11,0,1,30,90,75,2.8,2.5,3.8
10/6/18,31,0,3,8,0,42,24,0,6,0,1,31,89,76,2.8,2.5,3.8
10/7/18,12,0,0,6,0,18,21,0,4,0,14,39,88,72,2.8,2.5,3.8
10/8/18,20,0,6,7,0,33,17,1,4,0,11,33,84,72,2.8,2.5,3.8
10/9/18,35,0,2,7,0,44,15,0,10,0,2,27,81,68,2.8,2.5,3.8
10/10/18,35,0,0,4,0,39,7,0,9,0,5,21,80,63,2.8,2.5,3.8
10/11/18,21,0,2,3,0,26,9,0,15,0,4,28,75,61,2.8,2.5,3.8
10/12/18,25,0,0,8,0,33,15,0,12,1,5,33,86,63,2.8,2.5,3.8
10/13/18,29,0,7,14,0,50,18,0,4,0,3,25,90,68,2.8,2.5,3.8
10/14/18,24,0,2,2,0,28,16,0,11,0,7,34,90,67,2.8,2.5,3.8
10/15/18,10,0,3,1,0,14,17,0,6,0,10,33,70,44,2.8,2.5,3.8
10/16/18,16,0,1,0,0,17,17,0,6,0,7,30,50,46,2.8,2.5,3.8
10/17/18,19,0,2,5,0,26,13,1,5,0,2,21,59,50,2.8,2.5,3.8
10/18/18,19,0,1,3,0,23,13,0,5,0,8,26,60,53,2.8,2.5,3.8
10/19/18,27,0,1,13,0,41,20,0,4,0,4,28,64,59,2.8,2.5,3.8
10/20/18,38,0,5,6,0,49,7,0,9,0,6,22,67,62,2.8,2.5,3.8
10/21/18,27,0,1,6,0,34,18,0,14,0,4,36,74,56,2.8,2.5,3.8
10/22/18,30,0,5,4,0,39,22,0,14,0,2,38,65,55,2.8,2.5,3.8
10/23/18,44,0,2,7,0,53,12,0,12,0,22,46,70,54,2.8,2.5,3.8
10/24/18,18,0,3,6,0,27,8,0,10,0,4,22,63,57,2.8,2.5,3.8
10/25/18,20,0,1,3,0,24,7,0,9,0,15,31,69,55,2.8,2.5,3.8
10/26/18,9,0,1,5,0,15,16,0,3,0,13,32,80,52,2.8,2.5,3.8
10/27/18,30,0,1,7,0,38,9,0,3,0,3,15,86,54,2.8,2.5,3.8
10/28/18,9,0,1,4,0,14,10,0,4,0,5,19,85,59,2.8,2.5,3.8
10/29/18,22,0,1,8,0,31,6,0,10,0,10,26,84,62,2.8,2.5,3.8
10/30/18,24,0,2,5,0,31,7,0,9,0,4,20,84,67,2.8,2.5,3.8
10/31/18,22,0,1,10,0,33,2,0,6,0,12,20,82,57,2.8,2.5,3.8
11/1/18,17,0,3,7,0,27,6,0,12,0,8,26,70,49,2.8,2.2,3.8
11/2/18,14,0,4,6,0,24,8,0,7,0,4,19,76,46,2.8,2.2,3.8
11/3/18,15,0,1,3,0,19,6,0,11,0,8,25,79,51,2.8,2.2,3.8
11/4/18,22,0,1,2,0,25,6,0,9,0,3,18,74,56,2.8,2.2,3.8
11/5/18,22,0,3,7,0,32,5,0,5,0,7,17,80,55,2.8,2.2,3.8
11/6/18,19,0,2,3,0,24,3,0,7,1,11,22,79,60,2.8,2.2,3.8
11/7/18,22,0,5,6,0,33,6,0,6,0,5,17,86,63,2.8,2.2,3.8
11/8/18,16,0,2,10,0,28,5,0,7,0,6,18,63,56,2.8,2.2,3.8
11/9/18,30,0,1,5,0,36,7,1,10,0,2,20,59,50,2.8,2.2,3.8
11/10/18,20,0,2,6,0,28,6,0,8,0,2,16,54,46,2.8,2.2,3.8
11/11/18,28,0,1,1,0,30,1,0,15,0,9,25,55,47,2.8,2.2,3.8
11/12/18,25,0,0,3,0,28,7,0,13,0,12,32,50,37,2.8,2.2,3.8
11/13/18,20,0,4,4,0,28,1,0,8,0,14,23,48,34,2.8,2.2,3.8
11/14/18,23,0,2,1,0,26,3,0,11,0,3,17,55,29,2.8,2.2,3.8
11/15/18,16,0,9,3,0,28,6,0,9,0,7,22,65,31,2.8,2.2,3.8
11/16/18,20,0,1,4,0,25,10,0,12,0,4,26,71,37,2.8,2.2,3.8
11/17/18,18,0,3,6,0,27,2,0,6,0,1,9,74,44,2.8,2.2,3.8
11/18/18,20,0,0,4,0,24,6,0,6,0,1,13,64,44,2.8,2.2,3.8
11/19/18,34,0,4,3,0,41,2,0,5,0,11,18,53,43,2.8,2.2,3.8
11/20/18,20,0,3,9,0,32,0,0,4,0,5,9,63,41,2.8,2.2,3.8
11/21/18,23,0,0,3,0,26,0,0,3,0,0,3,56,40,2.8,2.2,3.8
11/22/18,1,0,0,0,0,1,19,0,7,0,4,30,63,50,2.8,2.2,3.8
11/23/18,32,0,1,7,0,40,9,0,14,0,2,25,79,50,2.8,2.2,3.8
11/24/18,20,0,4,3,0,27,8,1,5,0,4,18,76,48,2.8,2.2,3.8
11/25/18,26,0,1,5,0,32,8,1,7,0,15,31,69,49,2.8,2.2,3.8
11/26/18,13,0,1,4,0,18,6,0,7,0,8,21,61,38,2.8,2.2,3.8
11/27/18,14,0,1,10,0,25,6,0,10,1,4,21,64,33,2.8,2.2,3.8
11/28/18,14,0,1,4,0,19,7,0,2,0,14,23,73,46,2.8,2.2,3.8
11/29/18,16,0,3,6,0,25,13,0,3,0,3,19,76,54,2.8,2.2,3.8
11/30/18,10,0,4,3,0,17,2,0,2,0,2,6,78,66,2.8,2.2,3.8
12/1/18,18,0,4,3,0,25,7,0,10,0,2,19,78,51,2.8,1.9,3.9
12/2/18,23,0,1,1,0,25,6,0,8,0,5,19,70,49,2.8,1.9,3.9
12/3/18,26,0,4,14,0,44,17,0,9,0,14,40,63,48,2.8,1.9,3.9
12/4/18,12,0,3,10,0,25,8,0,9,0,5,22,58,39,2.8,1.9,3.9
12/5/18,20,0,4,7,0,31,17,0,5,0,15,37,55,40,2.8,1.9,3.9
12/6/18,12,0,6,4,0,22,12,1,4,0,4,21,56,51,2.8,1.9,3.9
12/7/18,22,0,0,10,0,32,14,0,7,2,0,23,56,46,2.8,1.9,3.9
12/8/18,21,0,5,2,0,28,9,0,4,0,2,15,47,41,2.8,1.9,3.9
12/9/18,20,0,3,1,0,24,15,0,12,0,2,29,56,37,2.8,1.9,3.9
12/10/18,28,0,6,7,0,41,19,0,17,0,9,45,60,35,2.8,1.9,3.9
12/11/18,15,0,6,1,0,22,19,0,8,0,6,33,63,32,2.8,1.9,3.9
12/12/18,20,0,1,4,0,25,16,0,8,0,7,31,66,50,2.8,1.9,3.9
12/13/18,22,0,4,3,0,29,31,0,14,0,17,62,70,44,2.8,1.9,3.9
12/14/18,29,0,1,5,0,35,24,0,15,0,2,41,53,43,2.8,1.9,3.9
12/15/18,16,0,1,8,0,25,26,0,12,0,14,52,69,42,2.8,1.9,3.9
12/16/18,14,0,1,2,0,17,24,0,7,0,5,36,64,39,2.8,1.9,3.9
12/17/18,13,0,1,3,0,17,21,0,5,0,2,28,70,44,2.8,1.9,3.9
12/18/18,10,0,0,4,0,14,11,0,7,1,3,22,64,38,2.8,1.9,3.9
12/19/18,17,0,1,7,0,25,25,0,11,0,0,36,61,53,2.8,1.9,3.9
12/20/18,17,0,4,12,0,33,17,0,16,0,2,35,65,50,2.8,1.9,3.9
12/21/18,17,0,3,7,0,27,18,0,8,0,1,27,67,41,2.8,1.9,3.9
12/22/18,16,0,0,13,0,29,22,0,7,0,2,31,81,45,2.8,1.9,3.9
12/23/18,25,0,0,3,0,28,12,0,8,0,3,23,63,46,2.8,1.9,3.9
12/24/18,18,0,1,0,0,19,1,0,1,0,1,3,61,36,2.8,1.9,3.9
12/25/18,4,0,0,0,0,4,19,0,3,0,5,27,74,59,2.8,1.9,3.9
12/26/18,18,0,2,11,0,31,30,0,12,0,2,44,70,53,2.8,1.9,3.9
12/27/18,28,0,6,12,0,46,19,0,4,0,10,33,70,49,2.8,1.9,3.9
12/28/18,25,0,3,8,0,36,13,1,14,1,5,34,55,40,2.8,1.9,3.9
12/29/18,10,0,0,6,0,16,21,0,5,0,1,27,47,42,2.8,1.9,3.9
12/30/18,10,0,2,4,0,16,13,0,5,0,8,26,42,38,2.8,1.9,3.9
12/31/18,17,0,2,7,0,26,1,0,4,0,0,5,64,40,2.8,1.9,3.9
1/1/19,12,0,0,2,0,14,19,0,13,0,2,34,46,39,3.3,1.6,4
1/2/19,38,0,4,4,0,46,20,0,9,0,7,36,41,36,3.3,1.6,4
1/3/19,29,0,1,5,0,35,22,0,10,0,1,33,52,34,3.3,1.6,4
1/4/19,20,0,3,7,0,30,18,0,10,0,3,31,66,32,3.3,1.6,4
1/5/19,23,0,1,4,0,28,15,0,5,1,3,24,75,37,3.3,1.6,4
1/6/19,20,0,3,7,0,30,21,0,9,0,6,36,72,42,3.3,1.6,4
1/7/19,23,0,3,3,0,29,12,1,9,0,21,43,77,59,3.3,1.6,4
1/8/19,24,0,0,2,0,26,14,1,11,1,3,30,77,53,3.3,1.6,4
1/9/19,28,0,3,4,0,35,15,0,7,0,1,23,62,46,3.3,1.6,4
1/10/19,28,0,2,3,0,33,26,0,11,0,2,39,60,42,3.3,1.6,4
1/11/19,23,0,2,10,0,35,20,0,8,0,2,30,61,48,3.3,1.6,4
1/12/19,23,0,4,7,0,34,17,0,7,0,9,33,61,44,3.3,1.6,4
1/13/19,16,0,1,2,0,19,15,0,13,0,3,31,54,37,3.3,1.6,4
1/14/19,25,0,0,9,0,34,13,1,7,0,8,29,52,38,3.3,1.6,4
1/15/19,19,0,2,4,0,25,21,0,5,0,10,36,51,45,3.3,1.6,4
1/16/19,13,0,1,8,0,22,16,0,1,0,7,24,57,50,3.3,1.6,4
1/17/19,25,0,5,3,0,33,17,0,2,0,8,27,77,53,3.3,1.6,4
1/18/19,26,0,7,5,0,38,32,0,10,0,3,45,66,50,3.3,1.6,4
1/19/19,29,0,2,4,0,35,20,0,10,0,0,30,62,39,3.3,1.6,4
1/20/19,19,0,0,6,0,25,24,0,13,0,9,46,54,32,3.3,1.6,4
1/21/19,18,0,2,7,0,27,22,1,6,0,1,30,67,36,3.3,1.6,4
1/22/19,16,0,0,13,0,29,22,0,10,0,14,46,69,42,3.3,1.6,4
1/23/19,11,0,3,8,0,22,16,1,5,0,3,25,56,34,3.3,1.6,4
1/24/19,6,0,2,7,0,15,17,0,2,0,3,22,64,32,3.3,1.6,4
1/25/19,28,0,2,2,0,32,23,0,13,0,0,36,61,40,3.3,1.6,4
1/26/19,17,0,3,12,0,32,19,0,5,0,1,25,64,42,3.3,1.6,4
1/27/19,19,0,1,9,0,29,18,0,3,0,5,26,67,43,3.3,1.6,4
1/28/19,9,0,3,3,0,15,12,2,8,0,10,32,73,44,3.3,1.6,4
1/29/19,22,0,3,6,0,31,14,0,9,0,7,30,50,36,3.3,1.6,4
1/30/19,23,0,2,2,0,27,8,2,10,0,9,29,55,40,3.3,1.6,4
1/31/19,13,0,1,5,0,19,11,0,11,0,4,26,58,46,3.3,1.6,4
2/1/19,20,0,2,10,0,32,13,0,7,1,3,24,65,57,3,1.5,3.8
2/2/19,29,0,5,8,0,42,20,0,4,0,3,27,64,59,3,1.5,3.8
2/3/19,13,0,1,2,0,16,9,1,6,1,1,18,76,62,3,1.5,3.8
2/4/19,27,0,2,12,0,41,8,0,9,0,5,22,77,66,3,1.5,3.8
2/5/19,19,0,2,6,0,27,15,0,8,0,9,32,79,67,3,1.5,3.8
2/6/19,13,0,2,7,0,22,14,0,5,0,8,27,76,68,3,1.5,3.8
2/7/19,24,0,1,8,0,33,9,0,7,0,2,18,72,39,3,1.5,3.8
2/8/19,20,0,4,5,0,29,20,0,8,0,5,33,39,33,3,1.5,3.8
2/9/19,15,0,3,5,0,23,18,0,5,0,3,26,41,33,3,1.5,3.8
2/10/19,21,0,0,3,0,24,22,0,8,0,1,31,47,37,3,1.5,3.8
2/11/19,10,0,2,8,0,20,18,0,9,0,13,40,63,47,3,1.5,3.8
2/12/19,31,0,4,4,0,39,18,0,10,0,8,36,65,40,3,1.5,3.8
2/13/19,24,0,0,7,0,31,21,0,8,0,5,34,66,32,3,1.5,3.8
2/14/19,11,0,2,7,0,20,17,0,11,1,7,36,75,52,3,1.5,3.8
2/15/19,15,0,3,9,0,27,21,0,7,0,1,29,91,54,3,1.5,3.8
2/16/19,20,0,2,4,0,26,12,0,5,0,1,18,62,42,3,1.5,3.8
2/17/19,14,0,0,8,0,22,14,0,12,0,7,33,63,49,3,1.5,3.8
2/18/19,25,0,0,6,0,31,13,0,6,0,11,30,59,44,3,1.5,3.8
2/19/19,11,0,2,16,0,29,16,2,5,0,2,25,45,40,3,1.5,3.8
2/20/19,19,0,5,4,0,28,11,1,5,0,3,20,65,41,3,1.5,3.8
2/21/19,25,0,2,3,0,30,14,2,9,0,5,30,56,46,3,1.5,3.8
2/22/19,18,0,1,5,0,24,13,0,7,0,1,21,59,50,3,1.5,3.8
2/23/19,17,0,0,4,0,21,17,0,8,1,4,30,75,53,3,1.5,3.8
2/24/19,21,0,2,7,0,30,18,1,8,0,6,33,65,45,3,1.5,3.8
2/25/19,16,0,0,8,0,24,9,0,8,0,10,27,68,43,3,1.5,3.8
2/26/19,20,0,4,12,0,36,11,0,8,0,14,33,69,54,3,1.5,3.8
2/27/19,11,0,2,7,0,20,10,0,10,0,2,22,79,51,3,1.5,3.8
2/28/19,24,0,3,1,0,28,11,0,8,0,6,25,51,39,3,1.5,3.8
3/1/19,24,0,4,7,0,35,11,1,8,0,2,22,54,42,2.7,1.9,3.8
3/2/19,19,0,5,13,0,37,24,0,7,0,2,33,54,45,2.7,1.9,3.8
3/3/19,25,0,2,6,0,33,15,0,12,0,5,32,45,33,2.7,1.9,3.8
3/4/19,27,0,5,4,0,36,3,0,8,0,12,23,38,29,2.7,1.9,3.8
3/5/19,31,0,1,12,0,44,9,0,7,4,3,23,48,26,2.7,1.9,3.8
3/6/19,25,0,1,7,0,33,12,1,9,1,7,30,59,29,2.7,1.9,3.8
3/7/19,27,0,3,12,0,42,23,1,10,0,9,43,75,50,2.7,1.9,3.8
3/8/19,19,0,1,7,0,27,32,0,7,0,11,50,84,64,2.7,1.9,3.8
3/9/19,22,0,1,5,0,28,21,0,14,0,2,37,87,58,2.7,1.9,3.8
3/10/19,28,0,2,3,0,33,15,0,10,0,7,32,78,55,2.7,1.9,3.8
3/11/19,23,0,1,7,0,31,21,0,9,0,8,38,65,57,2.7,1.9,3.8
3/12/19,24,0,1,10,0,35,10,2,5,0,6,23,78,58,2.7,1.9,3.8
3/13/19,19,0,2,4,0,25,9,0,2,0,5,16,83,55,2.7,1.9,3.8
3/14/19,12,0,4,10,0,26,10,0,10,2,9,31,76,59,2.7,1.9,3.8
3/15/19,23,0,1,4,0,28,27,0,16,1,0,44,60,50,2.7,1.9,3.8
3/16/19,21,0,4,11,0,36,9,0,6,0,0,15,63,47,2.7,1.9,3.8
3/17/19,11,0,2,7,0,20,19,0,6,0,6,31,68,43,2.7,1.9,3.8
3/18/19,27,0,3,8,0,38,18,0,6,0,5,29,71,46,2.7,1.9,3.8
3/19/19,23,0,5,2,0,30,11,0,9,0,21,41,72,47,2.7,1.9,3.8
3/20/19,17,0,3,13,0,33,13,0,6,0,7,26,78,54,2.7,1.9,3.8
3/21/19,39,0,2,5,0,46,19,0,5,0,26,50,80,50,2.7,1.9,3.8
3/22/19,28,0,3,6,0,37,24,0,5,0,1,30,81,50,2.7,1.9,3.8
3/23/19,13,0,4,13,0,30,10,1,6,0,3,20,75,62,2.7,1.9,3.8
3/24/19,10,0,1,8,0,19,16,1,10,0,14,41,83,66,2.7,1.9,3.8
3/25/19,16,0,6,11,0,33,23,0,13,2,7,45,82,64,2.7,1.9,3.8
3/26/19,20,0,3,6,0,29,16,0,8,0,17,41,79,56,2.7,1.9,3.8
3/27/19,18,0,6,4,0,28,13,0,6,1,1,21,79,53,2.7,1.9,3.8
3/28/19,23,0,3,5,0,31,12,0,7,0,8,27,80,56,2.7,1.9,3.8
3/29/19,12,0,3,5,0,20,17,0,7,1,2,27,80,62,2.7,1.9,3.8
3/30/19,18,0,3,6,0,27,19,0,11,0,2,32,71,50,2.7,1.9,3.8
3/31/19,26,0,3,4,0,33,12,1,5,0,4,22,59,43,2.7,1.9,3.8
4/1/19,19,0,2,11,0,32,17,2,9,0,11,39,64,40,2.3,2,3.7
4/2/19,8,0,4,8,0,20,15,0,9,1,11,36,74,40,2.3,2,3.7
4/3/19,19,0,2,15,0,36,13,1,9,0,4,27,70,55,2.3,2,3.7
4/4/19,16,0,4,7,0,27,14,1,5,0,0,20,92,65,2.3,2,3.7
4/5/19,16,0,4,2,0,22,10,0,8,0,7,25,83,64,2.3,2,3.7
4/6/19,14,0,0,4,0,18,17,0,5,0,7,29,73,66,2.3,2,3.7
4/7/19,29,0,3,4,0,36,7,0,18,0,6,31,70,62,2.3,2,3.7
4/8/19,35,0,0,6,0,41,8,0,5,0,8,21,89,60,2.3,2,3.7
4/9/19,28,0,3,12,0,43,15,1,11,0,20,47,90,57,2.3,2,3.7
4/10/19,30,0,1,4,0,35,8,0,16,1,3,28,93,62,2.3,2,3.7
4/11/19,23,0,0,10,0,33,20,0,12,0,13,45,84,59,2.3,2,3.7
4/12/19,16,0,5,1,0,22,36,0,9,0,0,45,79,54,2.3,2,3.7
4/13/19,25,0,2,6,0,33,19,1,11,0,3,34,68,48,2.3,2,3.7
4/14/19,16,0,3,6,0,25,12,0,11,0,25,48,75,46,2.3,2,3.7
4/15/19,25,0,1,8,0,34,16,0,4,0,6,26,82,52,2.3,2,3.7
4/16/19,13,0,3,10,0,26,6,0,8,0,8,22,84,64,2.3,2,3.7
4/17/19,22,0,3,15,0,40,6,0,14,0,15,35,84,61,2.3,2,3.7
4/18/19,33,0,0,6,0,39,13,1,8,0,4,26,76,57,2.3,2,3.7
4/19/19,21,0,3,5,0,29,12,1,8,0,1,22,77,52,2.3,2,3.7
4/20/19,16,0,0,6,0,22,15,1,3,0,1,20,84,47,2.3,2,3.7
4/21/19,10,0,2,4,0,16,9,0,7,0,4,20,85,58,2.3,2,3.7
4/22/19,19,0,3,8,0,30,20,0,10,0,9,39,80,67,2.3,2,3.7
4/23/19,13,0,0,13,0,26,15,0,7,0,10,32,80,68,2.3,2,3.7
4/24/19,10,0,1,4,0,15,6,0,11,0,7,24,70,58,2.3,2,3.7
4/25/19,22,0,2,8,0,32,17,0,12,1,11,41,88,57,2.3,2,3.7
4/26/19,30,0,2,16,0,48,17,0,7,0,0,24,83,63,2.3,2,3.7
4/27/19,23,0,9,6,0,38,16,0,7,0,1,24,86,60,2.3,2,3.7
4/28/19,21,0,1,3,0,25,4,0,8,0,8,20,86,66,2.3,2,3.7
4/29/19,19,0,3,10,0,32,20,2,4,0,18,44,85,69,2.3,2,3.7
4/30/19,15,0,4,5,0,24,9,0,9,1,6,25,83,74,2.3,2,3.7
5/1/19,18,0,5,4,0,27,9,1,4,1,3,18,83,75,2.4,1.8,3.6
5/2/19,23,0,1,8,0,32,8,0,12,0,1,21,79,63,2.4,1.8,3.6
5/3/19,20,0,3,6,0,29,10,1,7,0,9,27,82,64,2.4,1.8,3.6
5/4/19,36,0,2,9,0,47,24,0,8,0,2,34,83,61,2.4,1.8,3.6
5/5/19,17,0,1,6,0,24,8,0,20,0,5,33,86,60,2.4,1.8,3.6
5/6/19,27,0,3,7,0,37,4,0,17,0,8,29,76,67,2.4,1.8,3.6
5/7/19,20,0,1,4,0,25,12,0,15,0,6,33,87,68,2.4,1.8,3.6
5/8/19,34,0,1,8,0,43,10,0,9,0,9,28,78,66,2.4,1.8,3.6
5/9/19,24,0,2,7,0,33,14,0,9,0,2,25,87,63,2.4,1.8,3.6
5/10/19,29,0,4,5,0,38,18,0,9,0,6,33,68,55,2.4,1.8,3.6
5/11/19,30,0,3,17,0,50,42,0,13,0,2,57,66,57,2.4,1.8,3.6
5/12/19,21,0,1,2,0,24,18,2,4,1,15,40,80,60,2.4,1.8,3.6
5/13/19,11,0,2,6,0,19,23,1,7,1,12,44,84,56,2.4,1.8,3.6
5/14/19,18,0,1,1,0,20,23,0,11,0,5,39,82,63,2.4,1.8,3.6
5/15/19,25,0,0,7,0,32,16,3,7,0,13,39,86,64,2.4,1.8,3.6
5/16/19,17,0,3,4,0,24,5,1,4,1,1,12,87,67,2.4,1.8,3.6
5/17/19,15,0,0,5,0,20,10,1,14,0,3,28,90,73,2.4,1.8,3.6
5/18/19,28,0,1,8,0,37,11,0,5,0,3,19,85,76,2.4,1.8,3.6
5/19/19,15,0,0,8,0,23,11,0,6,0,7,24,91,76,2.4,1.8,3.6
5/20/19,29,0,4,20,0,53,11,0,10,0,3,24,90,77,2.4,1.8,3.6
5/21/19,23,0,3,3,0,29,11,0,7,1,10,29,88,64,2.4,1.8,3.6
5/22/19,15,0,1,3,0,19,14,1,5,0,4,24,91,74,2.4,1.8,3.6
5/23/19,32,0,4,4,0,40,8,0,5,0,6,19,92,76,2.4,1.8,3.6
5/24/19,20,0,1,11,0,32,23,0,10,1,3,37,90,75,2.4,1.8,3.6
5/25/19,14,0,3,8,0,25,16,0,11,0,6,33,91,75,2.4,1.8,3.6
5/26/19,14,0,2,3,0,19,12,2,3,0,7,24,91,74,2.4,1.8,3.6
5/27/19,16,0,2,9,0,27,15,0,11,0,14,40,90,74,2.4,1.8,3.6
5/28/19,35,0,3,12,0,50,14,0,8,0,17,39,89,74,2.4,1.8,3.6
5/29/19,16,0,3,2,0,21,12,0,5,0,4,21,92,76,2.4,1.8,3.6
5/30/19,25,0,3,9,0,37,14,0,9,1,8,32,86,72,2.4,1.8,3.6
5/31/19,19,0,2,3,0,24,13,0,10,0,7,30,91,72,2.4,1.8,3.6
6/1/19,19,0,3,3,0,25,19,0,5,2,2,28,92,75,2.9,1.6,3.6
6/2/19,31,0,2,6,0,39,20,0,14,0,13,47,94,74,2.9,1.6,3.6
6/3/19,37,0,2,6,0,45,21,1,10,0,2,34,93,74,2.9,1.6,3.6
6/4/19,40,0,5,6,0,51,8,1,8,0,13,30,84,74,2.9,1.6,3.6
6/5/19,20,0,2,14,0,36,12,0,9,0,6,27,91,74,2.9,1.6,3.6
6/6/19,24,0,3,6,0,33,13,1,5,0,20,39,90,67,2.9,1.6,3.6
6/7/19,22,0,4,5,0,31,22,1,6,0,9,38,95,71,2.9,1.6,3.6
6/8/19,20,0,2,7,0,29,20,1,4,3,3,31,98,70,2.9,1.6,3.6
6/9/19,17,0,2,6,0,25,16,1,14,2,5,38,98,71,2.9,1.6,3.6
6/10/19,36,0,3,12,0,51,21,0,7,0,9,37,88,74,2.9,1.6,3.6
6/11/19,20,0,3,8,0,31,16,1,9,1,9,36,81,69,2.9,1.6,3.6
6/12/19,14,0,4,7,0,25,16,0,5,1,17,39,90,66,2.9,1.6,3.6
6/13/19,22,0,2,8,0,32,16,3,6,0,9,34,91,71,2.9,1.6,3.6
6/14/19,15,0,2,16,0,33,16,0,8,0,6,30,92,70,2.9,1.6,3.6
6/15/19,22,0,2,1,0,25,30,1,8,2,4,45,95,76,2.9,1.6,3.6
6/16/19,14,0,0,8,0,22,14,0,6,3,2,25,95,69,2.9,1.6,3.6
6/17/19,33,0,1,10,0,44,13,0,6,0,14,33,90,69,2.9,1.6,3.6
6/18/19,23,0,2,9,0,34,13,2,7,0,16,38,95,72,2.9,1.6,3.6
6/19/19,34,0,1,4,0,39,16,0,11,1,6,34,97,78,2.9,1.6,3.6
6/20/19,11,0,1,3,0,15,13,0,10,0,3,26,97,77,2.9,1.6,3.6
6/21/19,23,0,4,9,0,36,14,0,9,1,1,25,95,80,2.9,1.6,3.6
6/22/19,31,0,3,5,0,39,13,0,6,0,4,23,93,75,2.9,1.6,3.6
6/23/19,20,0,1,4,0,25,7,0,11,1,4,23,96,80,2.9,1.6,3.6
6/24/19,23,0,2,10,0,35,6,0,8,0,19,33,83,67,2.9,1.6,3.6
6/25/19,22,0,2,6,0,30,11,0,6,0,12,29,94,68,2.9,1.6,3.6
6/26/19,37,0,3,5,0,45,17,0,8,0,38,63,93,71,2.9,1.6,3.6
6/27/19,22,0,2,13,0,37,17,0,7,0,38,62,95,72,2.9,1.6,3.6
6/28/19,8,0,2,5,0,15,32,1,3,0,7,43,94,73,2.9,1.6,3.6
6/29/19,12,0,3,1,0,16,32,0,6,0,4,42,96,68,2.9,1.6,3.6
6/30/19,14,0,3,10,0,27,18,2,8,0,1,29,86,68,2.9,1.6,3.6
7/1/19,25,0,3,11,0,39,15,0,3,1,12,31,92,74,3,1.8,3.7
7/2/19,21,0,2,7,0,30,18,0,9,1,7,35,93,75,3,1.8,3.7
7/3/19,26,0,3,5,0,34,8,0,1,0,0,9,92,75,3,1.8,3.7
7/4/19,2,0,4,1,0,7,19,0,15,0,16,50,93,76,3,1.8,3.7
7/5/19,42,0,5,12,0,59,23,1,5,0,3,32,96,78,3,1.8,3.7
7/6/19,29,0,9,18,0,56,23,1,10,1,1,36,95,77,3,1.8,3.7
7/7/19,12,0,10,8,0,30,11,0,11,0,8,30,97,77,3,1.8,3.7
7/8/19,48,0,0,0,0,48,13,0,11,0,15,39,97,72,3,1.8,3.7
7/9/19,10,0,4,1,0,15,15,0,10,1,20,46,97,75,3,1.8,3.7
7/10/19,31,0,24,6,0,61,9,0,7,0,5,21,98,77,3,1.8,3.7
7/11/19,32,0,3,9,0,44,16,0,4,0,4,24,98,75,3,1.8,3.7
7/12/19,22,0,5,5,0,32,5,1,5,0,14,25,99,76,3,1.8,3.7
7/13/19,18,0,2,13,0,33,13,1,4,0,1,19,97,75,3,1.8,3.7
7/14/19,13,0,0,6,0,19,13,0,9,0,6,28,100,79,3,1.8,3.7
7/15/19,17,0,3,9,0,29,18,1,19,0,6,44,98,77,3,1.8,3.7
7/16/19,18,0,6,7,0,31,19,1,9,0,19,48,100,78,3,1.8,3.7
7/17/19,16,0,5,7,0,28,9,0,6,0,9,24,100,78,3,1.8,3.7
7/18/19,9,0,4,4,0,17,4,2,25,0,9,40,100,78,3,1.8,3.7
7/19/19,19,0,1,7,0,27,22,0,10,0,7,39,100,77,3,1.8,3.7
7/20/19,21,0,2,10,0,33,15,0,7,1,0,23,100,78,3,1.8,3.7
7/21/19,18,0,1,3,0,22,8,0,13,0,4,25,100,76,3,1.8,3.7
7/22/19,30,0,7,5,0,42,17,0,6,0,22,45,99,77,3,1.8,3.7
7/23/19,13,0,4,7,0,24,18,1,6,0,14,39,95,80,3,1.8,3.7
7/24/19,29,0,6,3,0,38,14,2,8,0,2,26,92,74,3,1.8,3.7
7/25/19,9,0,1,2,0,12,10,1,9,0,3,23,93,63,3,1.8,3.7
7/26/19,28,0,3,6,0,37,14,0,6,0,2,22,93,66,3,1.8,3.7
7/27/19,12,0,2,16,0,30,18,1,12,0,3,34,97,71,3,1.8,3.7
7/28/19,26,0,5,6,0,37,14,0,4,0,1,19,101,77,3,1.8,3.7
7/29/19,17,0,2,10,0,29,11,1,3,1,12,28,101,77,3,1.8,3.7
7/30/19,14,0,4,5,0,23,13,1,3,0,5,22,103,78,3,1.8,3.7
7/31/19,29,0,4,7,0,40,9,0,6,0,6,21,103,76,3,1.8,3.7
8/1/19,15,0,5,12,0,32,10,0,12,0,1,23,100,77,2.9,1.7,3.6
8/2/19,20,0,4,4,0,28,10,1,7,0,14,32,100,77,2.9,1.7,3.6
8/3/19,25,0,1,2,0,28,17,0,11,0,5,33,98,80,2.9,1.7,3.6
8/4/19,26,0,0,9,0,35,11,0,6,0,13,30,95,75,2.9,1.7,3.6
8/5/19,29,0,2,6,0,37,14,1,6,0,7,28,100,77,2.9,1.7,3.6
8/6/19,22,0,1,3,0,26,15,0,9,0,8,32,102,78,2.9,1.7,3.6
8/7/19,24,0,5,3,0,32,16,0,9,0,12,37,102,79,2.9,1.7,3.6
8/8/19,10,0,1,3,0,14,17,1,5,0,6,29,104,79,2.9,1.7,3.6
8/9/19,18,0,3,11,0,32,22,0,2,1,1,26,105,80,2.9,1.7,3.6
8/10/19,12,0,3,3,0,18,23,0,11,2,2,38,104,79,2.9,1.7,3.6
8/11/19,12,0,2,6,0,20,13,0,5,1,7,26,104,78,2.9,1.7,3.6
8/12/19,23,0,4,4,0,31,16,0,4,0,13,33,105,79,2.9,1.7,3.6
8/13/19,26,0,3,6,0,35,13,0,5,3,9,30,105,79,2.9,1.7,3.6
8/14/19,9,0,2,2,0,13,18,0,4,0,4,26,104,79,2.9,1.7,3.6
8/15/19,44,0,0,11,0,55,16,0,8,3,9,36,103,78,2.9,1.7,3.6
8/16/19,23,0,1,11,0,35,60,0,9,0,0,69,104,79,2.9,1.7,3.6
8/17/19,24,0,0,8,0,32,25,0,5,0,0,30,104,80,2.9,1.7,3.6
8/18/19,19,0,4,3,0,26,28,0,11,0,5,44,103,80,2.9,1.7,3.6
8/19/19,10,0,5,10,0,25,14,0,2,0,1,17,103,80,2.9,1.7,3.6
8/20/19,22,0,3,10,0,35,14,0,10,0,12,36,103,79,2.9,1.7,3.6
8/21/19,28,0,0,3,0,31,16,0,5,1,11,33,101,78,2.9,1.7,3.6
8/22/19,21,0,0,11,0,32,18,3,7,0,9,37,102,78,2.9,1.7,3.6
8/23/19,20,0,0,3,0,23,14,0,3,0,3,20,100,79,2.9,1.7,3.6
8/24/19,27,0,0,6,0,33,24,0,8,0,1,33,99,75,2.9,1.7,3.6
8/25/19,13,0,2,12,0,27,9,0,6,0,2,17,101,76,2.9,1.7,3.6
8/26/19,22,0,0,6,0,28,17,0,6,0,12,35,102,79,2.9,1.7,3.6
8/27/19,24,0,5,2,0,31,19,1,8,0,5,33,94,80,2.9,1.7,3.6
8/28/19,19,0,1,10,0,30,8,1,9,0,16,34,102,76,2.9,1.7,3.6
8/29/19,20,0,5,9,0,34,24,0,4,0,2,30,102,77,2.9,1.7,3.6
8/30/19,14,0,6,5,0,25,13,1,3,0,11,28,100,79,2.9,1.7,3.6
8/31/19,32,0,8,11,0,51,20,0,4,0,2,26,100,76,2.9,1.7,3.6
9/1/19,13,0,0,6,0,19,9,2,6,0,7,24,99,76,2.7,1.7,3.5
9/2/19,33,0,2,7,0,42,10,1,5,0,14,30,102,76,2.7,1.7,3.5
9/3/19,21,0,12,9,0,42,7,0,14,1,7,29,101,74,2.7,1.7,3.5
9/4/19,16,0,2,6,0,24,12,0,6,0,2,20,102,75,2.7,1.7,3.5
9/5/19,22,0,2,2,0,26,15,2,4,0,13,34,102,74,2.7,1.7,3.5
9/6/19,18,0,1,2,0,21,18,0,6,0,6,30,103,77,2.7,1.7,3.5
9/7/19,14,0,2,2,0,18,15,0,12,0,2,29,103,77,2.7,1.7,3.5
9/8/19,22,0,2,7,0,31,17,1,6,1,9,34,102,77,2.7,1.7,3.5
9/9/19,21,0,1,9,0,31,11,0,18,0,16,45,101,78,2.7,1.7,3.5
9/10/19,19,0,1,12,0,32,8,0,8,1,6,23,101,74,2.7,1.7,3.5
9/11/19,29,0,3,12,0,44,14,0,9,1,3,27,100,74,2.7,1.7,3.5
9/12/19,34,0,1,4,0,39,16,0,8,1,5,30,100,74,2.7,1.7,3.5
9/13/19,19,0,1,9,0,29,23,0,6,0,0,29,98,75,2.7,1.7,3.5
9/14/19,15,0,2,14,0,31,22,0,7,0,2,31,100,75,2.7,1.7,3.5
9/15/19,18,0,2,7,0,27,18,2,5,0,10,35,98,73,2.7,1.7,3.5
9/16/19,24,0,2,5,0,31,17,0,8,0,18,43,101,76,2.7,1.7,3.5
9/17/19,33,0,2,7,0,42,10,0,2,0,8,20,92,76,2.7,1.7,3.5
9/18/19,15,0,2,9,0,26,12,1,4,0,6,23,101,74,2.7,1.7,3.5
9/19/19,23,0,1,2,0,26,15,0,6,0,5,26,101,77,2.7,1.7,3.5
9/20/19,15,0,6,7,0,28,17,0,5,0,23,45,100,78,2.7,1.7,3.5
9/21/19,36,0,1,13,0,50,14,1,6,0,1,22,99,79,2.7,1.7,3.5
9/22/19,17,0,0,10,0,27,15,0,12,0,3,30,100,77,2.7,1.7,3.5
9/23/19,23,0,0,18,0,41,9,0,7,0,8,24,100,78,2.7,1.7,3.5
9/24/19,24,0,3,8,0,35,16,1,8,0,15,40,98,78,2.7,1.7,3.5
9/25/19,13,0,2,4,0,19,13,0,7,0,12,32,100,75,2.7,1.7,3.5
9/26/19,12,0,1,9,0,22,13,0,8,0,13,34,98,75,2.7,1.7,3.5
9/27/19,22,0,2,11,0,35,22,0,3,0,2,27,99,75,2.7,1.7,3.5
9/28/19,17,0,1,11,0,29,24,0,8,0,6,38,96,79,2.7,1.7,3.5
9/29/19,11,0,1,22,0,34,16,1,4,0,8,29,98,77,2.7,1.7,3.5
9/30/19,12,0,2,8,0,22,16,1,6,2,4,29,99,80,2.7,1.7,3.5
10/1/19,23,0,1,9,0,33,9,0,3,0,20,32,99,78,2.6,1.8,3.6
10/2/19,35,0,4,8,0,47,13,0,7,0,1,21,98,77,2.6,1.8,3.6
10/3/19,19,0,1,17,0,37,12,0,6,0,6,24,97,75,2.6,1.8,3.6
10/4/19,22,0,0,8,0,30,14,0,8,0,7,29,96,75,2.6,1.8,3.6
10/5/19,24,0,2,12,0,38,15,0,15,1,3,34,97,72,2.6,1.8,3.6
10/6/19,27,0,6,3,0,36,21,0,8,0,0,29,99,72,2.6,1.8,3.6
10/7/19,20,0,0,4,0,24,14,0,5,0,13,32,85,68,2.6,1.8,3.6
10/8/19,12,0,2,10,0,24,15,1,4,0,16,36,87,63,2.6,1.8,3.6
10/9/19,14,0,1,6,0,21,7,1,4,0,9,21,96,69,2.6,1.8,3.6
10/10/19,15,0,3,8,0,26,5,0,6,0,4,15,99,78,2.6,1.8,3.6
10/11/19,27,0,1,5,0,33,10,0,11,0,1,22,82,47,2.6,1.8,3.6
10/12/19,19,0,2,9,0,30,23,0,10,0,2,35,65,54,2.6,1.8,3.6
10/13/19,25,0,6,4,0,35,14,1,14,0,9,38,82,56,2.6,1.8,3.6
10/14/19,13,0,2,7,0,22,16,0,16,0,16,48,89,71,2.6,1.8,3.6
10/15/19,11,0,2,4,0,17,11,0,7,0,4,22,96,74,2.6,1.8,3.6
10/16/19,22,0,2,12,0,36,11,0,8,0,6,25,76,56,2.6,1.8,3.6
10/17/19,14,0,1,3,0,18,9,0,7,0,7,23,77,54,2.6,1.8,3.6
10/18/19,16,0,2,6,0,24,16,0,2,1,1,20,85,51,2.6,1.8,3.6
10/19/19,16,0,0,15,0,31,16,0,9,0,0,25,96,66,2.6,1.8,3.6
10/20/19,21,0,3,2,0,26,8,0,6,0,2,16,95,65,2.6,1.8,3.6
10/21/19,32,0,0,5,0,37,9,1,2,1,19,32,82,63,2.6,1.8,3.6
10/22/19,15,0,4,14,0,33,8,0,5,0,22,35,83,50,2.6,1.8,3.6
10/23/19,18,0,4,25,0,47,7,0,4,1,7,19,87,54,2.6,1.8,3.6
10/24/19,33,0,0,9,0,42,20,1,8,0,5,34,86,49,2.6,1.8,3.6
10/25/19,19,0,0,14,0,33,21,0,9,0,13,43,59,44,2.6,1.8,3.6
10/26/19,19,0,1,5,0,25,24,0,8,0,1,33,74,46,2.6,1.8,3.6
10/27/19,14,0,0,5,0,19,20,0,8,0,6,34,83,45,2.6,1.8,3.6
10/28/19,22,0,2,6,0,30,19,0,8,0,6,33,82,57,2.6,1.8,3.6
10/29/19,14,0,1,2,0,17,18,0,6,0,12,36,57,49,2.6,1.8,3.6
10/30/19,19,0,0,5,0,24,19,0,9,0,5,33,49,41,2.6,1.8,3.6
10/31/19,28,0,0,7,0,35,13,0,1,0,2,16,57,34,2.6,1.8,3.6
11/1/19,13,0,1,9,0,23,13,0,9,0,2,24,64,31,2.5,2.1,3.6
11/2/19,13,0,1,15,0,29,17,0,17,0,2,36,71,40,2.5,2.1,3.6
11/3/19,23,0,0,9,0,32,20,0,3,0,5,28,74,41,2.5,2.1,3.6
11/4/19,20,0,2,7,0,29,12,0,4,0,13,29,83,54,2.5,2.1,3.6
11/5/19,21,0,2,7,0,30,9,1,4,0,12,26,83,63,2.5,2.1,3.6
11/6/19,14,0,1,12,0,27,10,0,6,0,5,21,85,68,2.5,2.1,3.6
11/7/19,26,0,1,5,0,32,15,0,8,0,3,26,68,44,2.5,2.1,3.6
11/8/19,18,0,1,4,0,23,20,0,5,0,5,30,50,44,2.5,2.1,3.6
11/9/19,21,0,1,3,0,25,15,1,2,0,3,21,70,43,2.5,2.1,3.6
11/10/19,26,0,0,15,0,41,17,2,5,0,3,27,76,49,2.5,2.1,3.6
11/11/19,22,0,2,3,0,27,12,2,4,0,14,32,75,33,2.5,2.1,3.6
11/12/19,13,0,0,2,0,15,14,0,7,0,0,21,47,31,2.5,2.1,3.6
11/13/19,22,0,5,4,0,31,10,0,7,0,13,30,42,30,2.5,2.1,3.6
11/14/19,36,0,2,4,0,42,5,0,10,0,12,27,45,37,2.5,2.1,3.6
11/15/19,22,0,2,3,0,27,10,0,14,0,3,27,65,38,2.5,2.1,3.6
11/16/19,14,0,0,6,0,20,12,0,10,0,1,23,66,35,2.5,2.1,3.6
11/17/19,27,0,0,7,0,34,15,0,9,0,17,41,72,42,2.5,2.1,3.6
11/18/19,28,0,4,8,0,40,20,0,10,0,7,37,75,48,2.5,2.1,3.6
11/19/19,15,0,0,5,0,20,7,0,10,0,6,23,80,45,2.5,2.1,3.6
11/20/19,21,0,0,8,0,29,11,1,10,0,12,34,84,64,2.5,2.1,3.6
11/21/19,24,0,0,7,0,31,12,0,8,0,2,22,81,69,2.5,2.1,3.6
11/22/19,22,0,0,8,0,30,9,0,6,0,0,15,74,47,2.5,2.1,3.6
11/23/19,35,0,1,9,0,45,15,1,7,0,6,29,72,41,2.5,2.1,3.6
11/24/19,13,0,0,5,0,18,11,0,6,0,27,44,75,41,2.5,2.1,3.6
11/25/19,26,0,0,12,0,38,21,0,4,0,4,29,88,51,2.5,2.1,3.6
11/26/19,16,0,2,3,0,21,20,2,5,0,1,28,74,66,2.5,2.1,3.6
11/27/19,22,0,1,5,0,28,43,1,9,0,4,57,70,52,2.5,2.1,3.6
11/28/19,2,0,0,0,0,2,26,0,2,0,5,33,55,49,2.5,2.1,3.6
11/29/19,17,0,1,10,0,28,25,1,5,0,1,32,74,52,2.5,2.1,3.6
11/30/19,21,0,0,14,0,35,22,0,1,0,3,26,87,61,2.5,2.1,3.6
12/1/19,16,0,2,8,0,26,27,0,7,0,16,50,67,48,2.4,2.3,3.6
12/2/19,24,0,0,6,0,30,19,0,2,0,18,39,67,43,2.4,2.3,3.6
12/3/19,31,0,2,6,0,39,13,0,11,0,2,26,75,39,2.4,2.3,3.6
12/4/19,22,0,1,6,0,29,23,0,5,0,2,30,75,52,2.4,2.3,3.6
12/5/19,17,0,1,1,0,19,17,0,4,0,1,22,75,51,2.4,2.3,3.6
12/6/19,13,0,2,4,0,19,22,0,8,0,7,37,75,54,2.4,2.3,3.6
12/7/19,21,0,0,12,0,33,24,0,1,0,4,29,70,46,2.4,2.3,3.6
12/8/19,26,0,2,2,0,30,21,0,9,0,0,30,75,49,2.4,2.3,3.6
12/9/19,15,0,4,12,0,31,13,0,5,0,4,22,83,57,2.4,2.3,3.6
12/10/19,11,0,2,9,0,22,22,0,10,0,6,38,57,38,2.4,2.3,3.6
12/11/19,17,0,1,11,0,29,14,0,8,0,5,27,58,36,2.4,2.3,3.6
12/12/19,14,0,2,3,0,19,10,0,7,0,0,17,63,35,2.4,2.3,3.6
12/13/19,16,0,1,11,0,28,12,0,4,0,1,17,78,41,2.4,2.3,3.6
12/14/19,17,0,2,12,0,31,7,0,7,0,13,27,77,43,2.4,2.3,3.6
12/15/19,17,0,1,3,0,21,17,0,14,0,10,41,81,50,2.4,2.3,3.6
12/16/19,19,0,2,6,0,27,11,0,9,0,3,23,70,41,2.4,2.3,3.6
12/17/19,18,0,1,5,0,24,24,0,13,0,4,41,56,35,2.4,2.3,3.6
12/18/19,39,0,4,5,0,48,15,0,6,1,1,23,61,34,2.4,2.3,3.6
12/19/19,12,0,0,6,0,18,21,0,5,0,0,26,62,30,2.4,2.3,3.6
12/20/19,11,0,2,8,0,21,19,0,6,0,6,31,52,47,2.4,2.3,3.6
12/21/19,22,0,1,3,0,26,19,0,10,0,2,31,62,41,2.4,2.3,3.6
12/22/19,15,0,0,13,0,28,0,0,1,0,0,1,61,39,2.4,2.3,3.6
12/23/19,21,0,1,14,0,36,22,0,5,1,9,37,70,36,2.4,2.3,3.6
12/24/19,0,0,2,0,0,2,12,0,7,0,7,26,72,37,2.4,2.3,3.6
12/26/19,30,0,0,4,0,34,18,0,2,0,0,20,69,48,2.4,2.3,3.6
12/27/19,21,0,0,4,0,25,8,1,7,0,5,21,68,54,2.4,2.3,3.6
12/28/19,14,0,3,4,0,21,18,1,8,2,15,44,68,54,2.4,2.3,3.6
12/29/19,19,0,3,6,0,28,26,0,9,1,8,44,72,53,2.4,2.3,3.6
12/30/19,25,0,1,6,0,32,0,0,1,0,0,1,66,46,2.4,2.3,3.6
12/31/19,31,0,2,5,0,38,18,0,12,1,16,47,62,39,2.4,2.3,3.6
1/1/20,9,0,0,0,0,9,14,0,20,0,10,44,62,37,2.4,2.3,3.6
1/2/20,38,0,3,6,0,47,14,1,11,0,5,31,58,50,2.7,2.5,3.6
1/3/20,29,0,1,5,0,35,19,0,6,0,2,27,60,49,2.7,2.5,3.6
1/4/20,31,0,0,12,0,43,21,0,10,0,3,34,66,49,2.7,2.5,3.6
1/5/20,20,0,3,4,0,27,15,0,5,0,4,24,73,44,2.7,2.5,3.6
1/6/20,14,0,2,14,0,30,23,0,13,1,10,47,76,45,2.7,2.5,3.6
1/7/20,25,0,1,7,0,33,11,0,2,0,9,22,76,42,2.7,2.5,3.6
1/8/20,13,0,2,2,0,17,12,0,3,0,17,32,69,43,2.7,2.5,3.6
1/9/20,19,0,0,0,0,19,17,1,9,0,2,29,71,37,2.7,2.5,3.6
1/10/20,11,0,2,7,0,20,16,0,9,0,1,26,78,62,2.7,2.5,3.6
1/11/20,18,0,0,10,0,28,12,1,5,0,3,21,77,57,2.7,2.5,3.6
1/12/20,15,0,2,4,0,21,13,1,4,0,16,34,60,43,2.7,2.5,3.6
1/13/20,18,0,2,7,0,27,7,0,4,0,9,20,63,36,2.7,2.5,3.6
1/14/20,11,0,2,5,0,18,7,3,3,0,2,15,60,52,2.7,2.5,3.6
1/15/20,17,0,3,8,0,28,15,0,8,0,2,25,77,60,2.7,2.5,3.6
1/16/20,20,0,2,10,0,32,26,1,7,0,1,35,82,69,2.7,2.5,3.6
1/17/20,21,0,1,6,0,28,17,0,12,0,3,32,73,57,2.7,2.5,3.6
1/18/20,23,0,0,17,0,40,0,1,0,0,0,1,59,50,2.7,2.5,3.6
1/19/20,19,0,0,5,0,24,16,0,12,0,5,33,70,49,2.7,2.5,3.6
1/20/20,3,0,1,0,0,4,13,1,6,0,15,35,58,41,2.7,2.5,3.6
1/21/20,25,0,1,10,0,36,7,0,6,0,12,25,62,35,2.7,2.5,3.6
1/22/20,19,0,5,12,0,36,13,0,7,0,0,20,62,40,2.7,2.5,3.6
1/23/20,29,0,0,10,0,39,19,0,6,0,5,30,59,47,2.7,2.5,3.6
1/24/20,10,0,0,8,0,18,14,1,6,0,3,24,67,48,2.7,2.5,3.6
1/25/20,17,0,1,14,0,32,20,0,4,0,0,24,69,42,2.7,2.5,3.6
1/26/20,11,0,2,5,0,18,11,2,10,0,10,33,67,43,2.7,2.5,3.6
1/27/20,20,0,1,10,0,31,16,1,13,0,2,32,79,54,2.7,2.5,3.6
1/28/20,25,0,3,9,0,37,7,1,7,0,12,27,70,47,2.7,2.5,3.6
1/29/20,13,0,1,19,0,33,21,0,4,0,1,26,73,51,2.7,2.5,3.6
1/30/20,14,0,2,6,0,22,15,0,10,0,0,25,63,44,2.7,2.5,3.6
1/31/20,18,0,3,7,0,28,18,0,6,0,5,29,50,44,2.7,2.5,3.6
2/1/20,18,0,1,6,0,25,13,1,3,0,1,18,63,44,2.7,2.5,3.6
2/2/20,16,0,1,4,0,21,17,1,6,0,10,34,74,42,2.6,2.3,3.5
2/3/20,21,0,7,3,0,31,10,0,4,0,7,21,81,44,2.6,2.3,3.5
2/4/20,16,0,2,6,0,24,7,0,5,0,5,17,73,56,2.6,2.3,3.5
2/5/20,22,0,1,3,0,26,17,1,6,0,4,28,79,47,2.6,2.3,3.5
2/6/20,19,0,1,6,0,26,11,0,4,0,4,19,47,33,2.6,2.3,3.5
2/7/20,21,0,5,3,0,29,9,0,4,0,5,18,55,31,2.6,2.3,3.5
2/8/20,25,0,0,6,0,31,16,0,11,0,4,31,76,36,2.6,2.3,3.5
2/9/20,19,0,3,5,0,27,17,0,8,0,4,29,70,44,2.6,2.3,3.5
2/10/20,13,0,1,1,0,15,0,0,0,0,16,16,72,63,2.6,2.3,3.5
2/11/20,18,0,2,6,0,26,18,0,4,0,4,26,71,47,2.6,2.3,3.5
2/12/20,8,0,1,0,0,9,25,2,7,1,8,43,47,43,2.6,2.3,3.5
2/13/20,20,0,0,9,0,29,28,0,6,0,1,35,57,44,2.6,2.3,3.5
2/14/20,35,0,1,6,0,42,25,0,3,0,6,34,55,39,2.6,2.3,3.5
2/15/20,18,0,1,12,0,31,22,1,15,0,17,55,60,33,2.6,2.3,3.5
2/16/20,16,0,2,8,0,26,19,1,5,0,17,42,65,40,2.6,2.3,3.5
2/17/20,10,0,0,1,0,11,9,0,9,1,11,30,78,49,2.6,2.3,3.5
2/18/20,18,0,0,15,0,33,8,0,2,0,10,20,80,59,2.6,2.3,3.5
2/19/20,12,0,1,12,0,25,11,1,2,0,0,14,72,50,2.6,2.3,3.5
2/20/20,18,0,0,6,0,24,3,1,7,0,1,12,51,47,2.6,2.3,3.5
2/21/20,16,0,0,9,0,25,12,0,6,0,1,19,52,44,2.6,2.3,3.5
2/22/20,13,0,0,9,0,22,16,0,5,1,29,51,56,36,2.6,2.3,3.5
2/23/20,25,0,1,10,0,36,7,1,19,0,0,27,65,44,2.6,2.3,3.5
2/24/20,22,0,4,4,0,30,22,1,4,1,7,35,69,54,2.6,2.3,3.5
2/25/20,18,0,3,15,0,36,14,0,6,0,3,23,70,48,2.6,2.3,3.5
2/26/20,26,0,0,10,0,36,23,1,8,0,4,36,68,47,2.6,2.3,3.5
2/27/20,24,0,0,5,0,29,18,0,2,0,1,21,56,39,2.6,2.3,3.5
2/28/20,16,0,1,11,0,28,13,0,7,1,8,29,65,32,2.6,2.3,3.5
2/29/20,20,0,1,7,0,28,12,1,5,0,7,25,75,39,2.6,2.3,3.5
3/1/20,16,0,2,7,0,25,10,0,5,1,20,36,76,47,2.6,2.3,3.5
3/2/20,30,0,2,6,0,38,22,0,1,2,2,27,77,58,4.1,1.5,4.4
3/3/20,20,0,2,14,0,36,10,1,10,0,8,29,79,65,4.1,1.5,4.4
3/4/20,17,0,1,9,0,27,18,0,3,0,2,23,75,64,4.1,1.5,4.4
3/5/20,13,0,1,14,0,28,14,0,2,0,4,20,69,54,4.1,1.5,4.4
3/6/20,19,0,1,6,0,26,15,0,10,0,0,25,76,48,4.1,1.5,4.4
3/7/20,25,0,0,4,0,29,17,2,8,1,6,34,71,50,4.1,1.5,4.4
3/8/20,21,0,0,5,0,26,12,0,6,0,2,20,64,45,4.1,1.5,4.4
3/9/20,23,0,2,7,0,32,12,0,3,1,21,37,76,50,4.1,1.5,4.4
3/10/20,20,0,1,6,0,27,13,1,13,0,2,29,67,64,4.1,1.5,4.4
3/11/20,26,0,2,6,0,34,24,0,6,0,1,31,81,59,4.1,1.5,4.4
3/12/20,17,0,20,6,0,43,27,1,6,0,2,36,85,63,4.1,1.5,4.4
3/13/20,13,0,6,13,0,32,9,0,5,0,6,20,87,68,4.1,1.5,4.4
3/14/20,13,0,0,7,0,20,6,0,6,1,17,30,84,69,4.1,1.5,4.4
3/15/20,19,0,2,14,0,35,2,0,3,0,7,12,84,69,4.1,1.5,4.4
3/16/20,6,0,3,1,0,10,0,0,2,0,3,5,69,58,4.1,1.5,4.4
3/17/20,4,0,0,0,0,4,0,0,1,0,10,11,75,58,4.1,1.5,4.4
3/18/20,1,0,1,1,0,3,3,0,0,0,0,3,81,68,4.1,1.5,4.4
3/19/20,1,0,0,1,0,2,0,0,4,1,0,5,83,70,4.1,1.5,4.4
3/20/20,8,0,0,0,0,8,0,0,2,0,2,4,85,70,4.1,1.5,4.4
3/21/20,3,0,3,0,0,6,0,1,23,0,15,39,72,52,4.1,1.5,4.4
3/22/20,3,0,1,1,0,5,6,0,1,0,6,13,55,48,4.1,1.5,4.4
3/23/20,16,0,0,0,0,16,4,0,3,0,2,9,67,54,4.1,1.5,4.4
3/24/20,0,0,3,4,0,7,1,0,2,0,1,4,84,64,4.1,1.5,4.4
3/25/20,1,0,2,1,0,4,5,1,5,0,0,11,92,60,4.1,1.5,4.4
3/26/20,4,0,3,0,0,7,1,1,6,0,0,8,91,56,4.1,1.5,4.4
3/27/20,0,0,1,0,0,1,0,1,0,0,1,2,88,67,4.1,1.5,4.4
3/28/20,6,0,2,2,0,10,15,0,1,0,0,16,89,70,4.1,1.5,4.4
3/29/20,3,0,0,2,0,5,5,0,3,0,0,8,81,55,4.1,1.5,4.4
3/30/20,7,0,2,0,0,9,8,0,2,1,0,11,81,51,4.1,1.5,4.4
3/31/20,3,0,1,0,0,4,2,0,1,0,3,6,70,64,4.1,1.5,4.4
4/1/20,3,0,0,1,0,4,10,0,5,0,1,16,75,56,4.1,1.5,4.4
4/2/20,6,0,2,1,0,9,3,0,5,0,2,10,78,50,11.4,0.3,14.8
4/3/20,4,0,1,3,0,8,2,0,2,0,0,4,70,62,11.4,0.3,14.8
4/4/20,2,0,1,1,0,4,17,0,3,0,0,20,74,46,11.4,0.3,14.8
4/5/20,3,0,1,0,0,4,5,0,0,0,3,8,53,45,11.4,0.3,14.8
4/6/20,2,0,1,0,0,3,4,0,4,0,1,9,67,51,11.4,0.3,14.8
4/7/20,5,0,2,1,0,8,3,0,3,0,1,7,80,61,11.4,0.3,14.8
4/8/20,8,0,2,0,0,10,2,1,1,0,1,5,89,70,11.4,0.3,14.8
4/9/20,1,0,5,0,0,6,1,0,6,0,3,10,95,73,11.4,0.3,14.8
4/10/20,5,0,2,0,0,7,3,1,2,0,5,11,93,66,11.4,0.3,14.8
4/11/20,2,0,2,1,0,5,11,1,2,0,0,14,75,63,11.4,0.3,14.8
4/12/20,2,0,0,0,0,2,13,0,4,0,2,19,76,61,11.4,0.3,14.8
4/13/20,4,0,2,2,0,8,0,0,1,0,1,2,87,61,11.4,0.3,14.8
4/14/20,10,0,2,3,0,15,5,0,1,0,2,8,65,45,11.4,0.3,14.8
4/15/20,4,0,1,1,0,6,0,3,0,0,2,5,66,46,11.4,0.3,14.8
4/16/20,4,0,1,0,0,5,2,0,1,0,0,3,70,43,11.4,0.3,14.8
4/17/20,4,0,1,0,0,5,10,0,3,0,5,18,79,48,11.4,0.3,14.8
4/18/20,3,0,1,5,0,9,2,0,1,0,1,4,74,56,11.4,0.3,14.8
4/19/20,0,0,8,0,0,8,2,0,0,0,1,3,63,55,11.4,0.3,14.8
4/20/20,1,0,1,0,0,2,4,0,1,0,1,6,94,60,11.4,0.3,14.8
4/22/20,5,0,0,1,0,6,0,0,2,0,0,2,87,61,11.4,0.3,14.8
4/23/20,5,0,1,0,0,6,4,0,1,0,0,5,87,67,11.4,0.3,14.8
4/24/20,3,0,0,3,0,6,1,1,1,0,2,5,81,71,11.4,0.3,14.8
4/25/20,1,0,1,0,0,2,3,0,3,0,1,7,90,59,11.4,0.3,14.8
4/26/20,2,0,1,1,0,4,7,0,2,0,2,11,98,61,11.4,0.3,14.8
4/27/20,3,0,1,2,0,6,3,0,1,0,1,5,81,60,11.4,0.3,14.8
4/28/20,8,0,3,1,0,12,2,0,4,0,1,7,87,54,11.4,0.3,14.8
4/29/20,3,0,1,1,0,5,6,0,0,0,3,9,90,61,11.4,0.3,14.8
4/30/20,4,0,1,0,0,5,0,0,0,0,2,2,93,74,11.4,0.3,14.8
5/1/20,4,0,1,2,0,7,3,0,1,0,0,4,85,59,11.4,0.3,14.8
5/2/20,1,0,1,2,0,4,4,0,2,0,4,10,89,55,11.4,0.3,14.8
5/3/20,2,0,2,0,0,4,6,0,3,0,1,10,90,61,10.4,0.1,13.2
5/4/20,1,0,1,1,0,3,11,0,5,1,1,18,93,69,10.4,0.1,13.2
5/5/20,4,0,0,0,0,4,6,0,1,0,2,9,95,70,10.4,0.1,13.2
5/6/20,6,0,1,0,0,7,5,0,0,0,4,9,97,72,10.4,0.1,13.2
5/7/20,10,0,1,1,0,12,0,0,1,0,1,2,86,71,10.4,0.1,13.2
5/8/20,9,0,2,4,0,15,2,0,0,0,2,4,87,66,10.4,0.1,13.2
5/9/20,0,0,1,1,0,2,11,0,3,0,2,16,84,57,10.4,0.1,13.2
5/11/20,4,0,1,2,0,7,7,0,4,0,1,12,86,64,10.4,0.1,13.2
5/12/20,5,0,2,1,0,8,7,0,0,0,0,7,79,61,10.4,0.1,13.2
5/13/20,7,0,4,4,0,15,6,0,3,0,0,9,82,55,10.4,0.1,13.2
5/14/20,4,0,1,1,0,6,7,0,2,0,5,14,86,59,10.4,0.1,13.2
5/15/20,6,0,0,0,0,6,3,0,2,0,2,7,74,66,10.4,0.1,13.2
5/16/20,3,0,1,4,0,8,5,0,0,0,1,6,89,64,10.4,0.1,13.2
5/17/20,3,0,1,2,0,6,5,0,2,0,0,7,93,72,10.4,0.1,13.2
5/18/20,1,0,1,1,0,3,7,0,3,0,0,10,92,65,10.4,0.1,13.2
5/19/20,5,0,1,2,0,8,1,0,0,0,2,3,84,63,10.4,0.1,13.2
5/20/20,2,0,0,2,0,4,5,0,1,0,1,7,92,66,10.4,0.1,13.2
5/21/20,3,0,0,4,0,7,0,0,0,0,3,3,95,64,10.4,0.1,13.2
5/22/20,4,0,0,6,0,10,4,0,7,0,1,12,97,70,10.4,0.1,13.2
5/23/20,4,0,5,3,0,12,7,1,5,0,3,16,95,75,10.4,0.1,13.2
5/24/20,12,0,2,0,0,14,9,1,8,0,6,24,93,71,10.4,0.1,13.2
5/25/20,7,0,1,0,0,8,4,0,1,0,2,7,95,73,10.4,0.1,13.2
5/26/20,7,0,1,6,0,14,4,0,3,0,0,7,93,74,10.4,0.1,13.2
5/27/20,12,0,0,0,0,12,3,0,3,2,3,11,95,67,10.4,0.1,13.2
5/28/20,5,0,1,0,0,6,3,0,1,0,0,4,80,66,10.4,0.1,13.2
5/29/20,6,0,0,2,0,8,1,0,8,0,2,11,86,65,10.4,0.1,13.2
5/30/20,12,0,1,0,0,13,14,0,2,0,3,19,91,62,10.4,0.1,13.2
5/31/20,3,0,1,1,0,5,8,0,8,0,10,26,90,63,10.4,0.1,13.2
6/1/20,7,0,0,7,0,14,4,0,0,0,2,6,89,70,10.4,0.1,13.2
6/2/20,10,0,0,6,0,16,4,0,5,0,1,10,89,63,10.4,0.1,13.2
6/3/20,11,0,0,6,0,17,6,0,2,0,2,10,85,74,10.4,0.1,13.2
6/4/20,6,0,2,5,0,13,3,0,1,0,1,5,84,72,8.7,0.6,11
6/5/20,5,0,0,4,0,9,8,0,4,0,7,19,90,72,8.7,0.6,11
6/6/20,4,0,0,0,0,4,11,0,2,0,2,15,93,73,8.7,0.6,11
6/7/20,6,0,0,1,0,7,6,1,2,1,5,15,94,74,8.7,0.6,11
6/8/20,12,0,3,6,0,21,5,1,1,0,4,11,94,76,8.7,0.6,11
6/9/20,10,0,4,1,0,15,3,1,0,0,6,10,96,74,8.7,0.6,11
6/10/20,6,0,2,7,0,15,2,0,1,0,2,5,96,76,8.7,0.6,11
6/11/20,7,0,1,4,0,12,3,0,4,0,0,7,99,74,8.7,0.6,11
6/12/20,8,0,1,8,0,17,10,0,3,0,4,17,100,77,8.7,0.6,11
6/13/20,5,0,7,0,0,12,6,0,9,0,3,18,94,68,8.7,0.6,11
6/14/20,3,0,2,0,0,5,6,1,5,0,1,13,96,64,8.7,0.6,11
6/15/20,13,0,4,4,0,21,5,1,2,0,0,8,94,63,8.7,0.6,11
6/16/20,8,0,0,1,0,9,5,0,1,0,3,9,94,67,8.7,0.6,11
6/17/20,4,0,1,4,0,9,4,0,2,0,2,8,94,66,8.7,0.6,11
6/18/20,9,0,1,7,0,17,4,0,0,0,1,5,96,72,8.7,0.6,11
6/19/20,1,0,2,1,0,4,9,0,2,0,8,19,95,75,8.7,0.6,11
6/20/20,2,0,0,0,0,2,11,0,0,0,12,23,96,71,8.7,0.6,11
6/21/20,6,0,0,1,0,7,6,0,1,0,0,7,97,73,8.7,0.6,11
6/22/20,9,0,0,5,0,14,4,0,1,0,4,9,97,77,8.7,0.6,11
6/23/20,13,0,1,4,0,18,8,0,4,0,0,12,94,70,8.7,0.6,11
6/24/20,7,0,1,4,0,12,2,0,0,0,0,2,96,77,8.7,0.6,11
6/25/20,9,0,1,4,0,14,3,0,4,0,0,7,94,79,8.7,0.6,11
6/26/20,7,0,2,17,0,26,5,0,4,1,1,11,93,71,8.7,0.6,11
6/27/20,6,0,1,1,0,8,6,1,4,0,1,12,86,74,8.7,0.6,11
6/28/20,11,0,0,0,0,11,6,0,8,0,4,18,94,71,8.7,0.6,11
6/29/20,13,0,1,3,0,17,6,0,1,0,1,8,86,71,8.7,0.6,11
6/30/20,11,0,0,6,0,17,0,1,2,0,1,4,93,77,8.7,0.6,11
7/1/20,6,0,0,5,0,11,5,0,0,1,2,8,88,76,8.7,0.6,11
7/2/20,9,0,0,6,0,15,2,0,6,0,0,8,90,78,8.7,0.6,11
7/3/20,3,0,4,0,0,7,6,0,0,1,2,9,93,80,8.7,0.6,11
7/4/20,5,0,1,2,0,8,10,4,3,0,6,23,95,80,7.9,1,10.2
7/5/20,9,0,0,0,0,9,6,0,1,0,1,8,98,80,7.9,1,10.2
7/6/20,7,0,0,5,0,12,4,0,1,0,5,10,99,76,7.9,1,10.2
7/7/20,14,0,1,3,0,18,4,0,1,0,3,8,100,74,7.9,1,10.2
7/8/20,4,0,1,1,0,6,6,0,1,0,0,7,100,75,7.9,1,10.2
7/9/20,8,0,2,3,0,13,4,1,2,0,2,9,94,78,7.9,1,10.2
7/10/20,8,0,1,5,0,14,5,0,6,0,4,15,100,81,7.9,1,10.2
7/11/20,5,0,0,0,0,5,5,0,2,0,15,22,99,80,7.9,1,10.2
7/12/20,5,0,2,1,0,8,5,1,4,1,4,15,101,80,7.9,1,10.2
7/13/20,11,0,1,2,0,14,6,0,2,0,4,12,102,79,7.9,1,10.2
7/14/20,9,0,0,6,0,15,11,0,3,0,0,14,104,78,7.9,1,10.2
7/15/20,14,0,0,3,0,17,3,0,7,0,4,14,105,78,7.9,1,10.2
7/16/20,8,0,0,3,0,11,2,0,0,0,0,2,108,79,7.9,1,10.2
7/17/20,10,0,3,1,0,14,5,0,5,1,4,15,106,77,7.9,1,10.2
7/18/20,7,0,1,1,0,9,6,1,0,0,0,7,103,78,7.9,1,10.2
7/19/20,5,0,0,0,0,5,1,1,1,0,12,15,102,77,7.9,1,10.2
7/20/20,7,0,2,2,0,11,5,0,0,0,2,7,102,78,7.9,1,10.2
7/21/20,2,0,0,1,0,3,0,0,4,0,2,6,98,76,7.9,1,10.2
7/22/20,12,0,1,3,0,16,3,0,0,0,0,3,99,76,7.9,1,10.2
7/23/20,9,0,1,4,0,14,6,0,0,0,0,6,100,77,7.9,1,10.2
7/24/20,5,0,0,3,0,8,3,0,10,0,4,17,97,78,7.9,1,10.2
7/25/20,4,0,1,2,0,7,19,0,2,0,3,24,100,79,7.9,1,10.2
7/26/20,10,0,0,1,0,11,5,0,0,0,7,12,101,79,7.9,1,10.2
7/27/20,6,0,0,6,0,12,4,0,2,0,3,9,100,81,7.9,1,10.2
7/28/20,14,0,0,0,0,14,6,0,3,0,1,10,94,75,7.9,1,10.2
7/29/20,5,0,1,5,0,11,6,0,3,0,5,14,97,76,7.9,1,10.2
7/30/20,3,0,0,7,0,10,4,0,4,0,4,12,98,77,7.9,1,10.2
7/31/20,5,0,1,4,0,10,4,0,1,0,5,10,102,76,7.9,1,10.2
8/1/20,6,0,1,0,0,7,7,0,3,1,3,14,102,75,7.9,1,10.2
8/2/20,25,0,1,0,0,26,6,0,1,0,6,13,101,77,7.9,1,10.2
8/3/20,16,0,0,17,0,33,15,0,5,0,5,25,102,74,7.9,1,10.2
8/4/20,7,0,1,4,0,12,6,0,3,0,4,13,99,74,6.3,1.3,8.4
8/5/20,12,0,1,5,0,18,7,0,2,0,4,13,101,74,6.3,1.3,8.4
8/6/20,13,0,0,7,0,20,0,0,0,0,2,2,103,73,6.3,1.3,8.4
8/7/20,5,0,0,1,0,6,5,0,0,0,4,9,102,75,6.3,1.3,8.4
8/8/20,4,0,0,2,0,6,22,0,4,0,8,34,103,76,6.3,1.3,8.4
8/9/20,4,0,1,2,0,7,9,0,2,1,2,14,103,77,6.3,1.3,8.4
8/10/20,5,0,0,5,0,10,8,0,3,0,1,12,103,77,6.3,1.3,8.4
8/11/20,6,0,1,4,0,11,6,0,3,1,2,12,104,77,6.3,1.3,8.4
8/12/20,5,0,2,3,0,10,3,0,0,0,1,4,103,78,6.3,1.3,8.4
8/13/20,5,0,0,8,0,13,5,0,2,0,1,8,103,79,6.3,1.3,8.4
8/14/20,7,0,2,3,0,12,8,0,4,0,2,14,104,79,6.3,1.3,8.4
8/15/20,3,0,3,0,0,6,11,0,1,0,0,12,106,79,6.3,1.3,8.4
8/16/20,4,0,0,0,0,4,5,0,4,0,8,17,104,79,6.3,1.3,8.4
8/17/20,5,0,0,2,0,7,8,0,0,0,1,9,107,78,6.3,1.3,8.4
8/18/20,15,0,6,5,0,26,3,0,3,0,1,7,107,79,6.3,1.3,8.4
8/19/20,5,0,1,6,0,12,8,1,1,0,2,12,106,79,6.3,1.3,8.4
8/20/20,8,0,0,5,0,13,1,0,1,0,2,4,101,76,6.3,1.3,8.4
8/21/20,7,0,2,2,0,11,8,0,1,0,0,9,104,75,6.3,1.3,8.4
8/22/20,6,0,1,0,0,7,7,0,6,0,8,21,104,73,6.3,1.3,8.4
8/23/20,4,0,1,0,0,5,9,0,4,0,7,20,101,71,6.3,1.3,8.4
8/24/20,8,0,0,5,0,13,3,0,3,0,3,9,104,77,6.3,1.3,8.4
8/25/20,10,0,4,5,0,19,11,0,3,0,16,30,93,68,6.3,1.3,8.4
8/26/20,5,0,1,7,0,13,5,0,2,0,4,11,97,70,6.3,1.3,8.4
8/27/20,9,0,4,7,0,20,1,1,4,0,1,7,100,75,6.3,1.3,8.4
8/28/20,19,0,3,5,0,27,7,2,3,0,0,12,101,75,6.3,1.3,8.4
8/29/20,5,0,0,1,0,6,7,0,4,0,7,18,97,79,6.3,1.3,8.4
8/30/20,7,0,0,1,0,8,8,0,0,0,0,8,101,76,6.3,1.3,8.4
8/31/20,6,0,1,2,0,9,4,0,2,0,0,6,106,81,6.3,1.3,8.4
9/1/20,14,0,0,4,0,18,3,0,5,0,0,8,105,79,6.3,1.3,8.4
9/2/20,14,0,1,7,0,22,5,0,8,0,5,18,103,79,6.3,1.3,8.4
9/3/20,8,0,1,10,0,19,2,0,2,0,0,4,104,83,6.3,1.3,8.4
9/4/20,13,0,10,1,0,24,0,0,1,0,0,1,100,83,6,1.4,7.8
9/5/20,8,0,1,0,0,9,14,0,3,0,6,23,85,73,6,1.4,7.8
9/6/20,1,0,1,0,0,2,9,0,3,0,1,13,94,72,6,1.4,7.8
9/7/20,4,0,1,0,0,5,7,1,3,0,3,14,83,72,6,1.4,7.8
9/8/20,7,0,2,1,0,10,5,0,1,0,3,9,92,74,6,1.4,7.8
9/9/20,11,0,0,1,0,12,16,0,2,0,2,20,94,73,6,1.4,7.8
9/10/20,19,0,0,3,0,22,1,0,1,0,0,2,97,73,6,1.4,7.8
9/11/20,6,0,2,6,0,14,16,0,13,0,10,39,91,77,6,1.4,7.8
9/12/20,7,0,1,1,0,9,8,0,1,0,8,17,81,60,6,1.4,7.8
9/13/20,8,0,2,0,0,10,7,0,2,0,0,9,67,58,6,1.4,7.8
9/14/20,9,0,1,3,0,13,7,1,1,0,5,14,87,63,6,1.4,7.8
9/15/20,8,0,1,4,0,13,8,0,5,0,1,14,93,68,6,1.4,7.8
9/16/20,4,0,0,6,0,10,4,0,4,0,1,9,94,75,6,1.4,7.8
9/17/20,7,0,2,2,0,11,2,0,4,0,2,8,92,74,6,1.4,7.8
9/18/20,11,0,2,4,0,17,9,0,1,0,1,11,93,74,6,1.4,7.8
9/19/20,9,0,1,1,0,11,16,0,6,1,6,29,94,74,6,1.4,7.8
9/20/20,7,0,1,0,0,8,12,0,6,0,0,18,90,74,6,1.4,7.8
9/21/20,12,0,0,3,0,15,9,1,2,0,1,13,89,71,6,1.4,7.8
9/22/20,6,0,2,5,0,13,9,2,1,0,1,13,85,69,6,1.4,7.8
9/23/20,13,0,0,4,0,17,17,1,5,0,1,24,86,64,6,1.4,7.8
9/24/20,11,0,2,7,0,20,0,0,3,0,1,4,73,68,6,1.4,7.8
9/25/20,6,0,1,4,0,11,12,0,3,0,2,17,75,69,6,1.4,7.8
9/26/20,10,0,2,0,0,12,12,0,1,0,7,20,77,70,6,1.4,7.8
9/27/20,6,0,0,0,0,6,3,1,2,0,5,11,82,65,6,1.4,7.8
9/28/20,6,0,9,3,0,18,13,0,3,0,0,16,89,61,6,1.4,7.8
9/29/20,8,0,0,7,0,15,2,0,6,0,0,8,91,68,6,1.4,7.8
9/30/20,12,0,1,7,0,20,3,1,1,0,0,5,93,76,6,1.4,7.8
10/1/20,14,0,2,18,0,34,0,0,3,0,5,8,81,64,6,1.4,7.8
10/2/20,12,0,4,3,0,19,5,0,13,0,8,26,85,56,6,1.4,7.8
10/3/20,7,0,1,1,0,9,13,0,3,0,8,24,90,53,6,1.4,7.8
10/4/20,7,0,3,0,0,10,3,0,5,0,0,8,91,56,5.1,1.2,6.8
10/5/20,12,0,2,9,0,23,11,0,1,0,2,14,85,59,5.1,1.2,6.8
10/6/20,3,0,5,6,0,14,8,0,11,0,3,22,87,59,5.1,1.2,6.8
10/7/20,6,0,2,3,0,11,9,0,1,0,1,11,91,61,5.1,1.2,6.8
10/8/20,3,0,1,9,0,13,1,0,1,0,2,4,87,64,5.1,1.2,6.8
10/9/20,5,0,4,6,0,15,2,0,0,0,2,4,88,64,5.1,1.2,6.8
10/10/20,2,0,0,0,0,2,16,0,7,0,2,25,92,63,5.1,1.2,6.8
10/11/20,2,0,0,1,0,3,5,2,3,0,1,11,88,61,5.1,1.2,6.8
10/12/20,6,0,0,6,0,12,5,0,4,0,3,12,90,72,5.1,1.2,6.8
10/13/20,13,0,1,7,0,21,12,0,0,0,2,14,96,66,5.1,1.2,6.8
10/14/20,11,0,1,2,0,14,2,0,6,0,3,11,99,68,5.1,1.2,6.8
10/15/20,8,0,1,3,0,12,1,0,2,0,0,3,89,65,5.1,1.2,6.8
10/16/20,6,0,1,3,0,10,8,0,0,0,1,9,91,57,5.1,1.2,6.8
10/17/20,2,0,0,1,0,3,15,0,1,0,10,26,93,60,5.1,1.2,6.8
10/18/20,3,0,1,3,0,7,4,0,2,0,0,6,91,67,5.1,1.2,6.8
10/19/20,8,0,0,0,0,8,8,1,2,0,1,12,77,57,5.1,1.2,6.8
10/20/20,3,0,1,1,0,5,14,0,2,1,0,17,81,61,5.1,1.2,6.8
10/21/20,14,0,0,7,0,21,5,0,1,0,0,6,93,73,5.1,1.2,6.8
10/22/20,9,0,0,8,0,17,3,0,3,0,3,9,93,73,5.1,1.2,6.8
10/23/20,18,0,2,0,0,20,6,0,3,0,1,10,93,75,5.1,1.2,6.8
10/24/20,8,0,1,1,0,10,11,1,3,0,9,24,91,74,5.1,1.2,6.8
10/25/20,5,0,0,1,0,6,6,0,4,0,7,17,91,73,5.1,1.2,6.8
10/26/20,12,0,1,3,0,16,3,0,5,0,2,10,85,55,5.1,1.2,6.8
10/27/20,16,0,3,6,0,25,7,0,5,0,3,15,67,53,5.1,1.2,6.8
10/28/20,13,0,0,5,0,18,9,1,2,0,1,13,86,55,5.1,1.2,6.8
10/29/20,17,0,1,8,0,26,1,0,1,0,1,3,75,42,5.1,1.2,6.8
10/30/20,7,0,1,8,0,16,9,0,3,0,1,13,43,40,5.1,1.2,6.8
10/31/20,4,0,0,2,0,6,5,0,3,0,8,16,62,39,5.1,1.2,6.8
11/1/20,8,0,1,2,0,11,4,1,2,0,3,10,64,40,5.1,1.2,6.8
11/2/20,12,0,0,2,0,14,4,0,3,1,2,10,73,45,5.1,1.2,6.8
11/3/20,3,0,1,1,0,5,7,1,3,2,4,17,79,41,5.1,1.2,6.8
11/4/20,9,0,0,9,0,18,6,0,2,0,1,9,79,50,5,1.2,6.7
11/5/20,15,0,2,2,0,19,4,0,2,0,9,15,78,47,5,1.2,6.7
11/6/20,7,0,0,5,0,12,6,0,6,1,0,13,81,43,5,1.2,6.7
11/7/20,8,0,0,3,0,11,8,1,1,0,8,18,82,48,5,1.2,6.7
11/8/20,10,0,0,1,0,11,10,0,10,0,4,24,83,57,5,1.2,6.7
11/9/20,8,0,2,3,0,13,7,0,3,0,18,28,82,63,5,1.2,6.7
11/10/20,14,0,3,7,0,24,8,1,1,1,1,12,82,54,5,1.2,6.7
11/11/20,2,0,2,1,0,5,4,1,3,0,2,10,84,59,5,1.2,6.7
11/12/20,9,0,1,13,0,23,4,0,4,1,3,12,86,66,5,1.2,6.7
11/13/20,6,0,0,7,0,13,6,1,1,0,6,14,81,64,5,1.2,6.7
11/14/20,8,0,0,0,0,8,4,0,2,0,2,8,84,59,5,1.2,6.7
11/15/20,8,0,1,2,0,11,3,1,5,0,2,11,85,63,5,1.2,6.7
11/16/20,6,0,1,4,0,11,4,0,3,0,1,8,84,65,5,1.2,6.7
11/17/20,16,0,1,6,0,23,10,0,2,1,4,17,87,71,5,1.2,6.7
11/18/20,6,0,2,8,0,16,3,0,3,0,0,6,74,52,5,1.2,6.7
11/19/20,5,0,0,15,0,20,10,0,5,1,1,17,76,43,5,1.2,6.7
11/20/20,9,0,0,6,0,15,9,2,5,0,11,27,78,41,5,1.2,6.7
11/21/20,3,0,1,5,0,9,5,0,7,0,1,13,81,43,5,1.2,6.7
11/22/20,9,0,0,1,0,10,0,0,0,0,2,2,83,59,5,1.2,6.7
11/23/20,17,0,1,4,0,22,0,0,1,0,0,1,84,63,5,1.2,6.7
11/24/20,14,0,1,4,0,19,11,0,1,0,0,12,81,65,5,1.2,6.7
11/25/20,21,0,0,4,0,25,4,1,1,0,3,9,83,57,5,1.2,6.7
11/26/20,2,0,4,2,0,8,13,0,1,0,4,18,68,52,5,1.2,6.7
11/27/20,4,0,0,0,0,4,9,0,4,0,7,20,84,59,5,1.2,6.7
11/28/20,6,0,2,0,0,8,8,0,3,0,8,19,74,50,5,1.2,6.7
11/29/20,5,0,0,1,0,6,12,1,3,0,14,30,78,45,5,1.2,6.7
11/30/20,19,0,1,4,0,24,11,0,5,0,25,41,71,60,5,1.2,6.7
12/1/20,9,0,2,3,0,14,10,0,2,0,1,13,61,51,5,1.2,6.7
12/2/20,13,0,2,10,0,25,3,0,0,0,1,4,57,46,5,1.2,6.7
12/3/20,11,0,1,4,0,16,10,1,6,0,4,21,58,33,5,1.2,6.7
12/4/20,11,0,1,10,0,22,13,0,4,0,13,30,64,30,4.9,1.4,6.7
12/5/20,7,0,1,2,0,10,10,1,5,0,2,18,66,44,4.9,1.4,6.7
12/6/20,12,0,2,1,0,15,7,0,6,0,3,16,59,40,4.9,1.4,6.7
12/7/20,8,0,1,17,0,26,7,0,3,1,4,15,60,36,4.9,1.4,6.7
12/8/20,5,0,1,7,0,13,5,1,1,1,0,8,54,36,4.9,1.4,6.7
12/9/20,12,0,1,4,0,17,2,1,2,0,3,8,68,42,4.9,1.4,6.7
12/10/20,15,0,2,10,0,27,12,1,4,0,3,20,72,41,4.9,1.4,6.7
12/11/20,6,0,4,6,0,16,14,0,5,1,0,20,79,43,4.9,1.4,6.7
12/12/20,4,0,0,1,0,5,5,0,4,0,5,14,82,46,4.9,1.4,6.7
12/13/20,9,0,1,2,0,12,5,0,3,0,9,17,78,44,4.9,1.4,6.7
12/14/20,9,0,0,6,0,15,11,0,3,0,7,21,71,57,4.9,1.4,6.7
12/15/20,6,0,1,1,0,8,12,0,6,0,0,18,64,48,4.9,1.4,6.7
12/16/20,13,0,2,4,0,19,4,0,0,0,0,4,69,42,4.9,1.4,6.7
12/17/20,11,0,0,4,0,15,11,0,3,0,7,21,52,36,4.9,1.4,6.7
12/18/20,12,0,0,7,0,19,14,0,2,0,2,18,59,40,4.9,1.4,6.7
12/19/20,4,0,2,4,0,10,5,0,1,0,3,9,58,36,4.9,1.4,6.7
12/20/20,5,0,2,0,0,7,6,0,5,0,1,12,66,30,4.9,1.4,6.7
12/21/20,10,0,1,1,0,12,2,0,1,0,0,3,64,38,4.9,1.4,6.7
12/22/20,14,0,0,2,0,16,13,2,3,0,3,21,69,44,4.9,1.4,6.7
12/23/20,8,0,0,7,0,15,4,0,3,0,5,12,69,42,4.9,1.4,6.7
12/24/20,3,0,3,0,0,6,7,0,2,0,0,9,75,40,4.9,1.4,6.7
12/25/20,3,0,0,1,0,4,8,0,2,0,3,13,75,43,4.9,1.4,6.7
12/26/20,5,0,1,0,0,6,5,0,9,0,8,22,82,47,4.9,1.4,6.7
12/27/20,5,0,0,0,0,5,4,0,2,0,3,9,57,34,4.9,1.4,6.7
12/28/20,14,0,4,4,0,22,2,0,1,0,1,4,71,41,4.9,1.4,6.7
12/29/20,5,0,3,2,0,10,5,2,2,2,3,14,71,35,4.9,1.4,6.7
12/30/20,9,0,0,3,0,12,14,0,5,0,1,20,77,47,4.9,1.4,6.7
12/31/20,11,0,0,3,0,14,8,0,5,0,6,19,75,56,4.9,1.4,6.7
1/1/21,2,0,2,0,0,4,7,1,4,0,3,15,77,63,4.9,1.4,6.7
1/2/21,8,0,0,2,0,10,6,2,0,0,0,8,75,44,4.9,1.4,6.7
1/3/21,9,0,0,0,0,9,2,0,0,0,1,3,44,37,4.9,1.4,6.7
1/4/21,5,0,1,2,0,8,7,0,2,0,6,15,53,37,5.2,1.4,6.4
1/5/21,16,0,0,2,0,18,4,0,1,1,5,11,64,37,5.2,1.4,6.4
1/6/21,8,0,4,1,0,13,5,0,5,0,0,10,72,37,5.2,1.4,6.4
1/7/21,9,0,1,1,0,11,7,0,3,0,1,11,78,39,5.2,1.4,6.4
1/8/21,10,0,0,1,0,11,10,0,3,0,6,19,73,44,5.2,1.4,6.4
1/9/21,3,0,1,1,0,5,4,1,2,0,2,9,71,49,5.2,1.4,6.4
1/10/21,3,0,0,1,0,4,4,0,3,0,1,8,63,42,5.2,1.4,6.4
1/11/21,10,0,2,4,0,16,11,0,2,0,3,16,54,37,5.2,1.4,6.4
1/12/21,13,0,4,0,0,17,7,0,0,0,3,10,54,32,5.2,1.4,6.4
1/13/21,11,0,0,1,0,12,8,0,4,0,4,16,45,34,5.2,1.4,6.4
1/14/21,7,0,0,4,0,11,7,0,2,0,4,13,50,32,5.2,1.4,6.4
1/15/21,9,0,1,0,0,10,9,0,4,0,5,18,53,31,5.2,1.4,6.4
1/16/21,8,0,2,3,0,13,0,0,1,1,0,2,67,32,5.2,1.4,6.4
1/17/21,5,0,0,2,0,7,3,0,3,0,3,9,69,38,5.2,1.4,6.4
1/18/21,3,0,1,0,0,4,7,0,6,0,3,16,60,39,5.2,1.4,6.4
1/19/21,7,0,2,6,0,15,6,0,7,2,7,22,65,37,5.2,1.4,6.4
1/20/21,12,0,1,2,0,15,5,0,4,0,9,18,69,39,5.2,1.4,6.4
1/21/21,10,0,1,10,0,21,8,0,3,0,4,15,75,37,5.2,1.4,6.4
1/22/21,7,0,2,4,0,13,14,1,3,0,3,21,69,50,5.2,1.4,6.4
1/23/21,7,0,1,0,0,8,2,0,2,1,0,5,55,48,5.2,1.4,6.4
1/24/21,14,0,0,0,0,14,7,0,6,0,0,13,66,50,5.2,1.4,6.4
1/25/21,11,0,1,3,0,15,5,0,4,1,7,17,78,52,5.2,1.4,6.4
1/26/21,16,0,4,10,0,30,8,0,3,0,2,13,61,50,5.2,1.4,6.4
1/27/21,13,0,1,3,0,17,14,0,6,0,1,21,71,60,5.2,1.4,6.4
1/28/21,11,0,0,4,0,15,9,0,2,0,2,13,76,49,5.2,1.4,6.4
1/29/21,6,0,0,7,0,13,4,0,4,0,2,10,73,46,5.2,1.4,6.4
1/30/21,2,0,2,3,0,7,5,1,1,0,2,9,65,45,5.2,1.4,6.4
1/31/21,4,0,2,0,0,6,7,0,2,0,0,9,56,38,5.2,1.4,6.4
2/1/21,8,0,1,9,0,18,10,0,5,0,8,23,69,36,5.2,1.4,6.4
2/2/21,9,0,7,5,0,21,5,0,4,0,0,9,80,53,5.2,1.4,6.4
2/3/21,7,0,1,4,0,12,5,0,3,0,3,11,69,49,5.2,1.4,6.4
2/4/21,8,0,3,3,0,14,7,0,0,1,6,14,67,41,5.1,1.7,6.2
2/5/21,3,0,3,4,0,10,12,0,0,1,0,13,69,40,5.1,1.7,6.2
2/6/21,2,0,1,0,0,3,0,1,0,0,0,1,77,45,5.1,1.7,6.2
2/7/21,4,0,1,1,0,6,4,0,1,0,0,5,85,55,5.1,1.7,6.2
2/8/21,12,0,1,3,0,16,1,0,2,0,0,3,61,44,5.1,1.7,6.2
2/9/21,13,0,1,5,0,19,5,0,2,1,0,8,75,48,5.1,1.7,6.2
2/10/21,8,0,0,6,0,14,8,0,0,0,0,8,70,40,5.1,1.7,6.2
2/11/21,7,0,0,11,0,18,10,0,1,0,0,11,76,51,5.1,1.7,6.2
2/12/21,7,0,1,0,0,8,7,0,4,0,7,18,64,46,5.1,1.7,6.2
2/13/21,6,0,0,0,0,6,4,0,4,0,0,8,46,37,5.1,1.7,6.2
2/17/21,1,0,4,0,0,5,4,0,0,0,6,10,37,31,5.1,1.7,6.2
2/18/21,0,0,2,0,0,2,10,0,3,0,2,15,33,29,5.1,1.7,6.2
2/19/21,2,0,1,1,0,4,8,0,1,0,4,13,31,26,5.1,1.7,6.2
2/20/21,8,0,3,1,0,12,5,0,1,0,2,8,30,13,5.1,1.7,6.2
2/21/21,2,0,0,1,0,3,7,0,3,0,0,10,25,8,5.1,1.7,6.2
2/22/21,11,0,1,7,0,19,14,1,7,1,8,31,26,7,5.1,1.7,6.2
2/23/21,7,0,0,4,0,11,10,0,1,1,0,12,32,24,5.1,1.7,6.2
2/24/21,1,0,2,1,0,4,10,0,4,0,7,21,33,24,5.1,1.7,6.2
2/25/21,7,0,1,3,0,11,2,0,1,0,4,7,43,21,5.1,1.7,6.2
2/26/21,10,0,1,1,0,12,7,2,5,0,2,16,62,26,5.1,1.7,6.2
2/27/21,8,0,0,0,0,8,2,0,1,0,0,3,76,44,5.1,1.7,6.2
2/28/21,5,0,0,0,0,5,1,0,5,0,4,10,76,42,5.1,1.7,6.2
3/1/21,6,0,0,2,0,8,7,0,2,0,6,15,79,47,5.1,1.7,6.2
3/2/21,16,0,1,9,0,26,3,0,3,1,2,9,86,64,5.1,1.7,6.2
3/3/21,17,0,0,12,0,29,3,1,1,1,1,7,66,51,5.1,1.7,6.2
3/4/21,3,0,1,2,0,6,11,0,3,0,9,23,60,47,5.1,1.7,6.2
3/5/21,9,0,0,6,0,15,30,0,0,0,1,31,79,58,5.1,1.7,6.2
3/6/21,1,0,1,0,0,2,1,0,3,0,0,4,74,58,5.1,1.7,6.2
3/7/21,8,0,2,0,0,10,9,0,2,0,4,15,58,48,4.8,2.6,6.1
3/8/21,15,0,1,3,0,19,8,0,5,0,8,21,67,45,4.8,2.6,6.1
3/9/21,7,0,0,6,0,13,4,0,4,0,0,8,73,38,4.8,2.6,6.1
3/10/21,9,0,1,5,0,15,6,0,3,0,4,13,77,45,4.8,2.6,6.1
3/11/21,9,0,1,15,0,25,7,0,3,0,2,12,80,57,4.8,2.6,6.1
3/12/21,6,0,1,5,0,12,6,1,1,0,2,10,69,49,4.8,2.6,6.1
3/13/21,1,0,1,0,0,2,3,0,0,0,3,6,71,41,4.8,2.6,6.1
3/14/21,5,0,1,1,0,7,6,0,1,0,2,9,74,45,4.8,2.6,6.1
3/15/21,6,0,1,6,0,13,13,0,5,0,3,21,77,57,4.8,2.6,6.1
3/16/21,6,0,5,4,0,15,6,0,1,0,1,8,83,64,4.8,2.6,6.1
3/17/21,5,0,0,2,0,7,2,1,2,0,4,9,82,69,4.8,2.6,6.1
3/18/21,3,0,2,14,0,19,8,0,5,0,2,15,81,69,4.8,2.6,6.1
3/19/21,5,0,0,9,0,14,3,0,2,0,10,15,77,68,4.8,2.6,6.1
3/20/21,7,0,0,1,0,8,5,0,3,0,4,12,78,53,4.8,2.6,6.1
3/21/21,11,0,2,1,0,14,14,0,5,0,2,21,87,47,4.8,2.6,6.1
3/22/21,12,0,3,3,0,18,2,0,5,1,3,11,83,67,4.8,2.6,6.1
3/23/21,6,0,1,5,0,12,9,1,2,0,2,14,77,54,4.8,2.6,6.1
3/24/21,11,0,0,10,0,21,11,1,1,1,2,16,73,47,4.8,2.6,6.1
3/25/21,8,0,0,3,0,11,9,0,7,0,3,19,71,46,4.8,2.6,6.1
3/26/21,9,0,0,6,0,15,15,0,1,0,2,18,73,43,4.8,2.6,6.1
3/27/21,3,0,0,3,0,6,5,0,0,0,5,10,76,50,4.8,2.6,6.1
3/28/21,10,0,1,2,0,13,9,0,4,0,0,13,73,57,4.8,2.6,6.1
3/29/21,7,0,2,4,0,13,6,0,1,0,6,13,82,54,4.8,2.6,6.1
3/30/21,3,0,0,14,0,17,6,0,3,0,1,10,72,54,4.8,2.6,6.1
3/31/21,10,0,4,13,0,27,9,0,1,0,4,14,75,55,4.8,2.6,6.1
4/1/21,6,0,1,4,0,11,7,1,2,0,1,11,84,48,4.8,2.6,6.1
4/2/21,7,0,2,3,0,12,5,0,1,0,1,7,87,66,4.8,2.6,6.1
4/3/21,4,0,0,0,0,4,4,0,5,0,4,13,76,54,4.8,2.6,6.1
4/4/21,6,0,0,0,0,6,4,0,4,0,3,11,78,45,4.8,2.6,6.1
4/5/21,15,0,2,3,0,20,9,0,0,0,3,12,80,60,4.8,2.6,6.1
4/6/21,7,0,1,4,0,12,8,0,2,0,1,11,73,56,4.8,2.6,6.1
4/7/21,7,0,1,2,0,10,6,0,0,1,0,7,72,43,4.2,4.2,6.1
4/8/21,8,0,2,3,0,13,8,0,4,0,11,23,73,44,4.2,4.2,6.1
4/9/21,4,0,1,5,0,10,4,0,1,0,10,15,66,52,4.2,4.2,6.1
4/10/21,4,0,1,1,0,6,5,1,1,0,2,9,75,56,4.2,4.2,6.1
4/11/21,6,0,0,1,0,7,11,1,8,0,3,23,83,59,4.2,4.2,6.1
4/12/21,7,0,1,7,0,15,8,1,7,0,4,20,87,67,4.2,4.2,6.1
4/13/21,24,0,2,5,0,31,7,0,0,0,1,8,89,62,4.2,4.2,6.1
4/14/21,15,0,0,6,0,21,5,0,7,2,0,14,92,53,4.2,4.2,6.1
4/15/21,10,0,2,4,0,16,10,0,4,0,2,16,92,69,4.2,4.2,6.1
4/16/21,22,0,1,4,0,27,2,0,2,0,4,8,82,59,4.2,4.2,6.1
4/17/21,11,0,0,0,0,11,5,0,0,0,0,5,90,48,4.2,4.2,6.1
4/18/21,3,0,6,1,0,10,11,1,4,0,3,19,90,66,4.2,4.2,6.1
4/19/21,12,0,2,5,0,19,5,0,3,0,5,13,84,71,4.2,4.2,6.1
4/20/21,11,0,1,5,0,17,8,0,3,0,0,11,84,70,4.2,4.2,6.1
4/21/21,14,0,0,17,0,31,13,0,3,0,0,16,73,61,4.2,4.2,6.1
4/22/21,5,0,1,5,0,11,11,0,4,0,13,28,69,60,4.2,4.2,6.1
4/23/21,15,0,2,5,0,22,21,0,5,0,2,28,66,53,4.2,4.2,6.1
4/24/21,8,0,0,1,0,9,3,0,1,0,3,7,70,51,4.2,4.2,6.1
4/25/21,5,0,1,0,0,6,10,0,4,0,2,16,77,49,4.2,4.2,6.1
4/26/21,6,0,2,6,0,14,9,0,5,0,4,18,85,51,4.2,4.2,6.1
4/27/21,5,0,1,3,0,9,21,0,2,0,9,32,68,44,4.2,4.2,6.1
4/28/21,9,0,1,3,0,13,15,0,1,0,3,19,67,52,4.2,4.2,6.1
4/29/21,14,0,1,7,0,22,16,0,4,0,2,22,72,62,4.2,4.2,6.1
4/30/21,10,0,3,3,0,16,19,0,3,0,0,22,84,61,4.2,4.2,6.1
5/1/21,8,0,1,2,0,11,16,0,3,0,5,24,89,56,4.2,4.2,6.1
5/2/21,8,0,0,1,0,9,4,0,7,0,3,14,87,68,4.2,4.2,6.1
5/3/21,13,0,0,12,0,25,14,0,1,0,8,23,80,69,4.2,4.2,6.1
5/4/21,11,0,2,2,0,15,7,0,1,0,0,8,85,74,4.2,4.2,6.1
5/5/21,7,0,0,6,0,13,9,1,3,0,2,15,75,68,4.2,4.2,6.1
5/6/21,9,0,0,4,0,13,9,1,2,0,4,16,75,66,4.2,4.2,6.1
5/7/21,7,0,2,5,0,14,10,0,2,0,0,12,76,65,4.1,5,5.8
5/8/21,9,0,2,0,0,11,5,0,6,0,2,13,89,61,4.1,5,5.8
5/9/21,6,0,1,2,0,9,8,0,2,1,2,13,94,73,4.1,5,5.8
5/10/21,8,0,1,6,0,15,15,0,3,0,7,25,84,67,4.1,5,5.8
5/11/21,10,0,0,2,0,12,3,0,2,1,1,7,82,58,4.1,5,5.8
5/12/21,14,0,0,5,0,19,8,1,6,0,7,22,89,58,4.1,5,5.8
5/13/21,10,0,5,7,0,22,9,0,2,0,3,14,87,60,4.1,5,5.8
5/14/21,8,0,4,3,0,15,7,0,2,0,2,11,91,68,4.1,5,5.8
5/15/21,16,0,0,1,0,17,4,0,2,0,0,6,90,74,4.1,5,5.8
5/16/21,8,0,0,1,0,9,5,0,3,0,3,11,80,63,4.1,5,5.8
5/17/21,9,0,3,5,0,17,12,0,4,1,3,20,76,62,4.1,5,5.8
5/18/21,13,0,1,2,0,16,11,0,2,0,0,13,75,60,4.1,5,5.8
5/19/21,9,0,0,4,0,13,8,0,6,1,0,15,75,60,4.1,5,5.8
5/20/21,10,0,0,10,0,20,9,0,2,0,4,15,85,58,4.1,5,5.8
5/21/21,5,0,0,4,0,9,3,0,5,0,2,10,80,67,4.1,5,5.8
5/22/21,7,0,0,1,0,8,5,0,1,0,0,6,82,70,4.1,5,5.8
5/23/21,8,0,3,0,0,11,0,1,0,0,3,4,82,66,4.1,5,5.8
5/24/21,13,0,3,4,0,20,10,1,5,0,7,23,79,66,4.1,5,5.8
5/25/21,17,0,2,9,0,28,8,0,3,0,5,16,73,64,4.1,5,5.8
5/26/21,10,0,3,6,0,19,14,0,4,0,2,20,86,63,4.1,5,5.8
5/27/21,18,0,0,7,0,25,3,2,3,0,6,14,87,69,4.1,5,5.8
5/28/21,11,0,1,3,0,15,18,0,2,0,2,22,81,72,4.1,5,5.8
5/29/21,6,0,1,2,0,9,10,0,2,0,0,12,74,70,4.1,5,5.8
5/30/21,13,0,7,0,0,20,17,0,4,0,4,25,88,70,4.1,5,5.8
5/31/21,5,0,2,4,0,11,20,0,2,0,4,26,91,72,4.1,5,5.8
6/1/21,13,0,1,6,0,20,9,1,4,0,4,18,91,68,4.1,5,5.8
6/2/21,11,0,1,5,0,17,11,0,2,0,1,14,90,75,4.1,5,5.8
6/3/21,19,0,0,9,0,28,7,0,3,0,2,12,88,66,4.1,5,5.8
6/4/21,10,0,1,5,0,16,8,1,2,2,6,19,88,66,4.1,5,5.8
6/5/21,4,0,0,1,0,5,8,0,1,0,0,9,88,69,4.1,5,5.8
6/6/21,8,0,1,1,0,10,11,0,5,0,0,16,86,69,4.1,5,5.8
6/7/21,14,0,1,6,0,21,11,0,6,1,4,22,87,68,4.5,5.4,5.9
6/8/21,9,0,1,12,0,22,14,0,3,2,3,22,89,64,4.5,5.4,5.9
6/9/21,15,0,0,9,0,24,18,1,3,1,5,28,73,64,4.5,5.4,5.9
6/10/21,21,0,1,4,0,26,0,1,0,0,1,2,85,68,4.5,5.4,5.9
6/11/21,33,0,5,7,0,45,9,0,6,1,0,16,83,69,4.5,5.4,5.9
6/12/21,10,0,11,3,0,24,4,4,1,0,3,12,91,69,4.5,5.4,5.9
6/13/21,20,0,1,1,0,22,17,0,3,0,19,39,91,78,4.5,5.4,5.9
6/14/21,7,0,1,2,0,10,14,0,5,1,1,21,93,78,4.5,5.4,5.9
6/15/21,14,0,26,8,0,48,13,0,4,1,2,20,95,77,4.5,5.4,5.9
6/16/21,19,0,2,7,0,28,8,0,3,0,2,13,94,77,4.5,5.4,5.9
6/17/21,12,0,0,12,0,24,18,0,1,0,11,30,93,78,4.5,5.4,5.9
6/18/21,6,0,3,0,0,9,18,1,3,1,4,27,95,76,4.5,5.4,5.9
6/19/21,1,0,1,4,0,6,2,0,1,0,2,5,99,75,4.5,5.4,5.9
6/20/21,8,0,1,0,0,9,22,2,2,0,10,36,100,76,4.5,5.4,5.9
6/21/21,13,0,1,19,0,33,15,0,4,1,4,24,99,75,4.5,5.4,5.9
6/22/21,8,0,1,10,0,19,21,1,0,1,7,30,97,73,4.5,5.4,5.9
6/23/21,16,0,2,11,0,29,20,0,2,0,1,23,97,74,4.5,5.4,5.9
6/24/21,7,0,0,7,0,14,10,1,2,0,14,27,94,76,4.5,5.4,5.9
6/25/21,12,0,0,7,0,19,11,0,3,0,1,15,96,70,4.5,5.4,5.9
6/26/21,8,0,0,5,0,13,7,0,4,0,0,11,95,76,4.5,5.4,5.9
6/27/21,2,0,0,1,0,3,0,0,0,0,2,2,96,81,4.5,5.4,5.9
6/28/21,18,0,1,6,0,25,26,0,13,0,4,43,89,73,4.5,5.4,5.9
6/29/21,10,0,1,7,0,18,13,0,5,0,6,24,98,79,4.5,5.4,5.9
6/30/21,14,0,1,5,0,20,7,1,7,0,3,18,98,78,4.5,5.4,5.9
7/1/21,8,0,0,7,0,15,4,0,3,0,1,8,97,78,4.5,5.4,5.9
7/2/21,26,0,1,8,0,35,15,0,4,0,11,30,98,78,4.5,5.4,5.9
7/3/21,7,0,2,2,0,11,9,0,1,0,1,11,92,76,4.5,5.4,5.9
7/4/21,7,0,3,1,0,11,14,1,2,0,5,22,91,74,4.5,5.4,5.9
7/5/21,3,0,4,1,0,8,7,0,6,0,2,15,88,74,4.5,5.4,5.9
7/6/21,21,0,4,9,0,34,14,1,7,0,7,29,93,75,4.5,5.4,5.9
7/7/21,24,0,1,12,0,37,25,1,2,0,0,28,96,74,4.1,5.4,5.4
7/8/21,31,0,1,7,0,39,16,0,0,0,4,20,97,76,4.1,5.4,5.4
7/9/21,15,0,1,8,0,24,11,1,2,0,2,16,93,76,4.1,5.4,5.4
7/10/21,9,0,0,1,0,10,7,0,4,1,0,12,86,75,4.1,5.4,5.4
7/11/21,2,0,0,1,0,3,21,0,5,0,1,27,85,75,4.1,5.4,5.4
7/12/21,20,0,0,7,0,27,21,0,4,0,7,32,90,75,4.1,5.4,5.4
7/13/21,22,0,0,5,0,27,11,1,3,0,2,17,88,73,4.1,5.4,5.4
7/14/21,11,0,5,12,0,28,9,0,5,0,1,15,89,74,4.1,5.4,5.4
7/15/21,17,0,0,5,0,22,12,2,1,0,0,15,81,75,4.1,5.4,5.4
7/16/21,17,0,0,11,0,28,8,0,7,0,4,19,94,75,4.1,5.4,5.4
7/17/21,15,0,1,2,0,18,26,1,3,0,7,37,91,77,4.1,5.4,5.4
7/18/21,9,0,0,2,0,11,15,0,5,1,8,29,88,75,4.1,5.4,5.4
7/19/21,10,0,2,7,0,19,18,1,2,1,3,25,91,72,4.1,5.4,5.4
7/20/21,19,0,1,4,0,24,6,0,0,0,0,6,93,72,4.1,5.4,5.4
7/21/21,13,0,1,3,0,17,11,0,4,0,4,19,93,76,4.1,5.4,5.4
7/22/21,17,0,0,6,0,23,11,0,4,0,10,25,94,76,4.1,5.4,5.4
7/23/21,12,0,4,13,0,29,12,0,0,0,0,12,94,77,4.1,5.4,5.4
7/24/21,15,0,2,0,0,17,5,0,1,0,0,6,95,74,4.1,5.4,5.4
7/25/21,4,0,0,1,0,5,18,1,11,0,3,33,97,75,4.1,5.4,5.4
7/26/21,7,0,0,6,0,13,17,0,3,0,6,26,92,73,4.1,5.4,5.4
7/27/21,11,0,2,8,0,21,14,0,3,0,0,17,93,73,4.1,5.4,5.4
7/28/21,15,0,1,16,0,32,8,0,7,0,2,17,94,71,4.1,5.4,5.4
7/29/21,15,0,0,17,0,32,22,0,5,0,15,42,95,74,4.1,5.4,5.4
7/30/21,8,0,1,9,0,18,4,0,1,1,1,7,98,77,4.1,5.4,5.4
7/31/21,8,0,2,2,0,12,3,1,3,0,1,8,100,75,4.1,5.4,5.4
8/1/21,4,0,0,3,0,7,7,0,5,0,1,13,99,74,4.1,5.4,5.4
8/2/21,21,0,0,8,0,29,14,0,2,0,4,20,98,75,4.1,5.4,5.4
8/3/21,18,0,1,13,0,32,12,1,2,0,4,19,97,78,4.1,5.4,5.4
8/4/21,15,0,2,8,0,25,8,0,4,0,1,13,98,76,4.1,5.4,5.4
8/5/21,9,0,0,7,0,16,12,0,1,0,0,13,97,75,4.1,5.4,5.4
8/6/21,14,0,0,7,0,21,16,0,2,0,11,29,98,77,4.1,5.4,5.4
8/7/21,9,0,0,7,0,16,8,0,1,0,1,10,101,78,3.9,5.3,5.1
8/8/21,7,0,1,1,0,9,14,0,4,0,0,18,86,74,3.9,5.3,5.1
8/9/21,8,0,1,16,0,25,14,0,6,0,3,23,93,75,3.9,5.3,5.1
8/10/21,13,0,2,4,0,19,18,0,0,0,2,20,92,74,3.9,5.3,5.1
8/11/21,6,0,1,12,0,19,15,0,4,0,3,22,86,77,3.9,5.3,5.1
8/12/21,14,0,2,6,0,22,12,0,6,0,3,21,92,75,3.9,5.3,5.1
8/13/21,13,0,1,1,0,15,10,0,4,0,1,15,96,76,3.9,5.3,5.1
8/14/21,3,0,2,2,0,7,20,0,0,1,3,24,98,78,3.9,5.3,5.1
8/15/21,3,0,1,0,0,4,21,0,4,0,1,26,99,79,3.9,5.3,5.1
8/16/21,20,0,2,17,0,39,8,2,6,0,7,23,99,77,3.9,5.3,5.1
8/17/21,18,0,0,9,0,27,10,0,3,0,0,13,99,77,3.9,5.3,5.1
8/18/21,11,0,3,6,0,20,12,0,6,2,5,25,99,77,3.9,5.3,5.1
8/19/21,9,0,2,11,0,22,14,0,2,0,7,23,99,76,3.9,5.3,5.1
8/20/21,14,0,1,6,0,21,11,0,4,0,9,24,99,76,3.9,5.3,5.1
8/21/21,5,0,0,2,0,7,6,0,2,0,1,9,94,72,3.9,5.3,5.1
8/22/21,15,0,2,1,0,18,15,0,4,2,1,22,94,71,3.9,5.3,5.1
8/23/21,11,0,3,14,0,28,8,0,1,0,8,17,93,75,3.9,5.3,5.1
8/24/21,15,0,1,9,0,25,12,0,1,0,2,15,95,80,3.9,5.3,5.1
8/25/21,17,0,0,1,0,18,11,0,3,0,0,14,97,80,3.9,5.3,5.1
8/26/21,5,0,0,20,0,25,6,0,6,0,8,20,95,78,3.9,5.3,5.1
8/27/21,19,0,0,7,0,26,13,0,0,0,3,16,98,78,3.9,5.3,5.1
8/28/21,8,0,2,4,0,14,11,1,1,1,9,23,98,75,3.9,5.3,5.1
8/29/21,3,0,2,1,0,6,15,0,3,0,5,23,97,74,3.9,5.3,5.1
8/30/21,21,0,1,8,0,30,15,0,3,0,1,19,98,76,3.9,5.3,5.1
8/31/21,12,0,1,13,0,26,9,1,3,0,15,28,98,76,3.9,5.3,5.1
9/1/21,13,0,0,9,0,22,9,0,1,0,1,11,100,77,3.9,5.3,5.1
9/2/21,12,0,1,3,0,16,21,0,2,0,0,23,90,76,3.9,5.3,5.1
9/3/21,12,0,1,9,0,22,8,0,3,0,0,11,94,75,3.9,5.3,5.1
9/4/21,12,0,1,2,0,15,22,0,6,0,6,34,96,76,3.9,5.3,5.1
9/5/21,5,0,0,2,0,7,13,0,2,0,4,19,96,75,3.9,5.3,5.1
9/6/21,2,0,1,0,0,3,11,0,3,0,0,14,100,75,3.9,5.3,5.1
9/7/21,12,0,4,5,0,21,14,1,5,0,10,30,100,78,3.7,5.4,4.7
9/8/21,12,0,1,9,0,22,10,0,3,0,6,19,99,79,3.7,5.4,4.7
9/9/21,17,0,1,4,0,22,33,0,1,0,1,35,99,78,3.7,5.4,4.7
9/10/21,12,0,0,9,0,21,9,0,4,0,2,15,100,77,3.7,5.4,4.7
9/11/21,4,0,1,2,0,7,22,0,2,0,3,27,102,75,3.7,5.4,4.7
9/12/21,9,0,1,11,0,21,17,0,5,0,1,23,100,74,3.7,5.4,4.7
9/13/21,12,0,0,7,0,19,8,0,7,0,6,21,97,72,3.7,5.4,4.7
9/14/21,15,0,2,9,0,26,21,0,0,1,1,23,101,69,3.7,5.4,4.7
9/15/21,12,0,3,11,0,26,13,2,8,0,2,25,97,69,3.7,5.4,4.7
9/16/21,13,0,4,8,0,25,9,0,3,0,4,16,96,67,3.7,5.4,4.7
9/17/21,25,0,0,9,0,34,7,0,4,0,1,12,93,65,3.7,5.4,4.7
9/18/21,9,0,0,2,0,11,18,0,8,0,4,30,94,69,3.7,5.4,4.7
9/19/21,2,0,2,3,0,7,8,2,1,0,30,41,91,75,3.7,5.4,4.7
9/20/21,13,0,1,5,0,19,16,1,3,0,6,26,88,73,3.7,5.4,4.7
9/21/21,21,0,0,17,0,38,9,0,3,0,1,13,93,74,3.7,5.4,4.7
9/22/21,12,0,0,7,0,19,13,0,1,0,3,17,95,70,3.7,5.4,4.7
9/23/21,14,0,1,8,0,23,9,1,2,0,0,12,99,70,3.7,5.4,4.7
9/24/21,13,0,3,10,0,26,8,0,3,0,1,12,99,72,3.7,5.4,4.7
9/25/21,10,0,1,1,0,12,18,1,11,0,2,32,101,73,3.7,5.4,4.7
9/26/21,8,0,0,0,0,8,20,0,3,0,0,23,102,75,3.7,5.4,4.7
9/27/21,14,0,1,8,0,23,8,0,4,1,1,14,95,77,3.7,5.4,4.7
9/28/21,9,0,0,9,0,18,7,0,2,1,5,15,87,64,3.7,5.4,4.7
9/29/21,13,0,0,25,0,38,11,0,2,0,26,39,89,58,3.7,5.4,4.7
9/30/21,8,0,9,13,0,30,15,0,2,0,1,18,89,60,3.7,5.4,4.7
10/1/21,10,0,0,12,0,22,5,0,4,0,1,10,90,61,3.7,5.4,4.7
10/2/21,11,1,1,4,0,17,11,0,4,0,9,24,92,61,3.7,5.4,4.7
10/3/21,9,0,2,2,0,13,15,0,3,1,1,20,94,65,3.7,5.4,4.7
10/4/21,8,0,0,5,0,13,11,0,4,0,3,18,98,68,3.7,5.4,4.7
10/5/21,12,0,0,9,0,21,7,0,2,0,5,14,90,68,3.7,5.4,4.7
10/6/21,16,0,1,9,0,26,7,0,5,0,6,18,94,74,3.7,5.4,4.7
10/7/21,13,0,0,16,0,29,3,0,6,0,0,9,88,68,3.5,6.2,4.5
10/8/21,12,0,0,9,0,21,4,1,2,0,1,8,88,76,3.5,6.2,4.5
10/9/21,7,0,2,2,0,11,19,0,8,0,5,32,90,70,3.5,6.2,4.5
10/10/21,6,0,0,2,0,8,17,0,4,0,1,22,92,65,3.5,6.2,4.5
10/11/21,13,0,1,13,0,27,15,0,5,0,0,20,91,64,3.5,6.2,4.5
10/12/21,13,0,0,9,0,22,5,0,5,2,2,14,90,60,3.5,6.2,4.5
10/13/21,14,0,2,6,0,22,3,0,6,0,26,35,91,65,3.5,6.2,4.5
10/14/21,11,0,2,7,0,20,12,0,3,0,1,16,91,66,3.5,6.2,4.5
10/15/21,13,0,0,7,0,20,7,0,0,0,3,10,89,65,3.5,6.2,4.5
10/16/21,9,0,1,0,0,10,14,0,6,0,5,25,92,64,3.5,6.2,4.5
10/17/21,14,0,1,0,0,15,21,0,4,2,0,27,84,62,3.5,6.2,4.5
10/18/21,19,0,0,5,0,24,9,0,2,1,0,12,88,69,3.5,6.2,4.5
10/19/21,13,0,2,4,0,19,3,1,6,0,5,15,89,68,3.5,6.2,4.5
10/20/21,26,0,1,6,0,33,9,0,2,0,1,12,79,68,3.5,6.2,4.5
10/21/21,12,0,1,4,0,17,6,0,5,0,2,13,91,65,3.5,6.2,4.5
10/22/21,16,0,0,4,0,20,2,0,4,1,1,8,75,54,3.5,6.2,4.5
10/23/21,8,0,1,1,0,10,18,0,8,0,19,45,75,50,3.5,6.2,4.5
10/24/21,9,0,1,1,0,11,5,0,3,0,3,11,78,49,3.5,6.2,4.5
10/25/21,19,0,1,8,0,28,6,0,1,0,1,8,84,58,3.5,6.2,4.5
10/26/21,9,0,3,8,0,20,8,0,6,0,3,17,85,67,3.5,6.2,4.5
10/27/21,17,0,0,4,0,21,9,0,4,0,29,42,86,64,3.5,6.2,4.5
10/28/21,15,0,0,6,0,21,7,0,4,0,1,12,87,65,3.5,6.2,4.5
10/29/21,11,0,0,5,0,16,14,0,2,0,1,17,89,70,3.5,6.2,4.5
10/30/21,7,0,2,0,0,9,16,1,3,0,0,20,87,70,3.5,6.2,4.5
10/31/21,7,0,4,2,0,13,7,0,6,0,2,15,90,70,3.5,6.2,4.5
11/1/21,10,0,1,12,0,23,8,0,5,1,5,19,87,72,3.5,6.2,4.5
11/2/21,8,0,1,10,0,19,1,0,0,0,0,1,78,55,3.5,6.2,4.5
11/3/21,12,0,4,5,0,21,9,0,5,0,8,22,79,56,3.5,6.2,4.5
11/4/21,9,0,0,10,0,19,15,0,3,2,24,44,76,52,3.5,6.2,4.5
11/5/21,23,0,0,9,0,32,9,0,5,0,0,14,82,51,3.5,6.2,4.5
11/6/21,8,0,0,4,0,12,14,1,3,0,12,30,84,52,3.5,6.2,4.5
11/7/21,6,0,0,0,0,6,8,0,1,0,4,13,82,53,3.2,6.8,4.1
11/8/21,11,0,1,8,0,20,9,1,3,0,1,14,79,60,3.2,6.8,4.1
11/9/21,16,0,0,8,0,24,9,0,3,0,0,12,65,50,3.2,6.8,4.1
11/10/21,13,0,3,19,0,35,11,0,3,0,23,37,62,45,3.2,6.8,4.1
11/11/21,6,0,1,0,0,7,13,1,3,0,1,18,66,41,3.2,6.8,4.1
11/12/21,19,0,4,5,0,28,8,1,0,1,2,12,71,42,3.2,6.8,4.1
11/13/21,9,0,0,2,0,11,10,0,3,0,1,14,75,45,3.2,6.8,4.1
11/14/21,3,0,0,2,0,5,13,0,3,0,0,16,78,51,3.2,6.8,4.1
11/15/21,9,0,1,19,0,29,12,1,7,0,4,24,79,57,3.2,6.8,4.1
11/16/21,8,0,5,6,0,19,0,0,2,0,1,3,81,63,3.2,6.8,4.1
11/17/21,25,0,1,11,0,37,17,0,11,0,2,30,75,51,3.2,6.8,4.1
11/18/21,12,0,1,18,0,31,6,0,1,0,3,10,79,45,3.2,6.8,4.1
11/19/21,10,0,0,5,0,15,19,0,5,0,8,32,71,46,3.2,6.8,4.1
11/20/21,6,0,0,1,0,7,7,0,5,0,3,15,80,48,3.2,6.8,4.1
11/21/21,8,0,0,1,0,9,16,0,6,0,6,28,82,58,3.2,6.8,4.1
11/22/21,16,0,2,11,0,29,8,0,5,0,2,15,82,65,3.2,6.8,4.1
11/23/21,23,0,2,3,0,28,7,0,6,1,1,15,83,63,3.2,6.8,4.1
11/24/21,11,0,5,10,0,26,12,0,4,0,2,18,66,52,3.2,6.8,4.1
11/25/21,3,0,0,0,0,3,11,0,3,0,1,15,67,43,3.2,6.8,4.1
11/26/21,4,0,5,0,0,9,10,0,12,0,6,28,75,49,3.2,6.8,4.1
11/27/21,7,0,0,2,0,9,11,0,1,0,2,14,78,59,3.2,6.8,4.1
11/28/21,7,0,1,4,0,12,12,0,2,0,3,17,71,45,3.2,6.8,4.1
11/29/21,16,0,2,9,0,27,10,0,0,0,4,14,71,39,3.2,6.8,4.1
11/30/21,7,0,0,5,0,12,6,0,9,0,25,40,78,53,3.2,6.8,4.1
12/1/21,13,0,0,3,0,16,13,0,9,0,5,27,69,50,3.2,6.8,4.1
12/2/21,19,0,0,15,0,34,3,0,3,0,1,7,57,44,3.2,6.8,4.1
12/3/21,14,0,2,9,0,25,12,0,2,0,3,17,52,47,3.2,6.8,4.1
12/4/21,12,0,3,2,0,17,12,1,3,0,0,16,72,46,3.2,6.8,4.1
12/5/21,9,0,1,2,0,12,10,0,4,0,2,16,73,45,3.2,6.8,4.1
12/6/21,23,0,4,12,0,39,5,1,2,0,17,25,75,48,3.2,6.8,4.1
12/7/21,9,0,0,1,0,10,9,0,2,1,4,16,76,50,2.9,7,3.9
12/8/21,8,0,0,13,0,21,8,1,3,0,1,13,81,52,2.9,7,3.9
12/9/21,16,0,1,4,0,21,19,0,3,0,3,25,75,62,2.9,7,3.9
12/10/21,8,0,2,9,0,19,24,1,5,0,8,38,78,64,2.9,7,3.9
12/11/21,8,0,5,1,0,14,18,1,11,0,2,32,80,67,2.9,7,3.9
12/12/21,6,0,0,0,0,6,18,0,1,0,9,28,73,47,2.9,7,3.9
12/13/21,19,0,2,12,0,33,18,0,3,0,4,25,69,40,2.9,7,3.9
12/14/21,13,0,4,8,0,25,0,0,0,0,1,1,79,45,2.9,7,3.9
12/15/21,10,0,3,5,0,18,6,1,3,0,3,13,79,62,2.9,7,3.9
12/16/21,10,0,2,4,0,16,10,1,6,0,4,21,85,71,2.9,7,3.9
12/17/21,19,0,0,10,0,29,10,0,3,0,0,13,72,40,2.9,7,3.9
12/18/21,8,0,0,1,0,9,18,3,10,0,5,36,62,33,2.9,7,3.9
12/19/21,5,0,2,2,0,9,7,0,4,1,6,18,65,44,2.9,7,3.9
12/20/21,21,0,1,8,0,30,13,0,6,0,6,25,77,58,2.9,7,3.9
12/21/21,12,0,1,9,0,22,0,0,0,0,4,4,81,69,2.9,7,3.9
12/22/21,5,0,1,18,0,24,7,0,4,1,2,14,79,71,2.9,7,3.9
12/23/21,9,0,0,3,0,12,21,0,6,0,3,30,79,71,2.9,7,3.9
12/24/21,3,0,1,0,0,4,15,0,1,1,3,20,72,46,2.9,7,3.9
12/26/21,15,0,0,3,0,18,8,1,4,2,4,19,56,40,2.9,7,3.9
12/27/21,23,0,2,11,0,36,15,2,1,0,5,23,60,43,2.9,7,3.9
12/28/21,21,0,12,7,0,40,14,0,12,0,35,61,68,38,2.9,7,3.9
12/29/21,28,0,0,10,0,38,15,0,1,0,2,18,75,49,2.9,7,3.9
12/30/21,9,0,0,6,0,15,7,1,2,0,0,10,71,55,2.9,7,3.9
12/31/21,27,0,0,5,0,32,5,0,5,0,1,11,78,61,2.9,7,3.9
1/1/22,2,0,0,0,0,2,12,1,2,0,2,17,79,62,2.9,7,3.9
1/2/22,16,0,1,4,0,21,18,0,4,0,8,30,76,60,2.9,7,3.9
1/3/22,23,0,0,7,0,30,10,1,1,0,7,19,79,67,2.9,7,3.9
1/4/22,12,0,0,16,0,28,22,0,4,0,5,31,75,62,2.9,7,3.9
1/5/22,9,0,1,4,0,14,6,0,2,0,8,16,82,59,2.9,7,3.9
1/6/22,14,0,3,5,0,22,10,0,3,0,2,15,82,57,2.9,7,3.9
1/7/22,20,0,2,5,0,27,0,1,0,0,2,3,83,66,2.9,7,3.9
1/8/22,19,0,2,0,0,21,30,0,7,0,3,40,78,38,3.4,7.5,4
1/9/22,5,0,1,0,0,6,10,0,3,0,9,22,48,25,3.4,7.5,4
1/10/22,13,0,4,19,0,36,11,0,2,0,3,16,57,28,3.4,7.5,4
1/11/22,11,0,0,11,0,22,16,0,4,0,2,22,67,36,3.4,7.5,4
1/12/22,8,0,2,9,0,19,8,0,6,0,0,14,74,42,3.4,7.5,4
1/13/22,15,0,0,5,0,20,0,0,0,0,2,2,56,34,3.4,7.5,4
1/14/22,9,0,1,10,0,20,17,0,6,0,8,31,42,28,3.4,7.5,4
1/15/22,15,0,0,0,0,15,16,0,3,0,2,21,63,42,3.4,7.5,4
1/16/22,6,0,0,3,0,9,13,1,5,0,11,30,64,48,3.4,7.5,4
1/17/22,7,0,2,0,0,9,10,0,4,0,1,15,59,41,3.4,7.5,4
1/18/22,27,0,1,9,0,37,2,0,1,0,2,5,51,41,3.4,7.5,4
1/19/22,15,0,3,6,0,24,15,0,3,0,4,22,66,43,3.4,7.5,4
1/20/22,8,0,4,6,0,18,0,0,1,0,0,1,75,40,3.4,7.5,4
1/21/22,31,0,1,11,0,43,9,0,3,0,6,18,78,43,3.4,7.5,4
1/22/22,7,0,0,5,0,12,6,0,5,0,2,13,64,41,3.4,7.5,4
1/24/22,13,0,2,8,0,23,18,0,4,0,27,49,63,34,3.4,7.5,4
1/25/22,15,0,2,6,0,23,1,0,0,1,2,4,68,34,3.4,7.5,4
1/26/22,23,0,2,5,0,30,13,1,8,0,0,22,75,44,3.4,7.5,4
1/27/22,17,0,1,5,0,23,0,0,1,0,0,1,81,42,3.4,7.5,4
1/28/22,10,0,0,4,0,14,8,0,6,0,4,18,42,32,3.4,7.5,4
1/29/22,9,0,1,4,0,14,17,1,4,0,2,24,50,28,3.4,7.5,4
1/30/22,7,0,0,0,0,7,7,4,1,0,12,24,55,28,3.4,7.5,4
1/31/22,17,0,3,15,0,35,16,0,6,0,37,59,58,42,3.4,7.5,4
2/1/22,19,0,0,5,0,24,17,0,5,0,2,24,53,44,3.4,7.5,4
2/2/22,14,0,2,17,0,33,29,0,4,0,2,35,53,46,3.4,7.5,4
2/3/22,6,0,2,0,0,8,0,0,0,0,3,3,55,42,3.4,7.5,4
2/4/22,2,0,1,0,0,3,16,1,2,0,0,19,61,41,3.4,7.5,4
2/5/22,13,0,3,2,0,18,18,0,9,0,3,30,60,38,3.4,7.5,4
2/6/22,2,0,0,0,0,2,9,0,0,0,4,13,68,36,3.4,7.5,4
2/7/22,18,0,3,12,0,33,5,0,8,1,2,16,71,36,3.4,7.5,4
2/8/22,12,0,5,19,0,36,9,0,8,0,4,21,59,52,3.4,7.5,4
2/9/22,13,0,2,4,0,19,13,0,0,0,0,13,66,53,3.2,7.9,3.8
2/10/22,17,0,1,12,0,30,14,0,11,0,9,34,60,37,3.2,7.9,3.8
2/11/22,13,0,4,4,0,21,4,1,12,0,4,21,37,22,3.2,7.9,3.8
2/12/22,7,0,0,2,0,9,6,1,9,0,1,17,42,21,3.2,7.9,3.8
2/13/22,3,0,0,0,0,3,8,0,3,0,26,37,52,26,3.2,7.9,3.8
2/14/22,19,0,1,6,0,26,12,0,2,0,2,16,59,29,3.2,7.9,3.8
2/15/22,24,0,1,4,0,29,0,0,0,0,1,1,62,37,3.2,7.9,3.8
2/16/22,10,0,0,4,0,14,18,0,3,0,1,22,68,35,3.2,7.9,3.8
2/17/22,12,0,0,4,0,16,12,0,1,0,6,19,75,41,3.2,7.9,3.8
2/18/22,22,0,1,7,0,30,8,0,2,0,10,20,75,40,3.2,7.9,3.8
2/19/22,7,0,1,0,0,8,12,1,6,0,3,22,77,48,3.2,7.9,3.8
2/20/22,3,0,0,0,0,3,7,0,5,0,1,13,58,35,3.2,7.9,3.8
2/21/22,24,0,3,0,0,27,13,0,4,1,2,20,67,30,3.2,7.9,3.8
2/22/22,11,0,5,7,0,23,0,0,1,0,1,2,71,36,3.2,7.9,3.8
2/23/22,16,0,3,2,0,21,14,0,7,1,2,24,75,42,3.2,7.9,3.8
2/24/22,20,0,2,2,0,24,10,0,4,0,4,18,77,61,3.2,7.9,3.8
2/25/22,13,0,1,3,0,17,10,0,4,0,5,19,72,36,3.2,7.9,3.8
2/26/22,5,0,1,1,0,7,7,0,3,0,0,10,60,32,3.2,7.9,3.8
2/27/22,4,0,0,1,0,5,6,0,7,0,11,24,66,32,3.2,7.9,3.8
2/28/22,8,0,1,5,0,14,21,0,3,0,3,27,73,41,3.2,7.9,3.8
3/1/22,14,0,1,6,0,21,1,0,0,0,1,2,85,62,3.2,7.9,3.8
3/2/22,12,0,5,4,0,21,18,1,7,0,24,50,88,48,3.2,7.9,3.8
3/3/22,15,0,6,11,0,32,11,0,9,0,1,21,48,29,3.2,7.9,3.8
3/4/22,13,0,4,9,0,26,10,0,4,1,1,16,36,28,3.2,7.9,3.8
3/5/22,13,0,1,4,0,18,7,0,5,0,0,12,39,31,3.2,7.9,3.8
3/6/22,5,0,0,0,0,5,11,0,1,0,5,17,41,36,3.2,7.9,3.8
3/7/22,14,0,3,7,0,24,6,0,2,0,16,24,62,37,3.2,7.9,3.8
3/8/22,16,0,0,4,0,20,4,0,5,0,0,9,68,33,3.2,7.9,3.8
3/9/22,13,0,0,4,0,17,10,1,2,0,1,14,74,35,2.8,8.5,3.6
3/10/22,11,0,2,4,0,17,9,0,1,0,15,25,76,42,2.8,8.5,3.6
3/11/22,15,0,3,4,0,22,10,1,4,0,0,15,80,51,2.8,8.5,3.6
3/12/22,8,0,0,0,0,8,13,1,2,0,5,21,79,61,2.8,8.5,3.6
3/13/22,5,0,1,0,0,6,15,1,1,0,1,18,82,65,2.8,8.5,3.6
3/14/22,7,0,0,7,0,14,0,0,1,0,0,1,82,69,2.8,8.5,3.6
3/15/22,15,0,3,5,0,23,10,0,6,0,8,24,73,43,2.8,8.5,3.6
3/16/22,16,0,3,2,0,21,8,0,5,1,1,15,55,42,2.8,8.5,3.6
3/17/22,9,0,2,9,0,20,8,0,6,0,7,21,62,36,2.8,8.5,3.6
3/18/22,24,0,1,3,0,28,12,1,3,0,0,16,74,38,2.8,8.5,3.6
3/19/22,7,0,0,3,0,10,11,0,2,0,2,15,63,37,2.8,8.5,3.6
3/20/22,3,0,1,1,0,5,19,0,7,0,0,26,58,28,2.8,8.5,3.6
3/21/22,7,0,1,1,0,9,0,1,0,0,0,1,68,33,2.8,8.5,3.6
3/22/22,16,0,0,11,0,27,9,0,7,0,1,17,82,50,2.8,8.5,3.6
3/23/22,6,0,0,2,0,8,9,0,0,0,7,16,78,53,2.8,8.5,3.6
3/24/22,18,0,0,5,0,23,10,0,9,0,35,54,84,44,2.8,8.5,3.6
3/25/22,8,0,1,3,0,12,6,0,3,0,6,15,72,55,2.8,8.5,3.6
3/26/22,9,0,3,2,0,14,9,0,3,0,5,17,75,50,2.8,8.5,3.6
3/27/22,1,0,1,0,0,2,21,0,4,0,3,28,80,43,2.8,8.5,3.6
3/28/22,11,0,1,6,0,18,0,0,0,0,7,7,80,48,2.8,8.5,3.6
3/29/22,11,0,0,10,0,21,8,1,8,0,1,18,80,59,2.8,8.5,3.6
3/30/22,22,0,0,10,0,32,15,0,3,0,8,26,66,50,2.8,8.5,3.6
3/31/22,4,0,2,9,0,15,15,0,8,0,5,28,71,44,2.8,8.5,3.6
4/1/22,16,0,22,2,0,40,8,0,0,0,4,12,77,45,2.8,8.5,3.6
4/2/22,10,0,1,0,0,11,10,0,7,0,3,20,86,42,2.8,8.5,3.6
4/3/22,3,0,0,1,0,4,12,0,2,0,3,17,91,54,2.8,8.5,3.6
4/4/22,30,0,4,14,0,48,0,0,2,0,12,14,88,58,2.8,8.5,3.6
4/5/22,16,0,3,4,0,23,12,0,7,0,1,20,87,58,2.8,8.5,3.6
4/6/22,5,0,2,2,0,9,10,1,4,0,15,30,80,68,2.8,8.5,3.6
4/7/22,15,0,2,3,0,20,8,0,2,0,1,11,80,57,2.8,8.5,3.6
4/8/22,10,0,0,6,0,16,10,0,5,0,12,27,79,45,2.8,8.5,3.6
4/9/22,4,0,0,0,0,4,8,0,9,0,6,23,82,49,2.6,8.3,3.7
4/10/22,7,0,1,0,0,8,13,0,3,1,0,17,88,59,2.6,8.3,3.7
4/11/22,33,0,2,7,0,42,6,0,2,0,1,9,87,53,2.6,8.3,3.7
4/12/22,14,0,0,8,0,22,12,0,2,0,9,23,80,66,2.6,8.3,3.7
4/13/22,19,0,3,6,0,28,9,2,4,0,21,36,96,71,2.6,8.3,3.7
4/14/22,9,0,1,11,0,21,8,1,0,0,2,11,81,63,2.6,8.3,3.7
4/15/22,11,0,0,10,0,21,6,0,5,0,30,41,78,50,2.6,8.3,3.7
4/16/22,6,0,1,3,0,10,17,0,1,0,6,24,79,48,2.6,8.3,3.7
4/17/22,2,0,2,1,0,5,0,1,0,0,4,5,88,44,2.6,8.3,3.7
4/18/22,14,0,0,5,0,19,7,2,2,0,6,17,88,60,2.6,8.3,3.7
4/19/22,14,0,2,5,0,21,16,0,4,0,5,25,84,68,2.6,8.3,3.7
4/20/22,7,0,1,2,0,10,2,0,2,0,0,4,92,72,2.6,8.3,3.7
4/21/22,10,0,3,4,0,17,4,1,4,0,0,9,95,68,2.6,8.3,3.7
4/22/22,22,0,4,14,0,40,9,0,3,0,13,25,83,57,2.6,8.3,3.7
4/23/22,11,0,1,11,0,23,11,0,4,0,1,16,83,64,2.6,8.3,3.7
4/24/22,2,0,1,0,0,3,9,0,3,0,23,35,83,72,2.6,8.3,3.7
4/25/22,11,0,0,3,0,14,10,0,6,0,4,20,88,65,2.6,8.3,3.7
4/26/22,18,0,0,5,0,23,7,1,3,0,2,13,79,62,2.6,8.3,3.7
4/27/22,18,0,0,4,0,22,5,0,13,1,10,29,71,56,2.6,8.3,3.7
4/28/22,11,0,2,3,0,16,8,1,4,0,1,14,86,67,2.6,8.3,3.7
4/29/22,16,0,8,4,0,28,10,0,1,0,1,12,80,73,2.6,8.3,3.7
4/30/22,5,0,0,0,0,5,8,1,4,0,11,24,91,71,2.6,8.3,3.7
5/1/22,4,0,0,0,0,4,5,1,4,0,0,10,89,70,2.6,8.3,3.7
5/2/22,39,0,1,9,0,49,8,0,4,0,1,13,91,70,2.6,8.3,3.7
5/3/22,17,0,1,3,0,21,5,0,3,0,2,10,75,60,2.6,8.3,3.7
5/4/22,11,0,2,7,0,20,12,1,4,0,30,47,77,55,2.6,8.3,3.7
5/5/22,16,0,5,1,0,22,7,0,2,0,0,9,78,61,2.6,8.3,3.7
5/6/22,15,0,2,6,0,23,0,0,1,0,0,1,88,69,2.6,8.3,3.7
5/7/22,4,0,2,0,0,6,16,3,3,0,4,26,86,70,2.6,8.3,3.7
5/8/22,4,0,0,1,0,5,12,0,1,0,27,40,91,73,2.6,8.3,3.7
5/9/22,16,0,3,10,0,29,6,0,7,0,10,23,87,69,2.7,8.6,3.6
5/10/22,5,0,5,5,0,15,12,0,6,0,6,24,85,70,2.7,8.6,3.6
5/11/22,22,0,1,5,0,28,9,1,4,0,8,22,93,75,2.7,8.6,3.6
5/12/22,16,0,8,2,0,26,11,0,1,0,1,13,92,73,2.7,8.6,3.6
5/13/22,23,0,3,5,0,31,0,0,1,0,0,1,88,67,2.7,8.6,3.6
5/14/22,5,0,2,0,0,7,0,0,1,0,0,1,95,60,2.7,8.6,3.6
5/15/22,3,0,1,0,0,4,20,1,5,0,5,31,97,73,2.7,8.6,3.6
5/16/22,12,0,2,10,0,24,7,0,6,0,10,23,98,74,2.7,8.6,3.6
5/17/22,8,0,0,5,0,13,4,0,2,0,5,11,97,76,2.7,8.6,3.6
5/18/22,14,0,6,4,0,24,15,0,6,0,7,28,94,76,2.7,8.6,3.6
5/19/22,25,0,1,2,0,28,9,1,3,0,24,37,94,74,2.7,8.6,3.6
5/20/22,12,0,1,4,0,17,0,1,2,0,0,3,94,70,2.7,8.6,3.6
5/21/22,12,0,1,1,0,14,11,0,2,0,0,13,92,68,2.7,8.6,3.6
5/22/22,3,0,1,0,0,4,9,0,2,0,8,19,97,71,2.7,8.6,3.6
5/23/22,30,0,3,11,0,44,6,0,1,0,43,50,97,70,2.7,8.6,3.6
5/24/22,12,0,4,2,0,18,2,0,2,1,0,5,99,73,2.7,8.6,3.6
5/25/22,18,0,0,8,0,26,6,6,1,0,0,13,99,71,2.7,8.6,3.6
5/26/22,14,0,2,7,0,23,11,1,0,0,1,13,98,72,2.7,8.6,3.6
5/27/22,10,0,0,1,0,11,0,0,0,0,2,2,98,72,2.7,8.6,3.6
5/28/22,5,0,3,1,0,9,7,0,1,0,5,13,97,76,2.7,8.6,3.6
5/29/22,3,0,1,1,0,5,10,0,3,0,1,14,100,69,2.7,8.6,3.6
5/30/22,5,0,0,7,0,12,2,0,4,0,3,9,84,63,2.7,8.6,3.6
5/31/22,21,0,2,3,0,26,6,0,3,0,11,20,89,67,2.7,8.6,3.6
6/1/22,36,0,0,4,0,40,9,0,4,0,4,17,89,61,2.7,8.6,3.6
6/2/22,7,0,1,6,0,14,9,0,0,0,1,10,84,62,2.7,8.6,3.6
6/3/22,8,0,1,2,0,11,5,1,0,0,0,6,98,58,2.7,8.6,3.6
6/4/22,9,0,2,0,0,11,16,1,3,2,3,25,98,71,2.7,8.6,3.6
6/5/22,4,0,0,0,0,4,10,1,5,0,5,21,97,72,2.7,8.6,3.6
6/6/22,5,0,2,2,0,9,6,0,4,0,0,10,98,74,2.7,8.6,3.6
6/7/22,13,0,1,12,0,26,18,1,4,0,22,45,97,76,2.7,8.6,3.6
6/8/22,11,0,2,7,0,20,14,0,2,0,30,46,99,76,2.7,8.6,3.6
6/9/22,13,0,0,2,0,15,8,0,0,0,7,15,97,77,3.1,9.1,3.6
6/10/22,16,0,2,3,0,21,0,0,0,0,1,1,92,73,3.1,9.1,3.6
6/11/22,7,0,0,6,0,13,15,0,2,0,3,20,93,72,3.1,9.1,3.6
6/12/22,6,0,1,0,0,7,9,0,5,0,20,34,93,68,3.1,9.1,3.6
6/13/22,10,0,0,5,0,15,6,0,1,0,5,12,99,71,3.1,9.1,3.6
6/14/22,13,0,0,4,0,17,13,0,3,0,0,16,103,76,3.1,9.1,3.6
6/15/22,25,0,4,7,0,36,15,0,1,0,2,18,103,77,3.1,9.1,3.6
6/16/22,34,0,0,3,0,37,6,0,1,1,1,9,101,76,3.1,9.1,3.6
6/17/22,7,0,2,4,0,13,0,0,4,0,0,4,101,76,3.1,9.1,3.6
6/18/22,3,0,0,1,0,4,0,0,0,0,2,2,103,77,3.1,9.1,3.6
6/19/22,1,0,3,0,0,4,13,0,2,0,5,20,104,77,3.1,9.1,3.6
6/20/22,22,0,3,3,0,28,13,0,1,0,1,15,105,77,3.1,9.1,3.6
6/21/22,11,0,6,3,0,20,12,0,4,0,9,25,102,77,3.1,9.1,3.6
6/22/22,25,0,3,5,0,33,8,0,1,1,3,13,101,78,3.1,9.1,3.6
6/23/22,20,0,4,9,0,33,12,0,4,0,0,16,98,79,3.1,9.1,3.6
6/24/22,14,0,1,7,0,22,1,0,1,1,0,3,103,76,3.1,9.1,3.6
6/25/22,13,0,0,3,0,16,13,0,2,0,1,16,100,75,3.1,9.1,3.6
6/26/22,1,0,0,0,0,1,14,1,6,6,2,29,100,75,3.1,9.1,3.6
6/27/22,19,0,2,7,0,28,9,0,2,0,5,16,102,75,3.1,9.1,3.6
6/28/22,12,0,1,6,0,19,15,1,5,0,10,31,103,74,3.1,9.1,3.6
6/29/22,20,0,2,5,0,27,14,0,10,0,2,26,101,78,3.1,9.1,3.6
6/30/22,15,0,0,8,0,23,6,0,4,0,3,13,101,76,3.1,9.1,3.6
7/1/22,10,0,2,17,0,29,21,0,2,2,0,25,104,77,3.1,9.1,3.6
7/3/22,2,0,0,0,0,2,14,1,4,1,2,22,103,76,3.1,9.1,3.6
7/4/22,3,0,1,0,0,4,7,0,1,0,11,19,103,75,3.1,9.1,3.6
7/5/22,6,0,1,6,0,13,7,0,3,1,33,44,103,74,3.1,9.1,3.6
7/6/22,26,0,4,15,0,45,7,0,1,0,6,14,102,70,3.1,9.1,3.6
7/7/22,16,0,10,10,0,36,12,0,2,0,3,17,94,72,3.1,9.1,3.6
7/8/22,25,0,0,5,0,30,13,0,2,2,11,28,99,69,3.1,9.1,3.6
7/9/22,7,0,0,1,0,8,5,0,0,0,0,5,99,76,3.1,9.1,3.6
7/10/22,4,0,0,0,0,4,21,1,4,3,2,31,97,75,3,8.5,3.5
7/11/22,24,0,1,1,0,26,7,0,2,0,41,50,101,79,3,8.5,3.5
7/12/22,22,0,10,14,0,46,13,0,1,0,3,17,101,78,3,8.5,3.5
7/13/22,11,0,7,2,0,20,8,1,8,0,0,17,101,77,3,8.5,3.5
7/14/22,26,0,2,3,0,31,20,2,1,0,3,26,101,78,3,8.5,3.5
7/15/22,14,0,0,2,0,16,8,0,4,0,0,12,102,77,3,8.5,3.5
7/16/22,8,0,1,1,0,10,18,0,2,0,2,22,102,77,3,8.5,3.5
7/17/22,11,0,0,0,0,11,13,1,1,0,0,15,104,79,3,8.5,3.5
7/18/22,24,0,3,7,0,34,6,0,3,0,10,19,106,79,3,8.5,3.5
7/19/22,15,0,1,6,0,22,11,0,6,0,2,19,110,78,3,8.5,3.5
7/20/22,15,0,3,15,0,33,13,0,2,1,16,32,109,80,3,8.5,3.5
7/21/22,18,0,7,2,0,27,6,0,4,0,2,12,109,79,3,8.5,3.5
7/22/22,8,0,0,42,0,50,1,0,0,0,0,1,108,80,3,8.5,3.5
7/23/22,15,0,3,10,0,28,18,2,8,0,2,30,103,76,3,8.5,3.5
7/24/22,1,0,0,11,0,12,18,0,0,0,1,19,99,75,3,8.5,3.5
7/25/22,19,0,2,13,0,34,17,0,3,0,8,28,102,76,3,8.5,3.5
7/26/22,8,0,4,5,0,17,9,0,3,0,6,18,104,76,3,8.5,3.5
7/27/22,26,0,11,7,0,44,11,0,5,0,30,46,106,77,3,8.5,3.5
7/28/22,13,0,0,3,0,16,11,1,5,0,2,19,106,77,3,8.5,3.5
7/29/22,11,0,0,8,0,19,0,1,0,0,0,1,106,77,3,8.5,3.5
7/30/22,23,0,5,1,0,29,14,0,2,0,2,18,105,78,3,8.5,3.5
8/1/22,32,0,0,5,0,37,11,0,4,0,2,17,103,77,3,8.5,3.5
8/2/22,12,0,0,3,0,15,11,0,4,0,4,19,104,78,3,8.5,3.5
8/3/22,19,0,0,12,0,31,11,0,7,0,8,26,105,78,3,8.5,3.5
8/4/22,13,0,0,10,0,23,13,0,2,0,0,15,104,77,3,8.5,3.5
8/5/22,17,0,0,7,0,24,15,1,3,0,1,20,104,76,3,8.5,3.5
8/6/22,10,0,1,0,0,11,0,0,1,0,0,1,103,77,3,8.5,3.5
8/7/22,3,0,2,0,0,5,17,2,2,0,5,26,103,76,3,8.5,3.5
8/8/22,11,0,1,6,0,18,7,0,3,0,1,11,104,78,3,8.5,3.5
8/9/22,13,0,4,2,0,19,14,1,5,0,17,37,104,77,3,8.5,3.5
8/10/22,9,0,1,7,0,17,10,0,2,0,14,26,103,78,3,8.5,3.5
8/11/22,21,0,3,3,0,27,12,1,5,0,3,21,103,77,3,8.3,3.6
8/12/22,15,0,1,3,0,19,32,0,0,1,0,33,105,77,3,8.3,3.6
8/13/22,7,0,2,1,0,10,0,0,1,0,0,1,106,78,3,8.3,3.6
8/14/22,2,0,1,0,0,3,19,0,3,0,0,22,106,79,3,8.3,3.6
8/15/22,18,0,1,4,0,23,23,1,2,0,1,27,104,78,3,8.3,3.6
8/16/22,25,0,5,5,0,35,18,0,0,1,21,40,99,79,3,8.3,3.6
8/17/22,18,0,5,3,0,26,11,1,6,0,5,23,102,78,3,8.3,3.6
8/18/22,15,0,2,5,0,22,12,0,2,0,1,15,102,78,3,8.3,3.6
8/19/22,26,0,1,6,0,33,12,0,4,0,1,17,102,76,3,8.3,3.6
8/20/22,3,0,0,1,0,4,0,0,1,0,3,4,104,78,3,8.3,3.6
8/21/22,5,0,0,0,0,5,13,0,4,0,1,18,102,77,3,8.3,3.6
8/22/22,18,0,0,3,0,21,8,2,4,0,5,19,104,76,3,8.3,3.6
8/23/22,16,0,1,10,0,27,9,0,6,0,1,16,102,78,3,8.3,3.6
8/24/22,13,0,3,7,0,23,14,2,4,0,17,37,94,78,3,8.3,3.6
8/25/22,11,0,4,5,0,20,10,0,5,0,1,16,102,76,3,8.3,3.6
8/26/22,14,0,1,13,0,28,0,0,1,0,0,1,101,77,3,8.3,3.6
8/27/22,9,0,1,2,0,12,22,0,2,0,0,24,103,78,3,8.3,3.6
8/28/22,2,0,1,0,0,3,22,0,3,0,2,27,103,73,3,8.3,3.6
8/29/22,28,0,3,5,0,36,14,0,4,0,7,25,95,73,3,8.3,3.6
8/30/22,12,0,1,10,0,23,21,1,0,1,2,25,101,77,3,8.3,3.6
8/31/22,8,0,0,11,0,19,10,0,4,0,19,33,95,78,3,8.3,3.6
9/1/22,33,0,1,6,0,40,17,0,2,0,1,20,98,73,3,8.3,3.6
9/2/22,10,0,1,6,0,17,33,0,4,0,1,38,92,73,3,8.3,3.6
9/3/22,12,0,0,0,0,12,13,0,4,0,0,17,94,74,3,8.3,3.6
9/4/22,4,0,1,0,0,5,10,0,5,0,6,21,97,74,3,8.3,3.6
9/5/22,7,0,0,0,0,7,12,0,2,0,8,22,98,75,3,8.3,3.6
9/6/22,20,0,2,4,0,26,13,0,3,0,11,27,99,76,3,8.3,3.6
9/7/22,20,0,1,8,0,29,5,0,0,0,0,5,98,77,3,8.3,3.6
9/8/22,15,0,4,7,0,26,7,0,2,0,1,10,99,78,3,8.3,3.6
9/9/22,14,0,1,1,0,16,20,0,2,0,2,24,87,75,3,8.3,3.6
9/10/22,12,0,1,1,0,14,14,0,2,0,0,16,92,71,3,8.3,3.6
9/11/22,2,0,1,0,0,3,11,0,1,0,3,15,94,73,2.9,8.2,3.5
9/12/22,17,0,0,4,0,21,14,0,1,1,2,18,95,74,2.9,8.2,3.5
9/13/22,5,0,0,7,0,12,8,0,5,0,16,29,90,74,2.9,8.2,3.5
9/14/22,3,0,0,2,0,5,7,0,0,0,2,9,92,71,2.9,8.2,3.5
9/15/22,0,0,0,1,0,1,2,0,1,0,0,3,94,67,2.9,8.2,3.5
9/16/22,2,0,0,5,0,7,11,0,3,0,1,15,96,71,2.9,8.2,3.5
9/17/22,6,0,0,1,0,7,7,0,1,0,0,8,95,72,2.9,8.2,3.5
9/18/22,3,0,1,0,0,4,11,0,1,0,3,15,95,71,2.9,8.2,3.5
9/19/22,5,0,1,3,0,9,8,0,8,1,1,18,94,71,2.9,8.2,3.5
9/20/22,5,0,2,3,0,10,8,0,4,1,2,15,95,74,2.9,8.2,3.5
9/21/22,5,0,0,9,0,14,6,0,1,0,3,10,92,72,2.9,8.2,3.5
9/22/22,11,0,0,7,0,18,12,0,3,0,3,18,92,69,2.9,8.2,3.5
9/23/22,8,0,1,8,0,17,11,0,0,1,30,42,94,72,2.9,8.2,3.5
9/24/22,3,0,0,4,0,7,10,1,4,0,1,16,93,72,2.9,8.2,3.5
9/25/22,4,0,0,2,0,6,1,0,5,0,1,7,92,66,2.9,8.2,3.5
9/26/22,11,0,1,2,0,14,4,0,3,0,7,14,96,75,2.9,8.2,3.5
9/27/22,10,0,0,4,0,14,8,0,4,0,3,15,98,77,2.9,8.2,3.5
9/28/22,7,0,0,6,0,13,3,0,1,0,2,6,97,75,2.9,8.2,3.5
9/29/22,13,0,0,3,0,16,2,1,1,0,4,8,98,76,2.9,8.2,3.5
9/30/22,9,0,1,3,0,13,9,0,2,0,0,11,98,76,2.9,8.2,3.5
10/1/22,6,0,0,2,0,8,10,0,0,0,1,11,98,73,2.9,8.2,3.5
10/2/22,7,0,4,1,0,12,7,0,5,0,5,17,99,70,2.9,8.2,3.5
10/3/22,10,0,1,0,0,11,4,0,0,0,6,10,98,72,2.9,8.2,3.5
10/4/22,4,0,7,3,0,14,9,1,0,0,15,25,95,71,2.9,8.2,3.5
10/5/22,7,0,0,3,0,10,7,0,1,0,0,8,97,73,2.9,8.2,3.5
10/6/22,16,0,0,3,0,19,1,0,5,0,0,6,93,68,2.9,8.2,3.5
10/7/22,8,0,3,4,0,15,10,0,2,0,6,18,92,61,2.9,8.2,3.5
10/8/22,11,0,1,2,0,14,11,0,5,0,6,22,92,64,2.9,8.2,3.5
10/9/22,2,0,1,1,0,4,4,0,10,0,18,32,94,61,2.9,8.2,3.5
10/10/22,29,0,0,3,0,32,3,0,1,0,2,6,89,63,2.9,8.2,3.5
10/11/22,7,0,2,10,0,19,10,0,5,1,6,22,89,56,2.9,7.7,3.6
10/12/22,5,0,1,4,0,10,3,0,4,2,2,11,86,55,2.9,7.7,3.6
10/13/22,20,0,2,3,0,25,2,0,3,0,2,7,90,58,2.9,7.7,3.6
10/14/22,8,0,1,2,0,11,8,0,1,0,7,16,92,61,2.9,7.7,3.6
10/15/22,11,0,2,0,0,13,10,1,3,0,1,15,90,59,2.9,7.7,3.6
10/16/22,3,0,0,0,0,3,7,0,4,0,0,11,92,63,2.9,7.7,3.6
10/17/22,13,0,1,4,0,18,2,0,2,0,2,6,88,67,2.9,7.7,3.6
10/18/22,18,0,0,9,0,27,6,1,2,0,35,44,90,62,2.9,7.7,3.6
10/19/22,14,0,1,4,0,19,9,0,3,0,3,15,90,65,2.9,7.7,3.6
10/20/22,10,0,1,3,0,14,6,0,2,0,8,16,90,64,2.9,7.7,3.6
10/21/22,6,0,6,5,0,17,13,0,1,0,0,14,90,65,2.9,7.7,3.6
10/22/22,13,0,2,10,0,25,4,0,4,0,3,11,98,72,2.9,7.7,3.6
10/23/22,2,0,1,1,0,4,8,0,2,0,1,11,90,71,2.9,7.7,3.6
10/24/22,6,0,0,5,0,11,4,1,3,0,1,9,91,64,2.9,7.7,3.6
10/25/22,14,0,3,11,0,28,0,0,0,0,1,1,95,73,2.9,7.7,3.6
10/26/22,23,0,3,7,0,33,11,0,2,0,2,15,93,66,2.9,7.7,3.6
10/27/22,9,0,1,10,0,20,3,0,0,0,2,5,76,60,2.9,7.7,3.6
10/28/22,25,0,1,5,0,31,10,0,2,0,2,14,70,49,2.9,7.7,3.6
10/29/22,7,0,1,0,0,8,11,0,2,0,4,17,76,42,2.9,7.7,3.6
10/30/22,10,0,1,0,0,11,8,0,1,0,8,17,87,50,2.9,7.7,3.6
10/31/22,9,0,0,1,0,10,10,0,6,0,3,19,88,56,2.9,7.7,3.6
11/1/22,6,0,1,12,0,19,8,0,4,0,3,15,89,64,2.9,7.7,3.6
11/2/22,6,0,10,5,0,21,7,0,2,0,4,13,89,68,2.9,7.7,3.6
11/3/22,7,0,2,7,0,16,5,0,1,0,1,7,86,61,2.9,7.7,3.6
11/4/22,11,0,2,3,0,16,8,0,0,0,6,14,77,50,2.9,7.7,3.6
11/5/22,9,0,0,0,0,9,8,0,6,0,1,15,76,46,2.9,7.7,3.6
11/6/22,4,0,0,1,0,5,11,0,1,0,1,13,82,51,2.9,7.7,3.6
11/7/22,19,0,0,2,0,21,14,0,2,0,3,19,66,58,2.9,7.7,3.6
11/8/22,9,0,1,5,0,15,9,0,0,0,5,14,72,56,2.9,7.7,3.6
11/9/22,12,0,1,4,0,17,5,0,0,0,0,5,78,52,2.9,7.7,3.6
11/10/22,11,0,2,10,0,23,8,0,4,0,5,17,79,54,2.9,7.7,3.6
11/11/22,1,0,2,0,0,3,13,1,0,1,2,17,70,56,2.9,7.1,3.6
11/12/22,8,0,0,1,0,9,7,0,3,0,3,13,78,60,2.9,7.1,3.6
11/13/22,3,0,0,0,0,3,8,0,2,0,1,11,84,70,2.9,7.1,3.6
11/14/22,10,0,0,10,0,20,7,1,2,0,3,13,86,62,2.9,7.1,3.6
11/15/22,6,0,1,5,0,12,7,0,4,0,1,12,72,50,2.9,7.1,3.6
11/16/22,17,0,1,0,0,18,6,0,2,0,2,10,84,53,2.9,7.1,3.6
11/17/22,13,0,1,7,0,21,12,0,1,0,3,16,84,74,2.9,7.1,3.6
11/18/22,11,0,1,7,0,19,12,2,1,0,1,16,78,66,2.9,7.1,3.6
11/19/22,3,0,0,0,0,3,7,0,2,1,2,12,82,69,2.9,7.1,3.6
11/20/22,5,0,0,0,0,5,1,0,0,1,0,2,82,67,2.9,7.1,3.6
11/21/22,20,0,1,1,0,22,6,0,1,0,1,8,79,44,2.9,7.1,3.6
11/22/22,9,0,0,11,0,20,6,0,12,2,4,24,58,38,2.9,7.1,3.6
11/23/22,19,0,0,4,0,23,5,0,2,0,0,7,59,35,2.9,7.1,3.6
11/24/22,4,0,0,0,0,4,9,0,5,0,2,16,54,48,2.9,7.1,3.6
11/25/22,8,0,2,0,0,10,16,1,3,0,4,24,52,38,2.9,7.1,3.6
11/26/22,10,0,2,1,0,13,5,0,2,0,2,9,57,41,2.9,7.1,3.6
11/27/22,3,0,0,1,0,4,9,0,6,0,3,18,59,42,2.9,7.1,3.6
11/28/22,12,0,0,8,0,20,11,1,2,0,3,17,56,48,2.9,7.1,3.6
11/29/22,18,0,0,8,0,26,15,0,2,0,2,19,48,37,2.9,7.1,3.6
11/30/22,20,0,2,2,0,24,11,0,3,0,0,14,47,38,2.9,7.1,3.6
12/1/22,8,0,5,4,0,17,12,0,2,0,2,16,46,40,2.9,7.1,3.6
12/2/22,7,0,0,9,0,16,17,1,0,0,4,22,55,45,2.9,7.1,3.6
12/3/22,4,0,1,3,0,8,13,1,1,0,2,17,64,52,2.9,7.1,3.6
12/4/22,3,0,1,0,0,4,12,0,4,0,9,25,68,60,2.9,7.1,3.6
12/5/22,6,0,2,1,0,9,4,0,5,0,1,10,62,56,2.9,7.1,3.6
12/6/22,28,0,4,2,0,34,0,0,0,0,1,1,61,45,2.9,7.1,3.6
12/7/22,9,0,0,1,0,10,0,0,0,0,1,1,73,47,2.9,7.1,3.6
12/8/22,22,0,5,3,0,30,15,0,1,0,2,18,77,41,2.9,7.1,3.6
12/9/22,8,0,0,2,0,10,19,1,3,0,0,23,84,65,2.9,7.1,3.6
12/10/22,7,0,0,1,0,8,15,0,2,0,2,19,66,41,2.9,7.1,3.6
12/11/22,5,0,3,0,0,8,14,0,1,0,3,18,53,37,2.8,6.5,3.5
12/12/22,4,0,0,3,0,7,12,1,1,0,3,17,68,51,2.8,6.5,3.5
12/13/22,9,0,3,11,0,23,0,0,2,0,0,2,66,54,2.8,6.5,3.5
12/14/22,8,0,1,5,0,14,1,0,0,0,0,1,59,53,2.8,6.5,3.5
12/15/22,8,0,1,2,0,11,17,0,3,0,3,23,78,56,2.8,6.5,3.5
12/16/22,12,0,3,3,0,18,12,0,2,0,3,17,80,64,2.8,6.5,3.5
12/17/22,4,0,0,1,0,5,15,0,3,0,4,22,82,69,2.8,6.5,3.5
12/18/22,2,0,1,0,0,3,11,0,5,0,1,17,82,69,2.8,6.5,3.5
12/19/22,3,0,0,6,0,9,14,0,0,1,3,18,80,65,2.8,6.5,3.5
12/20/22,18,0,1,1,0,20,5,0,3,0,2,10,77,66,2.8,6.5,3.5
12/21/22,24,0,0,4,0,28,8,0,5,0,6,19,67,60,2.8,6.5,3.5
12/22/22,23,0,4,11,0,38,14,0,1,0,2,17,71,58,2.8,6.5,3.5
12/23/22,12,0,0,0,0,12,11,0,2,0,6,19,78,62,2.8,6.5,3.5
12/24/22,5,0,0,0,0,5,5,0,1,0,2,8,68,43,2.8,6.5,3.5
12/25/22,1,0,0,1,0,2,10,0,7,0,5,22,65,36,2.8,6.5,3.5
12/26/22,4,0,1,1,0,6,9,0,1,1,2,13,55,41,2.8,6.5,3.5
12/27/22,32,0,1,3,0,36,20,0,0,0,4,24,59,38,2.8,6.5,3.5
12/28/22,10,0,0,5,0,15,0,0,0,0,1,1,55,31,2.8,6.5,3.5
12/29/22,9,0,0,2,0,11,17,0,2,0,4,23,50,43,2.8,6.5,3.5
12/30/22,9,0,0,3,0,12,14,1,2,0,2,19,51,44,2.8,6.5,3.5
12/31/22,11,0,1,1,0,13,18,0,11,0,17,46,49,39,2.8,6.5,3.5
1/1/23,0,0,2,0,0,2,8,0,1,0,11,20,59,17,2.8,6.5,3.5
1/2/23,8,0,1,1,0,10,16,0,1,0,0,17,32,15,2.8,6.5,3.5
1/3/23,19,0,1,6,0,26,5,0,2,0,0,7,41,18,2.8,6.5,3.5
1/4/23,9,0,2,8,0,19,7,0,0,0,3,10,54,24,2.8,6.5,3.5
1/5/23,12,0,0,9,0,21,9,1,2,0,3,15,65,30,2.8,6.5,3.5
1/6/23,19,0,1,4,0,24,4,0,0,0,8,12,59,32,2.8,6.5,3.5
1/7/23,5,0,0,2,0,7,6,0,1,0,1,8,77,42,2.8,6.5,3.5
1/8/23,5,0,0,1,0,6,7,1,3,0,5,16,77,59,2.8,6.5,3.5
1/9/23,12,0,0,10,0,22,9,0,3,0,4,16,68,50,2.8,6.5,3.5
1/10/23,14,0,1,3,0,18,8,0,1,0,0,9,78,42,2.8,6.5,3.5
1/11/23,26,0,2,5,0,33,10,0,0,1,5,16,79,50,3.3,6.4,3.4
1/12/23,19,0,0,3,0,22,3,0,2,0,0,5,83,69,3.3,6.4,3.4
1/13/23,20,0,0,8,0,28,13,0,4,0,4,21,74,54,3.3,6.4,3.4
1/14/23,7,0,1,0,0,8,12,0,4,0,0,16,74,42,3.3,6.4,3.4
1/15/23,2,0,0,0,0,2,7,0,4,0,2,13,69,41,3.3,6.4,3.4
1/16/23,2,0,0,1,0,3,15,0,1,0,9,25,79,44,3.3,6.4,3.4
1/17/23,14,0,1,6,0,21,16,0,8,0,2,26,77,59,3.3,6.4,3.4
1/18/23,23,0,3,7,0,33,10,1,0,0,2,13,69,47,3.3,6.4,3.4
1/19/23,12,0,0,1,0,13,8,0,2,0,2,12,74,43,3.3,6.4,3.4
1/20/23,12,0,1,5,0,18,9,0,0,1,10,20,84,57,3.3,6.4,3.4
1/21/23,7,0,0,1,0,8,30,0,1,0,0,31,78,56,3.3,6.4,3.4
1/22/23,6,0,0,0,0,6,6,0,0,0,6,12,69,50,3.3,6.4,3.4
1/23/23,12,0,1,4,0,17,12,0,0,0,9,21,64,41,3.3,6.4,3.4
1/24/23,13,0,0,3,0,16,15,1,1,0,1,18,66,34,3.3,6.4,3.4
1/25/23,10,0,2,2,0,14,9,1,2,0,1,13,74,46,3.3,6.4,3.4
1/26/23,8,0,1,5,0,14,14,0,6,0,8,28,78,58,3.3,6.4,3.4
1/27/23,11,0,1,5,0,17,13,0,3,0,0,16,82,50,3.3,6.4,3.4
1/28/23,10,0,0,1,0,11,8,0,1,0,1,10,77,57,3.3,6.4,3.4
1/29/23,5,0,1,2,0,8,13,0,0,0,2,15,69,46,3.3,6.4,3.4
1/30/23,13,0,0,10,0,23,0,0,1,0,0,1,58,50,3.3,6.4,3.4
1/31/23,5,0,6,1,0,12,12,1,2,0,15,30,65,46,3.3,6.4,3.4
2/1/23,1,0,1,0,0,2,10,0,0,0,1,11,62,42,3.3,6.4,3.4
2/2/23,14,0,0,0,0,14,3,1,1,1,1,7,60,33,3.3,6.4,3.4
2/3/23,13,0,3,4,0,20,7,1,2,0,5,15,55,42,3.3,6.4,3.4
2/4/23,8,0,0,1,0,9,10,0,2,0,1,13,56,39,3.3,6.4,3.4
2/5/23,9,0,1,0,0,10,9,1,4,0,0,14,58,35,3.3,6.4,3.4
2/6/23,21,0,0,9,0,30,18,0,1,0,11,30,56,33,3.3,6.4,3.4
2/7/23,18,0,0,3,0,21,11,0,1,0,0,12,60,48,3.3,6.4,3.4
2/8/23,19,0,0,6,0,25,10,0,2,1,3,16,75,41,3.3,6.4,3.4
2/9/23,16,0,0,6,0,22,12,0,2,0,0,14,41,30,3.3,6.4,3.4
2/10/23,9,0,2,2,0,13,8,0,4,0,7,19,32,29,3.3,6.4,3.4
2/11/23,14,0,0,2,0,16,23,1,1,0,2,27,32,29,3.5,6,3.6
2/12/23,6,0,0,0,0,6,8,0,1,0,5,14,40,32,3.5,6,3.6
2/13/23,4,0,0,8,0,12,9,1,0,0,2,12,50,32,3.5,6,3.6
2/14/23,7,0,3,2,0,12,11,0,5,0,1,17,63,35,3.5,6,3.6
2/15/23,13,0,0,10,0,23,13,0,4,0,2,19,75,41,3.5,6,3.6
2/16/23,6,0,0,5,0,11,10,0,4,0,2,16,76,55,3.5,6,3.6
2/17/23,7,0,3,6,0,16,12,0,6,0,7,25,70,50,3.5,6,3.6
2/18/23,27,0,0,1,0,28,13,0,0,0,0,13,60,40,3.5,6,3.6
2/19/23,14,0,2,0,0,16,15,0,2,0,1,18,75,40,3.5,6,3.6
2/20/23,13,0,1,3,0,17,14,0,2,0,2,18,56,38,3.5,6,3.6
2/21/23,15,0,0,7,0,22,14,0,5,0,1,20,60,35,3.5,6,3.6
2/22/23,7,0,2,4,0,13,19,1,2,0,8,30,66,32,3.5,6,3.6
2/23/23,7,0,1,1,0,9,12,0,3,0,3,18,71,42,3.5,6,3.6
2/24/23,8,0,5,3,0,16,13,0,3,2,6,24,80,53,3.5,6,3.6
2/25/23,8,0,1,0,0,9,11,0,2,2,3,18,81,48,3.5,6,3.6
2/26/23,3,0,0,0,0,3,5,0,2,0,2,9,71,40,3.5,6,3.6
2/27/23,24,0,2,6,0,32,11,0,3,0,2,16,54,33,3.5,6,3.6
2/28/23,8,0,1,5,0,14,7,0,4,0,1,12,58,31,3.5,6,3.6
3/1/23,6,0,0,5,0,11,7,0,2,1,5,15,77,46,3.5,6,3.6
3/2/23,21,0,2,2,0,25,9,0,6,0,3,18,84,56,3.5,6,3.6
3/3/23,9,0,0,4,0,13,1,0,3,0,3,7,84,60,3.5,6,3.6
3/4/23,9,0,1,2,0,12,13,0,4,0,4,21,91,69,3.5,6,3.6
3/5/23,5,0,0,1,0,6,6,0,1,0,7,14,79,57,3.5,6,3.6
3/6/23,10,0,1,4,0,15,17,0,1,0,2,20,57,50,3.5,6,3.6
3/7/23,17,0,10,3,0,30,11,0,0,0,3,14,65,45,3.5,6,3.6
3/8/23,16,0,0,14,0,30,5,1,10,0,4,20,81,53,3.5,6,3.6
3/9/23,3,0,1,12,0,16,8,0,1,0,9,18,83,56,3.5,6,3.6
3/10/23,9,0,1,12,0,22,7,0,3,0,2,12,84,54,3.5,6,3.6
3/11/23,6,0,1,3,0,10,16,0,1,1,4,22,85,70,3.3,5,3.5
3/12/23,5,0,0,1,0,6,14,0,1,0,1,16,82,54,3.3,5,3.5
3/13/23,23,0,5,5,0,33,11,0,1,0,1,13,74,50,3.3,5,3.5
3/14/23,8,0,2,9,0,19,10,0,0,0,1,11,82,45,3.3,5,3.5
3/15/23,15,0,3,1,0,19,10,0,1,0,2,13,80,53,3.3,5,3.5
3/16/23,17,0,3,5,0,25,5,1,3,0,7,16,81,59,3.3,5,3.5
3/17/23,12,0,3,4,0,19,10,0,1,0,5,16,82,66,3.3,5,3.5
3/18/23,8,0,1,0,0,9,11,0,5,3,4,23,82,62,3.3,5,3.5
3/19/23,0,0,0,1,0,1,3,1,1,0,6,11,86,60,3.3,5,3.5
3/20/23,12,0,0,4,0,16,14,1,2,0,4,21,76,56,3.3,5,3.5
3/21/23,19,0,2,8,0,29,4,0,0,1,3,8,90,62,3.3,5,3.5
3/22/23,24,0,0,3,0,27,5,3,4,0,8,20,76,57,3.3,5,3.5
3/23/23,11,0,4,5,0,20,4,0,7,0,4,15,69,50,3.3,5,3.5
3/24/23,10,0,2,7,0,19,12,0,8,0,5,25,69,49,3.3,5,3.5
3/25/23,8,0,0,0,0,8,14,0,2,0,6,22,76,49,3.3,5,3.5
3/26/23,13,0,1,0,0,14,9,1,4,0,0,14,81,53,3.3,5,3.5
3/27/23,6,0,2,3,0,11,13,0,2,0,1,16,59,41,3.3,5,3.5
3/28/23,13,0,0,4,0,17,9,0,3,1,2,15,54,45,3.3,5,3.5
3/29/23,6,0,0,8,0,14,3,0,0,0,0,3,61,39,3.3,5,3.5
3/30/23,7,0,1,6,0,14,3,0,3,1,2,9,57,40,3.3,5,3.5
3/31/23,15,0,0,9,0,24,7,0,8,0,3,18,69,52,3.3,5,3.5
4/1/23,3,0,0,2,0,5,18,0,1,0,1,20,80,68,3.3,5,3.5
4/2/23,5,0,0,0,0,5,8,0,1,1,1,11,84,71,3.3,5,3.5
4/3/23,7,0,2,6,0,15,11,0,1,0,2,14,87,58,3.3,5,3.5
4/4/23,13,0,2,9,0,24,8,0,2,2,3,15,83,51,3.3,5,3.5
4/5/23,16,0,1,2,0,19,9,0,1,0,5,15,82,52,3.3,5,3.5
4/6/23,9,0,0,9,0,18,7,0,2,0,4,13,80,58,3.3,5,3.5
4/7/23,9,0,0,2,0,11,4,0,3,1,5,13,70,58,3.3,5,3.5
4/8/23,7,0,0,6,0,13,9,1,4,0,4,18,74,55,3.3,5,3.5
4/9/23,14,0,0,0,0,14,4,1,5,0,2,12,75,60,3.3,5,3.5
4/10/23,19,0,0,3,0,22,14,0,6,2,2,24,90,61,3.3,5,3.5
4/11/23,14,0,0,3,0,17,8,0,2,1,0,11,84,52,2.9,4.9,3.4
4/12/23,17,0,1,6,0,24,5,0,2,0,1,8,86,63,2.9,4.9,3.4
4/13/23,15,0,1,3,0,19,5,1,3,1,2,12,93,71,2.9,4.9,3.4
4/14/23,10,0,0,6,0,16,8,0,1,0,6,15,91,73,2.9,4.9,3.4
4/15/23,10,0,2,0,0,12,9,0,1,0,3,13,77,59,2.9,4.9,3.4
4/16/23,5,0,4,1,0,10,11,0,1,0,8,20,61,47,2.9,4.9,3.4
4/17/23,6,0,3,2,0,11,18,0,2,0,8,28,54,50,2.9,4.9,3.4
4/18/23,13,0,0,4,0,17,7,0,5,0,2,14,62,53,2.9,4.9,3.4
4/19/23,8,0,2,2,0,12,5,1,4,0,1,11,74,55,2.9,4.9,3.4
4/20/23,13,0,3,4,0,20,9,0,7,0,7,23,74,55,2.9,4.9,3.4
4/21/23,11,0,0,5,0,16,11,0,6,0,14,31,77,53,2.9,4.9,3.4
4/22/23,16,0,0,0,0,16,10,0,2,0,1,13,79,51,2.9,4.9,3.4
4/23/23,5,0,3,0,0,8,14,1,1,0,1,17,81,55,2.9,4.9,3.4
4/24/23,14,0,6,6,0,26,10,0,2,0,5,17,81,61,2.9,4.9,3.4
4/25/23,18,0,0,5,0,23,7,0,3,0,9,19,94,62,2.9,4.9,3.4
4/26/23,14,0,0,12,0,26,10,2,1,0,4,17,76,56,2.9,4.9,3.4
4/27/23,13,0,4,7,0,24,3,0,2,0,18,23,79,49,2.9,4.9,3.4
4/28/23,13,0,4,2,0,19,1,0,2,0,1,4,80,62,2.9,4.9,3.4
4/29/23,8,0,0,3,0,11,4,0,1,0,3,8,81,70,2.9,4.9,3.4
4/30/23,3,0,3,1,0,7,6,0,3,0,6,15,88,65,2.9,4.9,3.4
5/1/23,10,0,1,8,0,19,16,0,3,1,0,20,82,63,2.9,4.9,3.4
5/2/23,7,0,1,6,0,14,15,1,3,0,2,21,81,57,2.9,4.9,3.4
5/3/23,6,0,19,7,0,32,5,0,5,0,2,12,68,52,2.9,4.9,3.4
5/4/23,10,0,0,5,0,15,6,0,0,0,2,8,71,54,2.9,4.9,3.4
5/5/23,15,0,7,10,0,32,10,0,2,0,5,17,75,62,2.9,4.9,3.4
5/6/23,8,0,2,0,0,10,6,2,0,0,3,11,86,64,2.9,4.9,3.4
5/7/23,4,0,1,0,0,5,8,0,4,0,3,15,82,61,2.9,4.9,3.4
5/8/23,13,0,0,10,0,23,0,0,0,0,2,2,86,57,2.9,4.9,3.4
5/9/23,9,0,2,4,0,15,15,0,3,0,11,29,77,54,2.9,4.9,3.4
5/10/23,18,0,2,4,0,24,6,0,2,0,3,11,91,52,2.9,4.9,3.4
5/11/23,7,0,1,3,0,11,12,0,3,0,5,20,84,58,3.3,4,3.7
5/12/23,10,0,1,8,0,19,13,0,2,1,6,22,82,68,3.3,4,3.7
5/13/23,6,0,1,0,0,7,6,0,3,0,1,10,86,64,3.3,4,3.7
5/14/23,10,0,0,0,0,10,4,0,3,0,3,10,85,68,3.3,4,3.7
5/15/23,18,0,1,5,0,24,14,0,7,0,12,33,94,66,3.3,4,3.7
5/16/23,12,0,3,8,0,23,11,0,1,0,2,14,91,67,3.3,4,3.7
5/17/23,19,0,1,3,0,23,9,0,5,1,7,22,88,74,3.3,4,3.7
5/18/23,16,0,1,5,0,22,10,0,3,0,2,15,93,72,3.3,4,3.7
5/19/23,4,0,4,1,0,9,6,0,0,0,4,10,76,69,3.3,4,3.7
5/20/23,2,0,1,0,0,3,5,0,1,1,15,22,82,67,3.3,4,3.7
5/21/23,6,0,0,0,0,6,7,1,1,0,1,10,92,72,3.3,4,3.7
5/22/23,13,0,1,10,0,24,10,0,3,0,11,24,88,75,3.3,4,3.7
5/23/23,12,0,2,4,0,18,9,0,3,0,3,15,78,64,3.3,4,3.7
5/24/23,10,0,4,4,0,18,9,1,4,0,7,21,86,65,3.3,4,3.7
5/25/23,12,0,1,5,0,18,2,0,3,0,0,5,86,67,3.3,4,3.7
5/26/23,7,0,0,9,0,16,7,0,2,1,5,15,85,67,3.3,4,3.7
5/27/23,8,0,2,0,0,10,2,0,4,0,0,6,90,65,3.3,4,3.7
5/28/23,4,0,0,0,0,4,5,0,3,0,0,8,91,65,3.3,4,3.7
5/29/23,7,0,3,0,0,10,0,0,0,0,1,1,92,68,3.3,4,3.7
5/30/23,11,0,2,4,0,17,10,0,1,0,0,11,84,68,3.3,4,3.7
5/31/23,11,0,1,5,0,17,10,2,1,0,8,21,74,65,3.3,4,3.7
6/1/23,16,0,0,5,0,21,3,0,3,0,20,26,87,63,3.3,4,3.7
6/2/23,14,0,1,5,0,20,8,0,1,0,0,9,92,67,3.3,4,3.7
6/3/23,12,0,3,1,0,16,8,0,1,0,5,14,86,65,3.3,4,3.7
6/4/23,6,0,0,0,0,6,7,0,0,0,3,10,85,67,3.3,4,3.7
6/5/23,17,0,2,14,0,33,10,1,2,0,5,18,89,65,3.3,4,3.7
6/6/23,11,0,0,3,0,14,8,0,4,0,2,14,87,67,3.3,4,3.7
6/7/23,14,0,1,1,0,16,5,0,3,0,5,13,86,71,3.3,4,3.7
6/8/23,5,0,1,3,0,9,11,0,5,0,1,17,88,70,3.3,4,3.7
6/9/23,20,0,2,4,0,26,11,0,1,0,3,15,89,67,3.3,4,3.7
6/10/23,3,0,3,1,0,7,3,0,0,0,1,4,91,69,3.3,4,3.7
6/11/23,4,0,0,0,0,4,3,0,1,0,0,4,91,72,3.5,3,3.6
6/12/23,12,0,0,7,0,19,8,0,1,0,4,13,91,71,3.5,3,3.6
6/13/23,10,0,3,7,0,20,0,1,1,0,0,2,93,68,3.5,3,3.6
6/14/23,11,0,0,2,0,13,13,0,0,0,4,17,83,67,3.5,3,3.6
6/15/23,5,0,2,1,0,8,5,0,7,0,1,13,88,67,3.5,3,3.6
6/16/23,11,0,0,5,0,16,7,0,6,1,0,14,89,67,3.5,3,3.6
6/17/23,11,0,0,1,0,12,9,0,1,1,0,11,91,70,3.5,3,3.6
6/18/23,8,0,0,0,0,8,5,1,5,0,0,11,89,71,3.5,3,3.6
6/19/23,11,0,0,0,0,11,11,0,1,0,8,20,100,71,3.5,3,3.6
6/20/23,9,0,2,3,0,14,14,0,1,0,0,15,98,67,3.5,3,3.6
6/21/23,10,0,3,6,0,19,4,0,4,0,4,12,100,74,3.5,3,3.6
6/22/23,21,0,0,3,0,24,2,0,0,0,2,4,98,77,3.5,3,3.6
6/23/23,8,0,1,4,0,13,10,0,0,0,1,11,94,78,3.5,3,3.6
6/24/23,9,0,0,0,0,9,8,0,1,0,1,10,96,80,3.5,3,3.6
6/25/23,7,0,1,1,0,9,8,0,2,0,6,16,101,82,3.5,3,3.6
6/26/23,12,0,9,1,0,22,6,0,0,0,3,9,103,73,3.5,3,3.6
6/27/23,7,0,0,4,0,11,6,2,1,0,0,9,97,78,3.5,3,3.6
6/28/23,5,0,2,0,0,7,12,1,1,0,4,18,106,80,3.5,3,3.6
6/29/23,4,0,3,3,0,10,11,0,2,0,1,14,104,80,3.5,3,3.6
6/30/23,6,0,2,7,0,15,10,0,1,0,1,12,106,80,3.5,3,3.6
7/1/23,9,0,1,2,0,12,8,0,1,1,3,13,103,73,3.5,3,3.6
7/2/23,2,0,0,0,0,2,3,0,0,0,3,6,94,75,3.5,3,3.6
7/3/23,13,0,1,2,0,16,9,1,2,0,6,18,99,78,3.5,3,3.6
7/4/23,6,0,0,0,0,6,7,0,1,1,0,9,103,79,3.5,3,3.6
7/5/23,8,0,6,4,0,18,4,1,4,0,2,11,103,80,3.5,3,3.6
7/6/23,5,0,1,3,0,9,9,0,0,0,5,14,105,78,3.5,3,3.6
7/7/23,10,0,2,5,0,17,7,1,3,0,2,13,105,77,3.5,3,3.6
7/8/23,5,0,0,2,0,7,4,0,1,0,1,6,103,76,3.5,3,3.6
7/9/23,8,0,0,1,0,9,3,0,0,0,1,4,101,79,3.5,3,3.6
7/10/23,10,0,2,1,0,13,10,0,3,0,5,18,102,77,3.5,3,3.6
7/11/23,14,0,0,6,0,20,13,1,6,0,3,23,102,78,3.6,3.2,3.5
7/12/23,4,0,1,7,0,12,6,2,3,0,1,12,98,79,3.6,3.2,3.5
7/13/23,6,0,1,1,0,8,6,0,2,0,0,8,99,78,3.6,3.2,3.5
7/14/23,7,0,0,9,0,16,7,0,3,0,1,11,97,78,3.6,3.2,3.5
7/15/23,4,0,0,1,0,5,10,0,0,0,2,12,99,79,3.6,3.2,3.5
7/16/23,1,0,4,0,0,5,7,0,5,1,4,17,92,78,3.6,3.2,3.5
7/17/23,3,0,0,2,0,5,15,0,3,0,3,21,95,75,3.6,3.2,3.5
7/18/23,4,0,0,3,0,7,6,0,0,1,7,14,102,77,3.6,3.2,3.5
7/19/23,9,0,1,4,0,14,4,0,4,0,2,10,104,78,3.6,3.2,3.5
7/20/23,5,0,0,7,0,12,11,1,1,0,11,24,105,79,3.6,3.2,3.5
7/21/23,8,0,0,3,0,11,9,0,2,1,4,16,105,79,3.6,3.2,3.5
7/22/23,7,0,1,2,0,10,4,0,3,0,4,11,108,80,3.6,3.2,3.5
7/23/23,6,0,1,3,0,10,6,0,1,0,3,10,107,80,3.6,3.2,3.5
7/24/23,10,0,5,5,0,20,9,0,3,0,6,18,107,80,3.6,3.2,3.5
7/25/23,11,0,1,6,0,18,6,0,3,0,3,12,107,79,3.6,3.2,3.5
7/26/23,12,0,1,3,0,16,10,0,0,1,0,11,106,78,3.6,3.2,3.5
7/27/23,5,0,0,5,0,10,11,1,2,0,2,16,108,77,3.6,3.2,3.5
7/28/23,8,0,4,0,0,12,1,0,2,1,6,10,107,78,3.6,3.2,3.5
7/29/23,3,0,1,0,0,4,7,0,3,0,1,11,106,78,3.6,3.2,3.5
7/30/23,6,0,1,0,0,7,8,0,2,0,0,10,106,80,3.6,3.2,3.5
7/31/23,3,0,3,5,0,11,7,0,0,0,0,7,104,77,3.6,3.2,3.5
8/1/23,11,0,1,0,0,12,7,0,3,0,0,10,105,77,3.6,3.2,3.5
8/2/23,7,0,1,1,0,9,6,0,1,0,2,9,106,80,3.6,3.2,3.5
8/3/23,2,0,4,2,0,8,1,0,1,0,2,4,105,75,3.6,3.2,3.5
8/4/23,10,0,2,3,0,15,9,0,1,2,1,13,104,77,3.6,3.2,3.5
8/5/23,2,0,3,1,0,6,24,0,2,0,3,29,103,79,3.6,3.2,3.5
8/6/23,5,0,3,0,0,8,6,0,2,0,0,8,103,78,3.6,3.2,3.5
8/7/23,13,0,4,3,0,20,8,0,3,0,0,11,102,77,3.6,3.2,3.5
8/8/23,14,0,1,1,0,16,7,1,0,0,1,9,104,76,3.6,3.2,3.5
8/9/23,12,0,1,3,0,16,5,1,5,0,3,14,104,77,3.6,3.2,3.5
8/10/23,13,0,1,5,0,19,3,2,3,0,1,9,107,79,3.6,3.2,3.5
8/11/23,6,0,2,2,0,10,7,0,2,0,4,13,106,78,3.6,3.7,3.8
8/12/23,5,0,1,1,0,7,7,0,0,0,1,8,105,79,3.6,3.7,3.8
8/13/23,2,0,0,0,0,2,8,0,0,0,2,10,104,78,3.6,3.7,3.8
8/14/23,10,0,0,8,0,18,10,0,4,0,2,16,105,79,3.6,3.7,3.8
8/15/23,4,0,1,2,0,7,10,0,0,0,2,12,106,78,3.6,3.7,3.8
8/16/23,5,0,0,0,0,5,9,0,1,0,3,13,105,78,3.6,3.7,3.8
8/17/23,3,0,1,4,0,8,4,0,1,0,2,7,106,78,3.6,3.7,3.8
8/18/23,7,0,3,2,0,12,6,0,0,0,1,7,106,78,3.6,3.7,3.8
8/19/23,3,0,3,0,0,6,3,0,2,0,0,5,108,77,3.6,3.7,3.8
8/20/23,5,0,0,2,0,7,8,0,1,0,3,12,107,78,3.6,3.7,3.8
8/21/23,9,0,1,2,0,12,16,0,1,0,0,17,108,79,3.6,3.7,3.8
8/22/23,10,0,1,5,0,16,2,0,3,0,2,7,106,80,3.6,3.7,3.8
8/23/23,4,0,4,6,0,14,8,0,3,0,0,11,106,79,3.6,3.7,3.8
8/24/23,5,0,0,1,0,6,4,0,1,1,2,8,106,77,3.6,3.7,3.8
8/25/23,10,0,0,8,0,18,3,1,1,0,0,5,102,80,3.6,3.7,3.8
8/26/23,7,0,2,2,0,11,2,0,0,0,1,3,104,73,3.6,3.7,3.8
8/27/23,4,0,1,0,0,5,9,0,2,0,2,13,110,77,3.6,3.7,3.8
8/28/23,9,0,4,4,0,17,8,0,4,0,1,13,106,77,3.6,3.7,3.8
8/29/23,11,0,1,2,0,14,6,1,1,0,1,9,104,75,3.6,3.7,3.8
8/30/23,8,0,3,2,0,13,4,0,2,0,0,6,107,78,3.6,3.7,3.8
8/31/23,5,0,1,2,0,8,5,0,1,0,12,18,105,80,3.6,3.7,3.8
9/1/23,5,0,0,5,0,10,5,0,2,0,1,8,99,78,3.6,3.7,3.8
9/2/23,6,0,1,2,0,9,7,0,2,1,0,10,101,78,3.6,3.7,3.8
9/3/23,11,0,0,2,0,13,6,0,2,0,1,9,105,79,3.6,3.7,3.8
9/4/23,4,0,0,1,0,5,9,1,3,0,1,14,107,80,3.6,3.7,3.8
9/5/23,12,0,5,4,0,21,11,1,3,0,3,18,107,77,3.6,3.7,3.8
9/6/23,7,0,1,1,0,9,6,0,0,0,2,8,109,77,3.6,3.7,3.8
9/7/23,7,0,1,3,0,11,9,1,7,0,1,18,100,75,3.6,3.7,3.8
9/8/23,7,0,0,1,0,8,1,1,0,0,0,2,99,76,3.6,3.7,3.8
9/9/23,3,0,1,1,0,5,4,0,0,0,1,5,101,70,3.6,3.7,3.8
9/10/23,5,0,2,2,0,9,12,0,4,0,0,16,102,71,3.6,3.7,3.8
9/11/23,8,0,0,4,0,12,4,2,3,0,3,12,100,73,3.5,3.7,3.8
9/12/23,3,0,0,12,0,15,4,1,2,1,9,17,101,74,3.5,3.7,3.8
9/13/23,10,0,1,0,0,11,3,0,1,0,0,4,102,76,3.5,3.7,3.8
9/14/23,12,0,4,4,0,20,7,1,2,0,0,10,102,77,3.5,3.7,3.8
9/15/23,8,0,0,4,0,12,11,0,0,1,0,12,104,79,3.5,3.7,3.8
9/16/23,9,0,0,0,0,9,5,0,3,0,0,8,103,78,3.5,3.7,3.8
9/17/23,4,0,0,0,0,4,8,0,0,0,11,19,105,78,3.5,3.7,3.8
9/18/23,5,0,0,6,0,11,11,0,1,0,4,16,107,77,3.5,3.7,3.8
9/19/23,10,0,3,6,0,19,10,0,1,0,3,14,104,77,3.5,3.7,3.8
9/20/23,14,0,1,3,0,18,7,0,4,0,0,11,99,79,3.5,3.7,3.8
9/21/23,5,0,3,2,0,10,7,0,0,0,3,10,98,75,3.5,3.7,3.8
9/22/23,6,0,0,11,0,17,5,0,1,0,4,10,94,77,3.5,3.7,3.8
9/23/23,3,0,0,0,0,3,5,0,2,0,2,9,89,72,3.5,3.7,3.8
9/24/23,3,0,0,1,0,4,6,2,1,1,0,10,94,69,3.5,3.7,3.8
9/25/23,11,0,1,3,0,15,7,0,2,0,1,10,89,73,3.5,3.7,3.8
9/26/23,12,0,0,6,0,18,7,0,2,0,8,17,85,68,3.5,3.7,3.8
9/27/23,11,0,0,3,0,14,5,0,1,0,2,8,94,69,3.5,3.7,3.8
9/28/23,7,0,1,10,0,18,12,0,1,0,7,20,96,67,3.5,3.7,3.8
9/29/23,6,0,1,0,0,7,8,0,1,1,10,20,98,72,3.5,3.7,3.8
9/30/23,5,0,1,6,0,12,8,0,1,0,1,10,99,72,3.5,3.7,3.8
10/1/23,20,0,0,0,0,20,11,0,2,0,0,13,97,76,3.5,3.7,3.8
10/2/23,6,0,1,4,0,11,2,1,1,0,3,7,99,74,3.5,3.7,3.8
10/3/23,15,0,2,6,0,23,5,1,1,1,7,15,101,78,3.5,3.7,3.8
10/4/23,8,0,0,2,0,10,17,1,4,0,4,26,103,72,3.5,3.7,3.8
10/5/23,7,0,3,4,0,14,6,0,6,0,9,21,96,76,3.5,3.7,3.8
10/6/23,8,0,1,2,0,11,4,0,3,0,0,7,96,72,3.5,3.7,3.8
10/7/23,10,0,4,1,0,15,2,0,0,0,1,3,96,71,3.5,3.7,3.8
10/8/23,3,0,0,0,0,3,8,0,1,1,1,11,95,72,3.5,3.7,3.8
10/9/23,5,0,1,5,0,11,13,0,0,0,6,19,95,72,3.5,3.7,3.8
10/10/23,8,0,2,4,0,14,9,0,2,0,1,12,95,73,3.5,3.7,3.8
10/11/23,14,0,0,6,0,20,11,0,1,0,0,12,94,72,3.3,3.2,3.8
10/12/23,8,0,4,1,0,13,1,0,2,0,0,3,94,72,3.3,3.2,3.8
10/13/23,8,0,7,2,0,17,1,0,3,0,0,4,95,70,3.3,3.2,3.8
10/14/23,8,0,2,1,0,11,11,1,4,0,0,16,98,76,3.3,3.2,3.8
10/15/23,6,0,1,0,0,7,13,0,1,0,2,16,80,67,3.3,3.2,3.8
10/16/23,2,0,1,1,0,4,5,0,1,0,2,8,87,67,3.3,3.2,3.8
10/17/23,10,0,0,3,0,13,11,0,0,1,16,28,76,60,3.3,3.2,3.8
10/18/23,8,0,3,1,0,12,10,1,12,0,2,25,80,51,3.3,3.2,3.8
10/19/23,6,0,1,2,0,9,0,2,0,0,1,3,85,54,3.3,3.2,3.8
10/20/23,6,0,0,5,0,11,9,0,1,1,1,12,81,65,3.3,3.2,3.8
10/21/23,4,0,0,3,0,7,6,0,0,0,1,7,71,66,3.3,3.2,3.8
10/22/23,3,0,1,0,0,4,8,0,1,2,3,14,85,64,3.3,3.2,3.8
10/23/23,23,0,0,4,0,27,10,0,2,0,0,12,93,69,3.3,3.2,3.8
10/24/23,9,0,0,6,0,15,11,0,2,1,6,20,79,60,3.3,3.2,3.8
10/25/23,9,0,2,1,0,12,11,0,0,0,2,13,75,56,3.3,3.2,3.8
10/26/23,20,0,1,2,0,23,10,1,1,0,0,12,75,50,3.3,3.2,3.8
10/27/23,14,0,1,3,0,18,2,0,0,0,5,7,77,45,3.3,3.2,3.8
10/28/23,9,0,0,1,0,10,10,0,1,0,0,11,84,51,3.3,3.2,3.8
10/29/23,2,0,1,2,0,5,12,0,1,0,0,13,88,58,3.3,3.2,3.8
10/30/23,16,0,0,3,0,19,17,0,4,0,5,26,97,57,3.3,3.2,3.8
10/31/23,12,0,3,2,0,17,25,0,2,0,2,29,94,57,3.3,3.2,3.8
11/1/23,8,0,0,1,0,9,0,0,0,0,1,1,89,67,3.3,3.2,3.8
11/2/23,18,0,1,4,0,23,14,0,3,0,0,17,83,68,3.3,3.2,3.8
11/3/23,7,0,0,3,0,10,10,0,1,0,0,11,79,71,3.3,3.2,3.8
11/4/23,10,0,1,0,0,11,12,0,1,0,0,13,85,72,3.3,3.2,3.8
11/5/23,6,0,0,0,0,6,9,0,7,0,1,17,79,71,3.3,3.2,3.8
11/6/23,4,0,0,4,0,8,6,0,2,0,2,10,88,73,3.3,3.2,3.8
11/7/23,15,0,2,11,0,28,7,1,4,1,1,14,87,73,3.3,3.2,3.8
11/8/23,10,0,3,4,0,17,15,0,2,0,2,19,78,41,3.3,3.2,3.8
11/9/23,3,0,2,4,0,9,6,0,4,0,0,10,48,39,3.3,3.2,3.8
11/10/23,5,0,0,0,0,5,5,0,0,0,0,5,61,42,3.3,3.2,3.8
11/11/23,8,0,0,1,0,9,11,0,2,0,0,13,60,38,3,3.1,3.7
11/12/23,1,0,0,2,0,3,11,0,2,0,2,15,67,35,3,3.1,3.7
11/13/23,9,0,1,6,0,16,14,0,4,0,4,22,76,46,3,3.1,3.7
11/14/23,7,0,0,9,0,16,9,0,1,0,2,12,79,58,3,3.1,3.7
11/15/23,11,0,0,0,0,11,12,0,0,0,2,14,80,59,3,3.1,3.7
11/16/23,8,0,3,3,0,14,3,0,3,0,1,7,80,64,3,3.1,3.7
11/17/23,9,0,1,3,0,13,4,0,0,0,1,5,85,63,3,3.1,3.7
11/18/23,5,0,0,2,0,7,12,0,3,0,0,15,81,69,3,3.1,3.7
11/19/23,4,0,3,2,0,9,10,0,3,0,2,15,74,53,3,3.1,3.7
11/20/23,14,0,1,4,0,19,12,0,2,0,0,14,56,52,3,3.1,3.7
11/21/23,7,0,3,6,0,16,11,0,3,0,7,21,61,53,3,3.1,3.7
11/22/23,9,0,0,5,0,14,10,1,0,0,11,22,61,54,3,3.1,3.7
11/23/23,7,0,0,0,0,7,10,0,1,0,1,12,65,53,3,3.1,3.7
11/25/23,17,0,3,1,0,21,5,0,2,0,1,8,72,54,3,3.1,3.7
11/26/23,3,0,0,1,0,4,9,0,1,0,0,10,74,51,3,3.1,3.7
11/27/23,11,0,1,9,0,21,10,0,4,1,4,19,62,51,3,3.1,3.7
11/28/23,16,0,1,1,0,18,15,0,2,0,0,17,81,55,3,3.1,3.7
11/29/23,11,0,1,3,0,15,12,0,1,0,1,14,70,59,3,3.1,3.7
11/30/23,10,0,2,3,0,15,9,0,2,1,14,26,65,56,3,3.1,3.7
12/1/23,8,0,2,15,0,25,1,0,2,0,1,4,82,60,3,3.1,3.7
12/2/23,2,0,0,1,0,3,4,1,1,0,0,6,60,47,3,3.1,3.7
12/3/23,5,0,1,0,0,6,0,1,0,0,0,1,66,39,3,3.1,3.7
12/4/23,8,0,0,3,0,11,0,0,0,0,4,4,58,42,3,3.1,3.7
12/5/23,7,0,0,0,0,7,7,0,5,0,3,15,65,40,3,3.1,3.7
12/6/23,9,0,1,12,0,22,21,1,0,0,1,23,59,46,3,3.1,3.7
12/7/23,13,0,0,3,0,16,8,0,2,0,5,15,56,42,3,3.1,3.7
12/8/23,15,0,3,7,0,25,8,0,1,0,0,9,56,36,3,3.1,3.7
12/9/23,1,0,2,2,0,5,1,0,3,0,0,4,61,45,3,3.1,3.7
12/10/23,1,0,0,0,0,1,19,0,7,0,1,27,63,43,3,3.1,3.7
12/11/23,7,0,5,3,0,15,11,0,1,0,3,15,73,56,3,3.1,3.7
12/12/23,6,0,4,1,0,11,14,0,5,1,3,23,71,50,3,3.4,3.7
12/13/23,5,0,2,2,0,9,24,0,3,0,2,29,68,45,3,3.4,3.7
12/14/23,12,0,0,7,0,19,6,0,2,0,0,8,73,46,3,3.4,3.7
12/15/23,24,0,1,8,0,33,3,0,2,0,1,6,68,44,3,3.4,3.7
12/16/23,14,0,5,0,0,19,13,1,2,0,2,18,73,39,3,3.4,3.7
12/17/23,6,0,3,1,0,10,10,1,3,0,2,16,68,42,3,3.4,3.7
12/18/23,8,0,1,4,0,13,9,0,1,0,3,13,71,46,3,3.4,3.7
12/19/23,11,0,5,6,0,22,12,0,4,0,3,19,72,61,3,3.4,3.7
12/20/23,10,0,1,4,0,15,16,0,1,0,0,17,75,50,3,3.4,3.7
12/21/23,16,0,0,7,0,23,7,0,5,0,4,16,59,38,3,3.4,3.7
12/22/23,6,0,0,3,0,9,10,0,2,0,0,12,65,31,3,3.4,3.7
12/23/23,12,0,1,1,0,14,27,1,3,0,3,34,68,39,3,3.4,3.7
12/24/23,3,0,0,1,0,4,8,0,5,0,2,15,56,50,3,3.4,3.7
12/25/23,4,0,1,0,0,5,14,0,4,0,1,19,67,48,3,3.4,3.7
12/26/23,6,0,1,0,0,7,15,1,3,0,6,25,63,51,3,3.4,3.7
12/27/23,11,0,3,4,0,18,7,2,3,1,3,16,65,43,3,3.4,3.7
12/28/23,7,0,1,2,0,10,21,0,0,0,1,22,71,37,3,3.4,3.7
12/29/23,15,0,2,0,0,17,7,1,0,0,8,16,68,43,3,3.4,3.7
12/30/23,4,0,1,2,0,7,12,0,1,0,0,13,67,38,3,3.4,3.7
12/31/23,0,0,0,1,0,1,8,0,1,1,1,11,72,50,3,3.4,3.7
1/1/24,9,0,2,0,0,11,8,1,1,0,0,10,62,59,3,3.4,3.7
1/2/24,6,0,1,2,0,9,2,0,0,0,1,3,71,60,3,3.4,3.7
1/3/24,15,0,1,4,0,20,11,0,0,0,1,12,69,61,3,3.4,3.7
1/4/24,6,0,1,2,0,9,20,0,2,0,0,22,72,53,3,3.4,3.7
1/5/24,22,0,6,5,0,33,23,2,2,0,4,31,57,40,3,3.4,3.7
1/6/24,4,0,0,1,0,5,13,0,4,0,1,18,59,33,3,3.4,3.7
1/7/24,2,0,5,0,0,7,10,0,0,0,2,12,63,38,3,3.4,3.7
1/8/24,11,0,0,5,0,16,9,0,4,0,1,14,60,38,3,3.4,3.7
1/9/24,2,0,2,15,0,19,10,0,2,0,3,15,59,34,3,3.4,3.7
1/10/24,11,0,1,4,0,16,9,0,0,0,2,11,69,39,3,3.4,3.7
1/11/24,7,0,1,7,0,15,12,1,4,0,2,19,72,39,3,3.4,3.7
1/12/24,6,0,0,9,0,15,13,1,3,0,0,17,59,42,3.4,3.1,3.7
1/13/24,9,0,0,2,0,11,7,0,2,0,0,9,51,40,3.4,3.1,3.7
1/14/24,8,0,1,1,0,10,10,0,5,0,2,17,51,43,3.4,3.1,3.7
1/15/24,1,0,1,0,0,2,16,0,4,0,8,28,56,39,3.4,3.1,3.7
1/16/24,17,0,2,4,0,23,14,0,3,0,3,20,64,46,3.4,3.1,3.7
1/17/24,3,0,3,7,0,13,17,0,0,0,2,19,63,38,3.4,3.1,3.7
1/18/24,6,0,2,1,0,9,6,0,0,0,3,9,64,34,3.4,3.1,3.7
1/19/24,22,0,2,3,0,27,18,0,4,0,3,25,70,48,3.4,3.1,3.7
1/20/24,7,0,0,0,0,7,15,0,7,0,2,24,56,33,3.4,3.1,3.7
1/21/24,8,0,0,2,0,10,10,0,3,0,4,17,67,32,3.4,3.1,3.7
1/22/24,16,0,1,3,0,20,9,0,1,0,3,13,73,44,3.4,3.1,3.7
1/23/24,8,0,1,7,0,16,11,0,2,0,2,15,67,34,3.4,3.1,3.7
1/24/24,10,0,3,4,0,17,8,0,5,0,0,13,62,33,3.4,3.1,3.7
1/25/24,12,0,2,0,0,14,10,2,2,1,6,21,35,17,3.4,3.1,3.7
1/26/24,9,0,0,7,0,16,0,0,0,0,2,2,24,16,3.4,3.1,3.7
1/27/24,9,0,0,0,0,9,18,1,3,0,1,23,34,17,3.4,3.1,3.7
1/28/24,2,0,0,4,0,6,10,0,3,2,8,23,45,16,3.4,3.1,3.7
1/29/24,10,0,4,1,0,15,13,0,2,0,0,15,77,37,3.4,3.1,3.7
1/30/24,10,0,1,8,0,19,11,1,3,0,1,16,55,30,3.4,3.1,3.7
1/31/24,13,0,3,1,0,17,10,0,1,0,0,11,42,25,3.4,3.1,3.7
2/1/24,7,0,1,13,0,21,12,0,4,0,0,16,39,36,3.4,3.1,3.7
2/2/24,15,0,2,6,0,23,17,0,1,1,0,19,55,37,3.4,3.1,3.7
2/3/24,6,0,1,0,0,7,14,0,3,0,2,19,59,52,3.4,3.1,3.7
2/4/24,10,0,1,1,0,12,8,0,0,0,5,13,54,50,3.4,3.1,3.7
2/5/24,23,0,0,9,0,32,15,1,4,0,1,21,63,47,3.4,3.1,3.7
2/6/24,18,0,1,3,0,22,10,2,1,0,1,14,58,49,3.4,3.1,3.7
2/7/24,12,0,5,2,0,19,6,1,4,0,7,18,64,48,3.4,3.1,3.7
2/8/24,9,0,1,21,0,31,11,0,0,0,1,12,68,42,3.4,3.1,3.7
2/9/24,6,0,1,5,0,12,7,1,8,1,5,22,73,41,3.4,3.1,3.7
2/10/24,7,0,1,0,0,8,15,0,6,0,8,29,76,46,3.4,3.1,3.7
2/11/24,1,0,0,0,0,1,8,0,2,0,2,12,75,46,3.4,3.1,3.7
2/12/24,12,0,1,7,0,20,12,0,4,0,2,18,73,49,3.7,3.2,3.9
2/13/24,13,0,3,10,0,26,15,0,3,0,1,19,68,58,3.7,3.2,3.9
2/14/24,15,0,1,5,0,21,6,0,3,0,1,10,71,47,3.7,3.2,3.9
2/15/24,27,0,1,19,0,47,3,0,0,1,0,4,69,47,3.7,3.2,3.9
2/16/24,9,0,0,3,0,12,14,0,2,0,2,18,65,51,3.7,3.2,3.9
2/17/24,5,0,0,2,0,7,18,0,1,0,5,24,71,44,3.7,3.2,3.9
2/18/24,4,0,9,0,0,13,8,0,8,0,2,18,70,47,3.7,3.2,3.9
2/19/24,4,0,1,0,0,5,6,0,5,0,1,12,73,60,3.7,3.2,3.9
2/20/24,12,0,2,3,0,17,8,0,2,0,1,11,76,61,3.7,3.2,3.9
2/21/24,9,0,0,7,0,16,7,0,0,0,0,7,67,58,3.7,3.2,3.9
2/22/24,14,0,1,3,0,18,4,0,4,0,2,10,59,46,3.7,3.2,3.9
2/23/24,10,0,0,8,0,18,10,0,0,0,1,11,62,41,3.7,3.2,3.9
2/24/24,7,0,1,0,0,8,7,1,5,0,0,13,69,37,3.7,3.2,3.9
2/25/24,5,0,0,2,0,7,10,0,2,0,2,14,67,42,3.7,3.2,3.9
2/26/24,11,0,0,4,0,15,14,0,1,0,1,16,71,59,3.7,3.2,3.9
2/27/24,12,0,0,4,0,16,9,1,3,1,0,14,77,52,3.7,3.2,3.9
2/28/24,8,0,0,7,0,15,13,1,1,0,4,19,52,39,3.7,3.2,3.9
2/29/24,12,0,1,13,0,26,13,0,0,0,1,14,58,33,3.7,3.2,3.9
3/1/24,15,0,1,5,0,21,22,1,2,0,4,29,69,37,3.7,3.2,3.9
3/2/24,4,0,4,1,0,9,12,0,2,0,3,17,80,45,3.7,3.2,3.9
3/3/24,12,0,1,1,0,14,4,0,3,0,0,7,77,62,3.7,3.2,3.9
3/4/24,17,0,1,4,0,22,11,0,3,0,14,28,88,65,3.7,3.2,3.9
3/5/24,16,0,3,8,0,27,4,1,1,0,1,7,78,56,3.7,3.2,3.9
3/6/24,4,0,1,4,0,9,16,0,3,0,6,25,81,51,3.7,3.2,3.9
3/7/24,21,0,5,1,0,27,4,0,0,1,2,7,85,55,3.7,3.2,3.9
3/8/24,12,0,0,2,0,14,13,0,1,0,1,15,85,59,3.7,3.2,3.9
3/9/24,4,0,0,0,0,4,12,0,2,0,2,16,81,67,3.7,3.2,3.9
3/10/24,5,0,0,0,0,5,9,0,3,0,0,12,71,47,3.7,3.2,3.9
3/11/24,11,0,1,6,0,18,4,1,4,0,1,10,49,44,3.7,3.2,3.9
3/12/24,15,0,3,5,0,23,5,0,2,0,3,10,70,45,3.5,3.5,3.8
3/13/24,11,0,2,4,0,17,6,0,1,0,1,8,83,48,3.5,3.5,3.8
3/14/24,11,0,2,5,0,18,13,0,1,0,1,15,81,63,3.5,3.5,3.8
3/15/24,11,0,0,3,0,14,3,0,3,1,0,7,84,67,3.5,3.5,3.8
3/16/24,6,0,0,2,0,8,15,0,13,0,3,31,91,61,3.5,3.5,3.8
3/17/24,6,0,0,1,0,7,14,0,0,0,6,20,84,56,3.5,3.5,3.8
3/18/24,5,0,0,10,0,15,7,0,0,0,0,7,75,67,3.5,3.5,3.8
3/19/24,18,0,2,3,0,23,4,0,2,0,5,11,84,51,3.5,3.5,3.8
3/20/24,27,0,15,4,0,46,12,0,1,0,3,16,63,46,3.5,3.5,3.8
3/21/24,5,0,0,1,0,6,10,0,1,0,4,15,69,43,3.5,3.5,3.8
3/22/24,12,0,0,8,0,20,13,0,4,0,2,19,75,54,3.5,3.5,3.8
3/23/24,5,0,2,1,0,8,9,1,2,0,2,14,79,58,3.5,3.5,3.8
3/24/24,6,0,2,1,0,9,10,0,4,0,3,17,84,67,3.5,3.5,3.8
3/25/24,11,0,0,10,0,21,9,0,6,0,1,16,80,70,3.5,3.5,3.8
3/26/24,7,0,0,5,0,12,8,0,0,0,2,10,76,64,3.5,3.5,3.8
3/27/24,17,0,3,6,0,26,9,1,4,0,3,17,74,62,3.5,3.5,3.8
3/28/24,12,0,1,4,0,17,1,0,0,0,1,2,66,58,3.5,3.5,3.8
3/29/24,10,0,1,3,0,14,4,0,2,0,0,6,66,52,3.5,3.5,3.8
3/30/24,6,0,0,2,0,8,12,0,2,1,7,22,68,46,3.5,3.5,3.8
3/31/24,5,0,1,0,0,6,7,0,1,1,6,15,67,50,3.5,3.5,3.8
4/1/24,10,0,0,5,0,15,21,3,4,0,9,37,64,58,3.5,3.5,3.8
4/2/24,12,0,1,0,0,13,14,0,3,0,1,18,80,55,3.5,3.5,3.8
4/3/24,21,0,1,3,0,25,7,0,5,0,2,14,73,52,3.5,3.5,3.8
4/4/24,17,0,0,3,0,20,7,0,1,0,2,10,73,59,3.5,3.5,3.8
4/5/24,14,0,1,8,0,23,3,0,2,0,13,18,78,57,3.5,3.5,3.8
4/6/24,2,0,0,2,0,4,11,0,1,0,4,16,70,46,3.5,3.5,3.8
4/7/24,3,0,0,1,0,4,2,0,2,0,0,4,68,48,3.5,3.5,3.8
4/8/24,4,0,0,1,0,5,9,0,2,0,2,13,79,45,3.5,3.5,3.8
4/9/24,21,0,1,4,0,26,12,0,2,1,5,20,80,56,3.5,3.5,3.8
4/10/24,15,0,3,2,0,20,6,0,3,0,1,10,78,63,3.5,3.5,3.8
4/11/24,10,0,1,4,0,15,5,0,3,0,3,11,79,67,3.5,3.5,3.8
4/12/24,22,0,0,4,0,26,20,1,6,0,4,31,83,67,,3.4,3.9
4/13/24,5,0,0,1,0,6,9,0,5,0,1,15,76,57,,3.4,3.9
4/14/24,6,0,1,1,0,8,5,2,3,0,1,11,84,50,,3.4,3.9
4/15/24,14,0,1,2,0,17,19,0,3,0,3,25,89,48,,3.4,3.9
4/16/24,11,0,4,4,0,19,5,0,1,0,1,7,88,53,,3.4,3.9
4/17/24,7,0,1,4,0,12,19,1,1,0,0,21,79,63,,3.4,3.9
4/18/24,20,0,5,3,0,28,5,0,1,0,0,6,83,61,,3.4,3.9
4/19/24,18,0,0,3,0,21,8,0,2,0,6,16,80,61,,3.4,3.9
4/20/24,10,0,0,0,0,10,5,0,1,0,4,10,84,64,,3.4,3.9
4/21/24,8,0,1,0,0,9,10,1,4,2,3,20,71,57,,3.4,3.9
4/22/24,17,0,4,1,0,22,11,1,1,0,8,21,84,54,,3.4,3.9
4/23/24,21,0,0,7,0,28,7,0,1,0,5,13,83,51,,3.4,3.9
4/24/24,10,0,3,2,0,15,3,0,1,0,0,4,83,63,,3.4,3.9
4/25/24,13,0,3,5,0,21,,,,,,,85,65,,3.4,3.9
4/26/24,4,0,4,1,0,9,,,,,,,84,70,,3.4,3.9
4/27/24,7,0,1,2,0,10,,,,,,,81,70,,3.4,3.9
4/28/24,9,0,0,1,0,10,,,,,,,83,72,,3.4,3.9
4/29/24,28,0,1,10,0,39,,,,,,,88,72,,3.4,3.9
4/30/24,19,0,0,13,0,32,,,,,,,76,64,,3.4,3.9
5/1/24,13,0,3,3,0,19,,,,,,,72,54,,3.4,3.9
5/2/24,18,0,0,7,0,25,,,,,,,71,51,,3.4,3.9
5/3/24,9,0,2,6,0,17,,,,,,,75,49,,3.4,3.9
5/4/24,6,0,4,2,0,12,,,,,,,75,55,,3.4,3.9
5/5/24,9,0,4,4,0,17,,,,,,,84,69,,3.4,3.9
5/6/24,10,0,2,3,0,15,,,,,,,83,70,,3.4,3.9
5/7/24,7,0,2,8,0,17,,,,,,,84,72,,3.4,3.9
5/8/24,10,0,1,2,0,13,,,,,,,83,75,,3.4,3.9
5/9/24,11,0,0,6,0,17,,,,,,,80,65,,3.4,3.9
5/10/24,8,0,2,12,0,22,,,,,,,89,71,,3.4,3.9
5/11/24,6,0,0,0,0,6,,,,,,,85,68,,3.4,3.9
5/12/24,18,0,0,1,0,19,,,,,,,78,69,,,
5/13/24,12,0,2,11,0,25,,,,,,,77,68,,,
5/14/24,17,0,2,5,0,24,,,,,,,76,71,,,
5/15/24,14,0,0,3,0,17,,,,,,,80,71,,,
5/16/24,2,0,0,0,0,2,,,,,,,82,64,,,
,,,,,,,,,,,,,87,74,,,
,,,,,,,,,,,,,89,73,,,
,,,,,,,,,,,,,89,76,,,
,,,,,,,,,,,,,93,73,,,
,,,,,,,,,,,,,86,70,,,
,,,,,,,,,,,,,83,68,,,
,,,,,,,,,,,,,75,68,,,
,,,,,,,,,,,,,81,67,,,
,,,,,,,,,,,,,94,62,,,
,,,,,,,,,,,,,94,65,,,
,,,,,,,,,,,,,82,65,,,
,,,,,,,,,,,,,87,62,,,